geneID	female.DGRP177	female.SP159N	male.DGRP177	male.SP159N	combined.DGRP177	combined.SP159N	crit1.f	crit1.m	crit1.c	crit1.ALL	crit2.f	crit2.m	crit2.ALL	crit1and2
FBgn0000008	432	430	393	386	825	816	TRUE	TRUE	TRUE	1	TRUE	TRUE	1	1
FBgn0000014	194	203	167	167	361	370	TRUE	TRUE	TRUE	1	TRUE	TRUE	1	1
FBgn0000015	798	787	627	690	1425	1477	TRUE	FALSE	TRUE	0	TRUE	TRUE	1	0
FBgn0000017	193	224	183	158	376	382	TRUE	TRUE	TRUE	1	TRUE	TRUE	1	1
FBgn0000018	105	89	77	70	182	159	TRUE	TRUE	TRUE	1	TRUE	TRUE	1	1
FBgn0000024	381	374	341	324	722	698	TRUE	TRUE	TRUE	1	TRUE	TRUE	1	1
FBgn0000032	124	131	130	148	254	279	TRUE	TRUE	TRUE	1	TRUE	TRUE	1	1
FBgn0000036	632	693	617	588	1249	1281	FALSE	TRUE	TRUE	0	TRUE	TRUE	1	0
FBgn0000037	222	252	211	233	433	485	TRUE	TRUE	FALSE	0	TRUE	TRUE	1	0
FBgn0000038	295	297	233	239	528	536	TRUE	TRUE	TRUE	1	TRUE	TRUE	1	1
FBgn0000039	272	269	265	227	537	496	TRUE	FALSE	TRUE	0	TRUE	TRUE	1	0
FBgn0000043	54	41	44	42	98	83	TRUE	TRUE	TRUE	1	TRUE	TRUE	1	1
FBgn0000044	84	73	71	51	155	124	TRUE	FALSE	FALSE	0	TRUE	TRUE	1	0
FBgn0000046	52	52	40	51	92	103	TRUE	TRUE	TRUE	1	TRUE	TRUE	1	1
FBgn0000047	52	71	47	65	99	136	TRUE	TRUE	FALSE	0	TRUE	TRUE	1	0
FBgn0000052	293	297	241	209	534	506	TRUE	TRUE	TRUE	1	TRUE	TRUE	1	1
FBgn0000053	419	388	331	307	750	695	TRUE	TRUE	TRUE	1	TRUE	TRUE	1	1
FBgn0000057	102	86	76	60	178	146	TRUE	TRUE	FALSE	0	TRUE	TRUE	1	0
FBgn0000061	132	120	105	87	237	207	TRUE	TRUE	TRUE	1	TRUE	TRUE	1	1
FBgn0000063	144	181	120	141	264	322	FALSE	TRUE	FALSE	0	TRUE	TRUE	1	0
FBgn0000064	194	181	169	151	363	332	TRUE	TRUE	TRUE	1	TRUE	TRUE	1	1
FBgn0000071	40	39	47	33	87	72	TRUE	TRUE	TRUE	1	TRUE	TRUE	1	1
FBgn0000075	178	196	154	148	332	344	TRUE	TRUE	TRUE	1	TRUE	TRUE	1	1
FBgn0000078	80	96	44	65	124	161	TRUE	FALSE	FALSE	0	TRUE	TRUE	1	0
FBgn0000079	92	90	50	77	142	167	TRUE	FALSE	TRUE	0	TRUE	FALSE	0	0
FBgn0000083	231	197	197	201	428	398	TRUE	TRUE	TRUE	1	TRUE	TRUE	1	1
FBgn0000094	91	72	72	70	163	142	TRUE	TRUE	TRUE	1	TRUE	TRUE	1	1
FBgn0000097	256	251	213	210	469	461	TRUE	TRUE	TRUE	1	TRUE	TRUE	1	1
FBgn0000109	88	82	74	71	162	153	TRUE	TRUE	TRUE	1	TRUE	TRUE	1	1
FBgn0000114	688	790	625	624	1313	1414	FALSE	TRUE	FALSE	0	TRUE	TRUE	1	0
FBgn0000115	81	91	69	64	150	155	TRUE	TRUE	TRUE	1	TRUE	TRUE	1	1
FBgn0000116	272	240	214	224	486	464	TRUE	TRUE	TRUE	1	TRUE	TRUE	1	1
FBgn0000119	514	479	454	396	968	875	TRUE	FALSE	FALSE	0	TRUE	TRUE	1	0
FBgn0000120	233	244	209	200	442	444	TRUE	TRUE	TRUE	1	TRUE	TRUE	1	1
FBgn0000121	78	98	53	49	131	147	TRUE	TRUE	TRUE	1	TRUE	TRUE	1	1
FBgn0000139	143	124	120	101	263	225	TRUE	TRUE	FALSE	0	TRUE	TRUE	1	0
FBgn0000140	453	445	353	375	806	820	TRUE	TRUE	TRUE	1	TRUE	TRUE	1	1
FBgn0000146	184	223	156	167	340	390	FALSE	TRUE	FALSE	0	TRUE	TRUE	1	0
FBgn0000147	94	112	79	80	173	192	TRUE	TRUE	TRUE	1	TRUE	TRUE	1	1
FBgn0000153	153	154	110	145	263	299	TRUE	FALSE	TRUE	0	TRUE	TRUE	1	0
FBgn0000157	172	151	101	130	273	281	TRUE	FALSE	TRUE	0	TRUE	TRUE	1	0
FBgn0000158	64	65	71	54	135	119	TRUE	TRUE	TRUE	1	TRUE	TRUE	1	1
FBgn0000166	61	60	48	77	109	137	TRUE	FALSE	FALSE	0	TRUE	FALSE	0	0
FBgn0000180	215	194	159	171	374	365	TRUE	TRUE	TRUE	1	TRUE	TRUE	1	1
FBgn0000181	61	51	53	52	114	103	TRUE	TRUE	TRUE	1	TRUE	TRUE	1	1
FBgn0000183	295	312	248	284	543	596	TRUE	TRUE	TRUE	1	TRUE	TRUE	1	1
FBgn0000206	90	103	72	82	162	185	TRUE	TRUE	TRUE	1	TRUE	TRUE	1	1
FBgn0000212	279	264	214	225	493	489	TRUE	TRUE	TRUE	1	TRUE	TRUE	1	1
FBgn0000216	47	43	40	41	87	84	TRUE	TRUE	TRUE	1	TRUE	TRUE	1	1
FBgn0000227	126	95	101	85	227	180	FALSE	TRUE	FALSE	0	TRUE	TRUE	1	0
FBgn0000228	382	445	348	397	730	842	FALSE	FALSE	FALSE	0	TRUE	TRUE	1	0
FBgn0000229	155	173	140	107	295	280	TRUE	FALSE	TRUE	0	TRUE	TRUE	1	0
FBgn0000239	24	28	24	19	48	47	TRUE	TRUE	TRUE	1	TRUE	TRUE	1	1
FBgn0000241	207	204	130	150	337	354	TRUE	TRUE	TRUE	1	TRUE	TRUE	1	1
FBgn0000244	62	65	56	56	118	121	TRUE	TRUE	TRUE	1	TRUE	TRUE	1	1
FBgn0000246	63	71	47	47	110	118	TRUE	TRUE	TRUE	1	TRUE	TRUE	1	1
FBgn0000247	381	398	352	332	733	730	TRUE	TRUE	TRUE	1	TRUE	TRUE	1	1
FBgn0000250	257	290	221	220	478	510	TRUE	TRUE	TRUE	1	TRUE	TRUE	1	1
FBgn0000251	127	111	104	106	231	217	TRUE	TRUE	TRUE	1	TRUE	TRUE	1	1
FBgn0000253	311	321	260	272	571	593	TRUE	TRUE	TRUE	1	TRUE	TRUE	1	1
FBgn0000256	457	526	401	431	858	957	FALSE	TRUE	FALSE	0	TRUE	TRUE	1	0
FBgn0000261	33	32	20	27	53	59	TRUE	TRUE	TRUE	1	TRUE	TRUE	1	1
FBgn0000273	357	355	284	285	641	640	TRUE	TRUE	TRUE	1	TRUE	TRUE	1	1
FBgn0000274	97	99	62	72	159	171	TRUE	TRUE	TRUE	1	TRUE	TRUE	1	1
FBgn0000276	53	73	60	43	113	116	FALSE	TRUE	TRUE	0	TRUE	TRUE	1	0
FBgn0000277	66	71	66	52	132	123	TRUE	TRUE	TRUE	1	TRUE	TRUE	1	1
FBgn0000278	74	86	55	61	129	147	TRUE	TRUE	TRUE	1	TRUE	TRUE	1	1
FBgn0000279	60	58	57	48	117	106	TRUE	TRUE	TRUE	1	TRUE	TRUE	1	1
FBgn0000280	37	45	45	45	82	90	TRUE	TRUE	TRUE	1	TRUE	TRUE	1	1
FBgn0000281	64	55	39	54	103	109	TRUE	TRUE	TRUE	1	TRUE	TRUE	1	1
FBgn0000286	170	195	146	161	316	356	TRUE	TRUE	TRUE	1	TRUE	TRUE	1	1
FBgn0000287	436	384	338	319	774	703	FALSE	TRUE	FALSE	0	TRUE	TRUE	1	0
FBgn0000289	241	260	219	224	460	484	TRUE	TRUE	TRUE	1	TRUE	TRUE	1	1
FBgn0000299	319	299	209	243	528	542	TRUE	TRUE	TRUE	1	TRUE	TRUE	1	1
FBgn0000303	188	232	148	139	336	371	FALSE	TRUE	TRUE	0	TRUE	TRUE	1	0
FBgn0000307	247	231	206	254	453	485	TRUE	FALSE	TRUE	0	TRUE	TRUE	1	0
FBgn0000308	141	162	116	115	257	277	TRUE	TRUE	TRUE	1	TRUE	TRUE	1	1
FBgn0000317	614	666	562	547	1176	1213	TRUE	TRUE	TRUE	1	TRUE	TRUE	1	1
FBgn0000318	32	46	27	27	59	73	TRUE	TRUE	TRUE	1	TRUE	TRUE	1	1
FBgn0000320	294	317	243	224	537	541	TRUE	TRUE	TRUE	1	TRUE	TRUE	1	1
FBgn0000326	190	163	115	133	305	296	TRUE	TRUE	TRUE	1	TRUE	TRUE	1	1
FBgn0000337	27	10	17	17	44	27	FALSE	TRUE	FALSE	0	FALSE	TRUE	0	0
FBgn0000339	60	32	30	45	90	77	FALSE	TRUE	TRUE	0	FALSE	TRUE	0	0
FBgn0000351	54	53	48	51	102	104	TRUE	TRUE	TRUE	1	TRUE	TRUE	1	1
FBgn0000352	197	196	183	166	380	362	TRUE	TRUE	TRUE	1	TRUE	TRUE	1	1
FBgn0000355	650	673	25	40	675	713	TRUE	FALSE	TRUE	0	TRUE	FALSE	0	0
FBgn0000356	615	699	41	41	656	740	FALSE	TRUE	FALSE	0	TRUE	TRUE	1	0
FBgn0000357	986	960	50	58	1036	1018	TRUE	TRUE	TRUE	1	TRUE	TRUE	1	1
FBgn0000358	1146	1225	68	67	1214	1292	TRUE	TRUE	TRUE	1	TRUE	TRUE	1	1
FBgn0000370	84	85	42	56	126	141	TRUE	TRUE	TRUE	1	TRUE	TRUE	1	1
FBgn0000384	54	39	28	42	82	81	TRUE	TRUE	TRUE	1	TRUE	TRUE	1	1
FBgn0000395	242	222	209	181	451	403	TRUE	TRUE	TRUE	1	TRUE	TRUE	1	1
FBgn0000404	255	290	208	222	463	512	TRUE	TRUE	TRUE	1	TRUE	TRUE	1	1
FBgn0000405	167	162	144	137	311	299	TRUE	TRUE	TRUE	1	TRUE	TRUE	1	1
FBgn0000406	103	82	87	89	190	171	TRUE	TRUE	TRUE	1	TRUE	TRUE	1	1
FBgn0000411	113	116	114	84	227	200	TRUE	FALSE	TRUE	0	TRUE	TRUE	1	0
FBgn0000412	80	76	68	80	148	156	TRUE	TRUE	TRUE	1	TRUE	TRUE	1	1
FBgn0000414	464	400	377	346	841	746	FALSE	TRUE	FALSE	0	TRUE	TRUE	1	0
FBgn0000416	135	154	132	133	267	287	TRUE	TRUE	TRUE	1	TRUE	TRUE	1	1
FBgn0000422	143	160	129	134	272	294	TRUE	TRUE	TRUE	1	TRUE	TRUE	1	1
FBgn0000439	144	138	113	116	257	254	TRUE	TRUE	TRUE	1	TRUE	TRUE	1	1
FBgn0000442	42	40	29	42	71	82	TRUE	TRUE	TRUE	1	TRUE	TRUE	1	1
FBgn0000447	50	44	47	41	97	85	TRUE	TRUE	TRUE	1	TRUE	TRUE	1	1
FBgn0000448	134	121	116	99	250	220	TRUE	TRUE	TRUE	1	TRUE	TRUE	1	1
FBgn0000449	166	168	122	133	288	301	TRUE	TRUE	TRUE	1	TRUE	TRUE	1	1
FBgn0000451	273	234	208	207	481	441	FALSE	TRUE	TRUE	0	TRUE	TRUE	1	0
FBgn0000454	96	95	94	82	190	177	TRUE	TRUE	TRUE	1	TRUE	TRUE	1	1
FBgn0000455	53	41	46	43	99	84	TRUE	TRUE	TRUE	1	TRUE	TRUE	1	1
FBgn0000463	343	370	269	291	612	661	TRUE	TRUE	TRUE	1	TRUE	TRUE	1	1
FBgn0000464	123	125	111	128	234	253	TRUE	TRUE	TRUE	1	TRUE	TRUE	1	1
FBgn0000473	100	106	88	74	188	180	TRUE	TRUE	TRUE	1	TRUE	TRUE	1	1
FBgn0000477	104	123	84	87	188	210	TRUE	TRUE	TRUE	1	TRUE	TRUE	1	1
FBgn0000489	263	213	190	200	453	413	FALSE	TRUE	TRUE	0	TRUE	TRUE	1	0
FBgn0000490	259	294	233	243	492	537	TRUE	TRUE	TRUE	1	TRUE	TRUE	1	1
FBgn0000492	163	206	129	125	292	331	FALSE	TRUE	TRUE	0	TRUE	TRUE	1	0
FBgn0000504	279	302	224	240	503	542	TRUE	TRUE	TRUE	1	TRUE	TRUE	1	1
FBgn0000527	277	289	250	226	527	515	TRUE	TRUE	TRUE	1	TRUE	TRUE	1	1
FBgn0000529	170	171	136	146	306	317	TRUE	TRUE	TRUE	1	TRUE	TRUE	1	1
FBgn0000533	38	53	38	22	76	75	TRUE	FALSE	TRUE	0	TRUE	FALSE	0	0
FBgn0000541	56	49	41	37	97	86	TRUE	TRUE	TRUE	1	TRUE	TRUE	1	1
FBgn0000543	252	244	140	127	392	371	TRUE	TRUE	TRUE	1	TRUE	TRUE	1	1
FBgn0000546	295	296	244	216	539	512	TRUE	TRUE	TRUE	1	TRUE	TRUE	1	1
FBgn0000547	586	542	507	479	1093	1021	TRUE	TRUE	TRUE	1	TRUE	TRUE	1	1
FBgn0000551	60	65	47	63	107	128	TRUE	TRUE	TRUE	1	TRUE	TRUE	1	1
FBgn0000552	55	33	45	35	100	68	FALSE	TRUE	FALSE	0	FALSE	TRUE	0	0
FBgn0000557	63	72	43	52	106	124	TRUE	TRUE	TRUE	1	TRUE	TRUE	1	1
FBgn0000560	23	20	21	17	44	37	TRUE	TRUE	TRUE	1	TRUE	TRUE	1	1
FBgn0000562	352	352	274	278	626	630	TRUE	TRUE	TRUE	1	TRUE	TRUE	1	1
FBgn0000564	67	78	66	62	133	140	TRUE	TRUE	TRUE	1	TRUE	TRUE	1	1
FBgn0000565	137	134	98	94	235	228	TRUE	TRUE	TRUE	1	TRUE	TRUE	1	1
FBgn0000566	119	113	117	105	236	218	TRUE	TRUE	TRUE	1	TRUE	TRUE	1	1
FBgn0000567	429	450	404	408	833	858	TRUE	TRUE	TRUE	1	TRUE	TRUE	1	1
FBgn0000568	625	633	568	536	1193	1169	TRUE	TRUE	TRUE	1	TRUE	TRUE	1	1
FBgn0000575	125	134	91	107	216	241	TRUE	TRUE	TRUE	1	TRUE	TRUE	1	1
FBgn0000576	145	128	109	108	254	236	TRUE	TRUE	TRUE	1	TRUE	TRUE	1	1
FBgn0000577	182	165	125	140	307	305	TRUE	TRUE	TRUE	1	TRUE	TRUE	1	1
FBgn0000578	576	527	449	487	1025	1014	TRUE	TRUE	TRUE	1	TRUE	TRUE	1	1
FBgn0000579	184	233	129	139	313	372	FALSE	TRUE	FALSE	0	TRUE	TRUE	1	0
FBgn0000581	535	516	462	438	997	954	TRUE	TRUE	TRUE	1	TRUE	TRUE	1	1
FBgn0000588	207	147	141	158	348	305	FALSE	TRUE	TRUE	0	TRUE	TRUE	1	0
FBgn0000591	91	94	61	69	152	163	TRUE	TRUE	TRUE	1	TRUE	TRUE	1	1
FBgn0000592	142	168	121	154	263	322	TRUE	FALSE	FALSE	0	TRUE	TRUE	1	0
FBgn0000606	41	31	30	32	71	63	TRUE	TRUE	TRUE	1	TRUE	TRUE	1	1
FBgn0000615	30	46	26	38	56	84	FALSE	TRUE	FALSE	0	FALSE	TRUE	0	0
FBgn0000625	237	251	225	223	462	474	TRUE	TRUE	TRUE	1	TRUE	TRUE	1	1
FBgn0000629	246	222	195	170	441	392	TRUE	TRUE	FALSE	0	TRUE	TRUE	1	0
FBgn0000633	641	621	562	555	1203	1176	TRUE	TRUE	TRUE	1	TRUE	TRUE	1	1
FBgn0000636	449	415	364	359	813	774	TRUE	TRUE	TRUE	1	TRUE	TRUE	1	1
FBgn0000639	220	214	153	161	373	375	TRUE	TRUE	TRUE	1	TRUE	TRUE	1	1
FBgn0000640	99	107	85	83	184	190	TRUE	TRUE	TRUE	1	TRUE	TRUE	1	1
FBgn0000658	162	172	109	150	271	322	TRUE	FALSE	FALSE	0	TRUE	TRUE	1	0
FBgn0000659	204	253	175	163	379	416	FALSE	TRUE	TRUE	0	TRUE	TRUE	1	0
FBgn0000662	139	153	111	115	250	268	TRUE	TRUE	TRUE	1	TRUE	TRUE	1	1
FBgn0000715	114	122	91	80	205	202	TRUE	TRUE	TRUE	1	TRUE	TRUE	1	1
FBgn0000721	604	595	489	541	1093	1136	TRUE	TRUE	TRUE	1	TRUE	TRUE	1	1
FBgn0000723	244	235	180	176	424	411	TRUE	TRUE	TRUE	1	TRUE	TRUE	1	1
FBgn0000964	121	122	110	115	231	237	TRUE	TRUE	TRUE	1	TRUE	TRUE	1	1
FBgn0000996	76	78	43	67	119	145	TRUE	FALSE	TRUE	0	TRUE	FALSE	0	0
FBgn0001075	1328	1474	1178	1305	2506	2779	FALSE	FALSE	FALSE	0	TRUE	TRUE	1	0
FBgn0001077	61	78	50	58	111	136	TRUE	TRUE	TRUE	1	TRUE	TRUE	1	1
FBgn0001078	99	121	99	87	198	208	TRUE	TRUE	TRUE	1	TRUE	TRUE	1	1
FBgn0001084	89	107	87	83	176	190	TRUE	TRUE	TRUE	1	TRUE	TRUE	1	1
FBgn0001085	226	209	220	227	446	436	TRUE	TRUE	TRUE	1	TRUE	TRUE	1	1
FBgn0001086	150	135	115	117	265	252	TRUE	TRUE	TRUE	1	TRUE	TRUE	1	1
FBgn0001089	35	41	29	30	64	71	TRUE	TRUE	TRUE	1	TRUE	TRUE	1	1
FBgn0001091	50	33	39	39	89	72	FALSE	TRUE	TRUE	0	FALSE	TRUE	0	0
FBgn0001098	206	208	218	171	424	379	TRUE	FALSE	TRUE	0	TRUE	TRUE	1	0
FBgn0001104	212	199	161	187	373	386	TRUE	TRUE	TRUE	1	TRUE	TRUE	1	1
FBgn0001108	379	343	297	307	676	650	TRUE	TRUE	TRUE	1	TRUE	TRUE	1	1
FBgn0001112	113	138	105	117	218	255	TRUE	TRUE	FALSE	0	TRUE	TRUE	1	0
FBgn0001114	169	160	139	130	308	290	TRUE	TRUE	TRUE	1	TRUE	TRUE	1	1
FBgn0001120	17	14	19	16	36	30	TRUE	TRUE	TRUE	1	TRUE	TRUE	1	1
FBgn0001122	429	412	367	389	796	801	TRUE	TRUE	TRUE	1	TRUE	TRUE	1	1
FBgn0001123	152	160	132	117	284	277	TRUE	TRUE	TRUE	1	TRUE	TRUE	1	1
FBgn0001124	201	203	171	140	372	343	TRUE	FALSE	TRUE	0	TRUE	TRUE	1	0
FBgn0001125	175	174	148	141	323	315	TRUE	TRUE	TRUE	1	TRUE	TRUE	1	1
FBgn0001128	201	178	125	176	326	354	TRUE	FALSE	TRUE	0	TRUE	TRUE	1	0
FBgn0001133	161	186	122	124	283	310	TRUE	TRUE	TRUE	1	TRUE	TRUE	1	1
FBgn0001134	214	228	195	174	409	402	TRUE	TRUE	TRUE	1	TRUE	TRUE	1	1
FBgn0001137	84	86	76	67	160	153	TRUE	TRUE	TRUE	1	TRUE	TRUE	1	1
FBgn0001138	114	123	84	98	198	221	TRUE	TRUE	TRUE	1	TRUE	TRUE	1	1
FBgn0001139	386	334	269	264	655	598	FALSE	TRUE	TRUE	0	TRUE	TRUE	1	0
FBgn0001142	86	47	82	51	168	98	FALSE	FALSE	FALSE	0	FALSE	FALSE	0	0
FBgn0001147	61	61	57	66	118	127	TRUE	TRUE	TRUE	1	TRUE	TRUE	1	1
FBgn0001148	44	49	43	44	87	93	TRUE	TRUE	TRUE	1	TRUE	TRUE	1	1
FBgn0001149	115	90	72	83	187	173	FALSE	TRUE	TRUE	0	TRUE	TRUE	1	0
FBgn0001168	240	226	104	85	344	311	TRUE	TRUE	TRUE	1	TRUE	TRUE	1	1
FBgn0001169	309	323	258	243	567	566	TRUE	TRUE	TRUE	1	TRUE	TRUE	1	1
FBgn0001170	198	202	157	147	355	349	TRUE	TRUE	TRUE	1	TRUE	TRUE	1	1
FBgn0001174	67	65	45	47	112	112	TRUE	TRUE	TRUE	1	TRUE	TRUE	1	1
FBgn0001179	195	155	139	149	334	304	FALSE	TRUE	TRUE	0	TRUE	TRUE	1	0
FBgn0001180	106	90	81	89	187	179	TRUE	TRUE	TRUE	1	TRUE	TRUE	1	1
FBgn0001185	78	86	81	65	159	151	TRUE	TRUE	TRUE	1	TRUE	TRUE	1	1
FBgn0001187	83	93	72	63	155	156	TRUE	TRUE	TRUE	1	TRUE	TRUE	1	1
FBgn0001197	148	118	103	107	251	225	FALSE	TRUE	TRUE	0	TRUE	TRUE	1	0
FBgn0001202	82	82	68	75	150	157	TRUE	TRUE	TRUE	1	TRUE	TRUE	1	1
FBgn0001208	221	216	151	153	372	369	TRUE	TRUE	TRUE	1	TRUE	TRUE	1	1
FBgn0001215	144	155	119	142	263	297	TRUE	TRUE	TRUE	1	TRUE	TRUE	1	1
FBgn0001216	199	224	166	136	365	360	TRUE	FALSE	TRUE	0	TRUE	TRUE	1	0
FBgn0001217	41	38	42	33	83	71	TRUE	TRUE	TRUE	1	TRUE	TRUE	1	1
FBgn0001220	187	193	178	166	365	359	TRUE	TRUE	TRUE	1	TRUE	TRUE	1	1
FBgn0001222	223	294	214	233	437	527	FALSE	TRUE	FALSE	0	TRUE	TRUE	1	0
FBgn0001224	72	103	68	78	140	181	FALSE	TRUE	FALSE	0	TRUE	TRUE	1	0
FBgn0001225	113	79	78	94	191	173	FALSE	TRUE	TRUE	0	TRUE	TRUE	1	0
FBgn0001227	15	17	18	27	33	44	TRUE	TRUE	TRUE	1	TRUE	TRUE	1	1
FBgn0001229	73	51	66	67	139	118	FALSE	TRUE	TRUE	0	TRUE	TRUE	1	0
FBgn0001230	107	107	84	76	191	183	TRUE	TRUE	TRUE	1	TRUE	TRUE	1	1
FBgn0001233	103	94	91	90	194	184	TRUE	TRUE	TRUE	1	TRUE	TRUE	1	1
FBgn0001234	593	557	517	486	1110	1043	TRUE	TRUE	TRUE	1	TRUE	TRUE	1	1
FBgn0001235	691	655	603	573	1294	1228	TRUE	TRUE	TRUE	1	TRUE	TRUE	1	1
FBgn0001247	99	123	96	89	195	212	TRUE	TRUE	TRUE	1	TRUE	TRUE	1	1
FBgn0001248	162	154	140	135	302	289	TRUE	TRUE	TRUE	1	TRUE	TRUE	1	1
FBgn0001253	455	482	434	389	889	871	TRUE	TRUE	TRUE	1	TRUE	TRUE	1	1
FBgn0001254	135	154	136	142	271	296	TRUE	TRUE	TRUE	1	TRUE	TRUE	1	1
FBgn0001255	66	92	52	63	118	155	FALSE	TRUE	FALSE	0	TRUE	TRUE	1	0
FBgn0001256	139	145	113	107	252	252	TRUE	TRUE	TRUE	1	TRUE	TRUE	1	1
FBgn0001257	145	161	132	129	277	290	TRUE	TRUE	TRUE	1	TRUE	TRUE	1	1
FBgn0001258	124	128	80	110	204	238	TRUE	FALSE	TRUE	0	TRUE	TRUE	1	0
FBgn0001259	131	119	87	95	218	214	TRUE	TRUE	TRUE	1	TRUE	TRUE	1	1
FBgn0001263	187	227	169	167	356	394	FALSE	TRUE	TRUE	0	TRUE	TRUE	1	0
FBgn0001269	379	356	302	334	681	690	TRUE	TRUE	TRUE	1	TRUE	TRUE	1	1
FBgn0001280	65	37	50	49	115	86	FALSE	TRUE	FALSE	0	FALSE	TRUE	0	0
FBgn0001281	56	54	42	41	98	95	TRUE	TRUE	TRUE	1	TRUE	TRUE	1	1
FBgn0001285	27	25	17	14	44	39	TRUE	TRUE	TRUE	1	TRUE	TRUE	1	1
FBgn0001291	63	51	63	49	126	100	TRUE	TRUE	FALSE	0	TRUE	TRUE	1	0
FBgn0001296	190	181	148	153	338	334	TRUE	TRUE	TRUE	1	TRUE	TRUE	1	1
FBgn0001297	467	485	430	373	897	858	TRUE	FALSE	TRUE	0	TRUE	TRUE	1	0
FBgn0001301	347	347	347	298	694	645	TRUE	FALSE	TRUE	0	TRUE	TRUE	1	0
FBgn0001308	151	166	167	128	318	294	TRUE	FALSE	TRUE	0	TRUE	TRUE	1	0
FBgn0001311	118	115	119	84	237	199	TRUE	FALSE	FALSE	0	TRUE	TRUE	1	0
FBgn0001316	886	953	714	758	1600	1711	TRUE	TRUE	FALSE	0	TRUE	TRUE	1	0
FBgn0001319	335	337	250	303	585	640	TRUE	FALSE	TRUE	0	TRUE	TRUE	1	0
FBgn0001320	45	46	29	25	74	71	TRUE	TRUE	TRUE	1	TRUE	TRUE	1	1
FBgn0001321	48	32	18	32	66	64	FALSE	FALSE	TRUE	0	TRUE	FALSE	0	0
FBgn0001323	51	58	48	31	99	89	TRUE	FALSE	TRUE	0	TRUE	FALSE	0	0
FBgn0001324	253	245	179	171	432	416	TRUE	TRUE	TRUE	1	TRUE	TRUE	1	1
FBgn0001325	320	257	218	214	538	471	FALSE	TRUE	FALSE	0	TRUE	TRUE	1	0
FBgn0001941	176	202	139	149	315	351	TRUE	TRUE	TRUE	1	TRUE	TRUE	1	1
FBgn0001942	130	162	88	102	218	264	FALSE	TRUE	FALSE	0	TRUE	TRUE	1	0
FBgn0001961	72	53	52	59	124	112	TRUE	TRUE	TRUE	1	TRUE	TRUE	1	1
FBgn0001965	242	248	193	193	435	441	TRUE	TRUE	TRUE	1	TRUE	TRUE	1	1
FBgn0001977	101	125	88	105	189	230	TRUE	TRUE	FALSE	0	TRUE	TRUE	1	0
FBgn0001978	274	317	249	233	523	550	FALSE	TRUE	TRUE	0	TRUE	TRUE	1	0
FBgn0001981	165	157	128	103	293	260	TRUE	TRUE	TRUE	1	TRUE	TRUE	1	1
FBgn0001983	159	145	160	146	319	291	TRUE	TRUE	TRUE	1	TRUE	TRUE	1	1
FBgn0001986	206	178	182	154	388	332	TRUE	TRUE	FALSE	0	TRUE	TRUE	1	0
FBgn0001987	430	414	361	344	791	758	TRUE	TRUE	TRUE	1	TRUE	TRUE	1	1
FBgn0001989	157	141	121	119	278	260	TRUE	TRUE	TRUE	1	TRUE	TRUE	1	1
FBgn0001990	191	182	161	168	352	350	TRUE	TRUE	TRUE	1	TRUE	TRUE	1	1
FBgn0001991	921	929	839	787	1760	1716	TRUE	TRUE	TRUE	1	TRUE	TRUE	1	1
FBgn0001992	145	133	124	120	269	253	TRUE	TRUE	TRUE	1	TRUE	TRUE	1	1
FBgn0001994	257	269	215	209	472	478	TRUE	TRUE	TRUE	1	TRUE	TRUE	1	1
FBgn0001995	60	83	71	65	131	148	FALSE	TRUE	TRUE	0	TRUE	TRUE	1	0
FBgn0002021	58	49	62	51	120	100	TRUE	TRUE	TRUE	1	TRUE	TRUE	1	1
FBgn0002022	41	50	49	38	90	88	TRUE	TRUE	TRUE	1	TRUE	TRUE	1	1
FBgn0002023	274	313	272	237	546	550	TRUE	TRUE	TRUE	1	TRUE	TRUE	1	1
FBgn0002031	199	176	135	150	334	326	TRUE	TRUE	TRUE	1	TRUE	TRUE	1	1
FBgn0002036	122	93	82	74	204	167	FALSE	TRUE	FALSE	0	TRUE	TRUE	1	0
FBgn0002044	61	84	60	72	121	156	FALSE	TRUE	FALSE	0	TRUE	TRUE	1	0
FBgn0002069	89	68	47	61	136	129	TRUE	TRUE	TRUE	1	TRUE	TRUE	1	1
FBgn0002121	257	183	184	189	441	372	FALSE	TRUE	FALSE	0	TRUE	TRUE	1	0
FBgn0002174	139	131	116	98	255	229	TRUE	TRUE	TRUE	1	TRUE	TRUE	1	1
FBgn0002183	260	316	221	263	481	579	FALSE	FALSE	FALSE	0	TRUE	TRUE	1	0
FBgn0002283	16	28	16	24	32	52	FALSE	TRUE	FALSE	0	FALSE	TRUE	0	0
FBgn0002306	223	219	192	166	415	385	TRUE	TRUE	TRUE	1	TRUE	TRUE	1	1
FBgn0002354	56	52	56	68	112	120	TRUE	TRUE	TRUE	1	TRUE	TRUE	1	1
FBgn0002413	282	272	218	205	500	477	TRUE	TRUE	TRUE	1	TRUE	TRUE	1	1
FBgn0002431	23	21	32	24	55	45	TRUE	TRUE	TRUE	1	TRUE	TRUE	1	1
FBgn0002440	106	102	95	78	201	180	TRUE	TRUE	TRUE	1	TRUE	TRUE	1	1
FBgn0002441	375	368	307	303	682	671	TRUE	TRUE	TRUE	1	TRUE	TRUE	1	1
FBgn0002466	443	422	316	307	759	729	TRUE	TRUE	TRUE	1	TRUE	TRUE	1	1
FBgn0002522	131	125	103	106	234	231	TRUE	TRUE	TRUE	1	TRUE	TRUE	1	1
FBgn0002524	222	238	202	181	424	419	TRUE	TRUE	TRUE	1	TRUE	TRUE	1	1
FBgn0002525	229	232	189	178	418	410	TRUE	TRUE	TRUE	1	TRUE	TRUE	1	1
FBgn0002526	474	486	343	348	817	834	TRUE	TRUE	TRUE	1	TRUE	TRUE	1	1
FBgn0002531	59	62	31	45	90	107	TRUE	TRUE	TRUE	1	TRUE	TRUE	1	1
FBgn0002533	75	81	62	53	137	134	TRUE	TRUE	TRUE	1	TRUE	TRUE	1	1
FBgn0002534	41	31	22	28	63	59	TRUE	TRUE	TRUE	1	TRUE	TRUE	1	1
FBgn0002535	100	93	69	79	169	172	TRUE	TRUE	TRUE	1	TRUE	TRUE	1	1
FBgn0002542	46	43	25	37	71	80	TRUE	TRUE	TRUE	1	TRUE	TRUE	1	1
FBgn0002543	339	312	249	252	588	564	TRUE	TRUE	TRUE	1	TRUE	TRUE	1	1
FBgn0002552	27	37	27	28	54	65	TRUE	TRUE	TRUE	1	TRUE	TRUE	1	1
FBgn0002563	152	151	131	144	283	295	TRUE	TRUE	TRUE	1	TRUE	TRUE	1	1
FBgn0002564	34	37	29	15	63	52	TRUE	FALSE	TRUE	0	TRUE	FALSE	0	0
FBgn0002565	28	33	20	19	48	52	TRUE	TRUE	TRUE	1	TRUE	TRUE	1	1
FBgn0002566	203	200	179	124	382	324	TRUE	FALSE	FALSE	0	TRUE	TRUE	1	0
FBgn0002567	213	194	163	156	376	350	TRUE	TRUE	TRUE	1	TRUE	TRUE	1	1
FBgn0002569	65	112	48	92	113	204	FALSE	FALSE	FALSE	0	FALSE	FALSE	0	0
FBgn0002570	88	120	56	70	144	190	FALSE	TRUE	FALSE	0	TRUE	TRUE	1	0
FBgn0002571	94	88	88	78	182	166	TRUE	TRUE	TRUE	1	TRUE	TRUE	1	1
FBgn0002573	198	195	163	183	361	378	TRUE	TRUE	TRUE	1	TRUE	TRUE	1	1
FBgn0002578	62	54	55	60	117	114	TRUE	TRUE	TRUE	1	TRUE	TRUE	1	1
FBgn0002592	63	44	33	38	96	82	FALSE	TRUE	TRUE	0	TRUE	TRUE	1	0
FBgn0002593	46	52	43	35	89	87	TRUE	TRUE	TRUE	1	TRUE	TRUE	1	1
FBgn0002609	86	96	87	75	173	171	TRUE	TRUE	TRUE	1	TRUE	TRUE	1	1
FBgn0002622	92	71	65	70	157	141	TRUE	TRUE	TRUE	1	TRUE	TRUE	1	1
FBgn0002626	65	77	71	63	136	140	TRUE	TRUE	TRUE	1	TRUE	TRUE	1	1
FBgn0002629	51	44	48	45	99	89	TRUE	TRUE	TRUE	1	TRUE	TRUE	1	1
FBgn0002631	60	71	50	60	110	131	TRUE	TRUE	TRUE	1	TRUE	TRUE	1	1
FBgn0002632	106	109	107	81	213	190	TRUE	FALSE	TRUE	0	TRUE	TRUE	1	0
FBgn0002633	61	50	40	43	101	93	TRUE	TRUE	TRUE	1	TRUE	TRUE	1	1
FBgn0002638	176	180	132	143	308	323	TRUE	TRUE	TRUE	1	TRUE	TRUE	1	1
FBgn0002643	574	603	495	480	1069	1083	TRUE	TRUE	TRUE	1	TRUE	TRUE	1	1
FBgn0002645	88	82	85	86	173	168	TRUE	TRUE	TRUE	1	TRUE	TRUE	1	1
FBgn0002673	109	122	90	81	199	203	TRUE	TRUE	TRUE	1	TRUE	TRUE	1	1
FBgn0002715	114	109	85	79	199	188	TRUE	TRUE	TRUE	1	TRUE	TRUE	1	1
FBgn0002716	87	112	67	61	154	173	FALSE	TRUE	TRUE	0	TRUE	TRUE	1	0
FBgn0002719	167	161	142	135	309	296	TRUE	TRUE	TRUE	1	TRUE	TRUE	1	1
FBgn0002732	66	56	61	51	127	107	TRUE	TRUE	TRUE	1	TRUE	TRUE	1	1
FBgn0002733	61	79	55	55	116	134	TRUE	TRUE	TRUE	1	TRUE	TRUE	1	1
FBgn0002734	87	97	71	72	158	169	TRUE	TRUE	TRUE	1	TRUE	TRUE	1	1
FBgn0002735	56	56	54	45	110	101	TRUE	TRUE	TRUE	1	TRUE	TRUE	1	1
FBgn0002736	49	53	55	49	104	102	TRUE	TRUE	TRUE	1	TRUE	TRUE	1	1
FBgn0002772	90	92	89	79	179	171	TRUE	TRUE	TRUE	1	TRUE	TRUE	1	1
FBgn0002773	82	96	51	68	133	164	TRUE	TRUE	FALSE	0	TRUE	TRUE	1	0
FBgn0002774	154	148	122	103	276	251	TRUE	TRUE	TRUE	1	TRUE	TRUE	1	1
FBgn0002775	173	164	131	139	304	303	TRUE	TRUE	TRUE	1	TRUE	TRUE	1	1
FBgn0002778	211	211	187	190	398	401	TRUE	TRUE	TRUE	1	TRUE	TRUE	1	1
FBgn0002781	447	449	367	372	814	821	TRUE	TRUE	TRUE	1	TRUE	TRUE	1	1
FBgn0002783	30	41	33	31	63	72	TRUE	TRUE	TRUE	1	TRUE	TRUE	1	1
FBgn0002787	98	89	88	89	186	178	TRUE	TRUE	TRUE	1	TRUE	TRUE	1	1
FBgn0002789	56	60	59	43	115	103	TRUE	TRUE	TRUE	1	TRUE	TRUE	1	1
FBgn0002791	205	185	150	148	355	333	TRUE	TRUE	TRUE	1	TRUE	TRUE	1	1
FBgn0002838	29	27	21	21	50	48	TRUE	TRUE	TRUE	1	TRUE	TRUE	1	1
FBgn0002842	27	26	27	18	54	44	TRUE	TRUE	TRUE	1	TRUE	TRUE	1	1
FBgn0002855	65	51	43	41	108	92	TRUE	TRUE	TRUE	1	TRUE	TRUE	1	1
FBgn0002856	39	50	49	50	88	100	TRUE	TRUE	TRUE	1	TRUE	TRUE	1	1
FBgn0002862	39	33	42	35	81	68	TRUE	TRUE	TRUE	1	TRUE	TRUE	1	1
FBgn0002865	68	77	48	41	116	118	TRUE	TRUE	TRUE	1	TRUE	TRUE	1	1
FBgn0002869	27	31	24	22	51	53	TRUE	TRUE	TRUE	1	TRUE	TRUE	1	1
FBgn0002872	348	278	266	234	614	512	FALSE	TRUE	FALSE	0	TRUE	TRUE	1	0
FBgn0002887	247	241	173	215	420	456	TRUE	FALSE	TRUE	0	TRUE	TRUE	1	0
FBgn0002891	334	342	288	288	622	630	TRUE	TRUE	TRUE	1	TRUE	TRUE	1	1
FBgn0002899	210	198	166	204	376	402	TRUE	FALSE	TRUE	0	TRUE	TRUE	1	0
FBgn0002901	222	283	186	216	408	499	FALSE	TRUE	FALSE	0	TRUE	TRUE	1	0
FBgn0002905	200	198	154	165	354	363	TRUE	TRUE	TRUE	1	TRUE	TRUE	1	1
FBgn0002906	101	103	78	69	179	172	TRUE	TRUE	TRUE	1	TRUE	TRUE	1	1
FBgn0002921	414	435	307	306	721	741	TRUE	TRUE	TRUE	1	TRUE	TRUE	1	1
FBgn0002922	134	136	100	105	234	241	TRUE	TRUE	TRUE	1	TRUE	TRUE	1	1
FBgn0002924	162	158	141	130	303	288	TRUE	TRUE	TRUE	1	TRUE	TRUE	1	1
FBgn0002926	397	385	389	333	786	718	TRUE	FALSE	FALSE	0	TRUE	TRUE	1	0
FBgn0002930	54	71	44	62	98	133	TRUE	FALSE	FALSE	0	TRUE	TRUE	1	0
FBgn0002931	71	57	45	44	116	101	TRUE	TRUE	TRUE	1	TRUE	TRUE	1	1
FBgn0002932	24	27	21	28	45	55	TRUE	TRUE	TRUE	1	TRUE	TRUE	1	1
FBgn0002937	133	149	107	112	240	261	TRUE	TRUE	TRUE	1	TRUE	TRUE	1	1
FBgn0002938	472	474	387	373	859	847	TRUE	TRUE	TRUE	1	TRUE	TRUE	1	1
FBgn0002939	64	64	53	45	117	109	TRUE	TRUE	TRUE	1	TRUE	TRUE	1	1
FBgn0002940	169	190	149	143	318	333	TRUE	TRUE	TRUE	1	TRUE	TRUE	1	1
FBgn0002941	147	139	154	139	301	278	TRUE	TRUE	TRUE	1	TRUE	TRUE	1	1
FBgn0002945	340	327	269	268	609	595	TRUE	TRUE	TRUE	1	TRUE	TRUE	1	1
FBgn0002962	96	82	67	88	163	170	TRUE	TRUE	TRUE	1	TRUE	TRUE	1	1
FBgn0002973	417	380	344	343	761	723	TRUE	TRUE	TRUE	1	TRUE	TRUE	1	1
FBgn0002985	67	88	45	60	112	148	TRUE	TRUE	FALSE	0	TRUE	TRUE	1	0
FBgn0002989	175	142	141	119	316	261	FALSE	TRUE	FALSE	0	TRUE	TRUE	1	0
FBgn0003002	44	34	25	40	69	74	TRUE	FALSE	TRUE	0	TRUE	FALSE	0	0
FBgn0003008	25	47	24	18	49	65	FALSE	TRUE	TRUE	0	FALSE	TRUE	0	0
FBgn0003009	285	302	264	249	549	551	TRUE	TRUE	TRUE	1	TRUE	TRUE	1	1
FBgn0003011	196	167	161	160	357	327	TRUE	TRUE	TRUE	1	TRUE	TRUE	1	1
FBgn0003016	383	347	329	313	712	660	TRUE	TRUE	TRUE	1	TRUE	TRUE	1	1
FBgn0003034	20	16	22	21	42	37	TRUE	TRUE	TRUE	1	TRUE	TRUE	1	1
FBgn0003041	595	609	513	507	1108	1116	TRUE	TRUE	TRUE	1	TRUE	TRUE	1	1
FBgn0003042	41	39	35	18	76	57	TRUE	FALSE	TRUE	0	TRUE	FALSE	0	0
FBgn0003044	271	275	243	235	514	510	TRUE	TRUE	TRUE	1	TRUE	TRUE	1	1
FBgn0003046	63	70	55	54	118	124	TRUE	TRUE	TRUE	1	TRUE	TRUE	1	1
FBgn0003060	53	64	44	34	97	98	TRUE	TRUE	TRUE	1	TRUE	TRUE	1	1
FBgn0003062	106	106	78	89	184	195	TRUE	TRUE	TRUE	1	TRUE	TRUE	1	1
FBgn0003065	17	22	27	19	44	41	TRUE	TRUE	TRUE	1	TRUE	TRUE	1	1
FBgn0003071	243	189	195	179	438	368	FALSE	TRUE	FALSE	0	TRUE	TRUE	1	0
FBgn0003074	106	118	108	74	214	192	TRUE	FALSE	TRUE	0	TRUE	TRUE	1	0
FBgn0003076	73	64	83	63	156	127	TRUE	TRUE	FALSE	0	TRUE	TRUE	1	0
FBgn0003082	87	85	62	68	149	153	TRUE	TRUE	TRUE	1	TRUE	TRUE	1	1
FBgn0003087	97	109	88	83	185	192	TRUE	TRUE	TRUE	1	TRUE	TRUE	1	1
FBgn0003089	567	551	519	453	1086	1004	TRUE	FALSE	FALSE	0	TRUE	TRUE	1	0
FBgn0003090	377	417	318	364	695	781	TRUE	FALSE	FALSE	0	TRUE	TRUE	1	0
FBgn0003091	620	506	451	400	1071	906	FALSE	FALSE	FALSE	0	TRUE	TRUE	1	0
FBgn0003093	377	352	277	298	654	650	TRUE	TRUE	TRUE	1	TRUE	TRUE	1	1
FBgn0003114	76	72	69	50	145	122	TRUE	FALSE	TRUE	0	TRUE	TRUE	1	0
FBgn0003117	319	303	238	249	557	552	TRUE	TRUE	TRUE	1	TRUE	TRUE	1	1
FBgn0003118	334	361	326	296	660	657	TRUE	TRUE	TRUE	1	TRUE	TRUE	1	1
FBgn0003124	85	109	72	84	157	193	FALSE	TRUE	FALSE	0	TRUE	TRUE	1	0
FBgn0003129	73	61	53	52	126	113	TRUE	TRUE	TRUE	1	TRUE	TRUE	1	1
FBgn0003130	212	193	177	161	389	354	TRUE	TRUE	TRUE	1	TRUE	TRUE	1	1
FBgn0003134	90	81	73	67	163	148	TRUE	TRUE	TRUE	1	TRUE	TRUE	1	1
FBgn0003137	401	409	345	379	746	788	TRUE	TRUE	TRUE	1	TRUE	TRUE	1	1
FBgn0003140	109	128	77	100	186	228	TRUE	FALSE	FALSE	0	TRUE	TRUE	1	0
FBgn0003141	102	97	107	88	209	185	TRUE	TRUE	TRUE	1	TRUE	TRUE	1	1
FBgn0003145	150	167	132	137	282	304	TRUE	TRUE	TRUE	1	TRUE	TRUE	1	1
FBgn0003149	5288	5442	417	377	5705	5819	TRUE	TRUE	TRUE	1	TRUE	TRUE	1	1
FBgn0003162	219	191	161	148	380	339	TRUE	TRUE	TRUE	1	TRUE	TRUE	1	1
FBgn0003165	665	609	484	475	1149	1084	TRUE	TRUE	TRUE	1	TRUE	TRUE	1	1
FBgn0003169	210	223	218	189	428	412	TRUE	TRUE	TRUE	1	TRUE	TRUE	1	1
FBgn0003174	164	146	112	128	276	274	TRUE	TRUE	TRUE	1	TRUE	TRUE	1	1
FBgn0003175	903	869	728	791	1631	1660	TRUE	TRUE	TRUE	1	TRUE	TRUE	1	1
FBgn0003187	241	206	164	209	405	415	TRUE	FALSE	TRUE	0	TRUE	TRUE	1	0
FBgn0003205	55	52	46	60	101	112	TRUE	TRUE	TRUE	1	TRUE	TRUE	1	1
FBgn0003206	122	110	101	87	223	197	TRUE	TRUE	TRUE	1	TRUE	TRUE	1	1
FBgn0003209	482	481	399	389	881	870	TRUE	TRUE	TRUE	1	TRUE	TRUE	1	1
FBgn0003227	48	56	41	37	89	93	TRUE	TRUE	TRUE	1	TRUE	TRUE	1	1
FBgn0003231	60	79	51	53	111	132	TRUE	TRUE	TRUE	1	TRUE	TRUE	1	1
FBgn0003248	143	152	134	111	277	263	TRUE	TRUE	TRUE	1	TRUE	TRUE	1	1
FBgn0003249	28	32	26	24	54	56	TRUE	TRUE	TRUE	1	TRUE	TRUE	1	1
FBgn0003250	79	78	75	61	154	139	TRUE	TRUE	TRUE	1	TRUE	TRUE	1	1
FBgn0003254	251	290	193	207	444	497	TRUE	TRUE	FALSE	0	TRUE	TRUE	1	0
FBgn0003255	429	396	382	346	811	742	TRUE	TRUE	FALSE	0	TRUE	TRUE	1	0
FBgn0003256	47	67	59	56	106	123	FALSE	TRUE	TRUE	0	TRUE	TRUE	1	0
FBgn0003257	123	133	127	102	250	235	TRUE	TRUE	TRUE	1	TRUE	TRUE	1	1
FBgn0003261	110	81	81	68	191	149	FALSE	TRUE	FALSE	0	TRUE	TRUE	1	0
FBgn0003267	85	75	74	65	159	140	TRUE	TRUE	TRUE	1	TRUE	TRUE	1	1
FBgn0003268	277	265	189	207	466	472	TRUE	TRUE	TRUE	1	TRUE	TRUE	1	1
FBgn0003270	47	56	45	47	92	103	TRUE	TRUE	TRUE	1	TRUE	TRUE	1	1
FBgn0003274	67	45	52	70	119	115	FALSE	TRUE	TRUE	0	TRUE	TRUE	1	0
FBgn0003278	93	104	65	70	158	174	TRUE	TRUE	TRUE	1	TRUE	TRUE	1	1
FBgn0003279	113	121	112	98	225	219	TRUE	TRUE	TRUE	1	TRUE	TRUE	1	1
FBgn0003292	216	205	188	179	404	384	TRUE	TRUE	TRUE	1	TRUE	TRUE	1	1
FBgn0003295	214	211	177	186	391	397	TRUE	TRUE	TRUE	1	TRUE	TRUE	1	1
FBgn0003308	280	259	250	230	530	489	TRUE	TRUE	TRUE	1	TRUE	TRUE	1	1
FBgn0003310	359	395	314	276	673	671	TRUE	TRUE	TRUE	1	TRUE	TRUE	1	1
FBgn0003312	99	76	83	85	182	161	FALSE	TRUE	TRUE	0	TRUE	TRUE	1	0
FBgn0003317	83	86	78	62	161	148	TRUE	TRUE	TRUE	1	TRUE	TRUE	1	1
FBgn0003319	172	196	139	176	311	372	TRUE	FALSE	FALSE	0	TRUE	TRUE	1	0
FBgn0003326	268	236	207	210	475	446	TRUE	TRUE	TRUE	1	TRUE	TRUE	1	1
FBgn0003330	120	114	74	91	194	205	TRUE	TRUE	TRUE	1	TRUE	TRUE	1	1
FBgn0003334	45	39	27	29	72	68	TRUE	TRUE	TRUE	1	TRUE	TRUE	1	1
FBgn0003339	183	192	187	161	370	353	TRUE	TRUE	TRUE	1	TRUE	TRUE	1	1
FBgn0003346	104	117	92	91	196	208	TRUE	TRUE	TRUE	1	TRUE	TRUE	1	1
FBgn0003353	232	204	149	200	381	404	TRUE	FALSE	TRUE	0	TRUE	TRUE	1	0
FBgn0003356	61	29	67	30	128	59	FALSE	FALSE	FALSE	0	FALSE	FALSE	0	0
FBgn0003357	64	31	45	22	109	53	FALSE	FALSE	FALSE	0	FALSE	FALSE	0	0
FBgn0003358	102	82	85	61	187	143	TRUE	FALSE	FALSE	0	TRUE	TRUE	1	0
FBgn0003372	94	113	73	85	167	198	TRUE	TRUE	TRUE	1	TRUE	TRUE	1	1
FBgn0003375	91	103	78	71	169	174	TRUE	TRUE	TRUE	1	TRUE	TRUE	1	1
FBgn0003378	41	46	29	22	70	68	TRUE	TRUE	TRUE	1	TRUE	TRUE	1	1
FBgn0003382	479	458	453	457	932	915	TRUE	TRUE	TRUE	1	TRUE	TRUE	1	1
FBgn0003386	333	312	282	259	615	571	TRUE	TRUE	TRUE	1	TRUE	TRUE	1	1
FBgn0003388	189	159	175	149	364	308	TRUE	TRUE	FALSE	0	TRUE	TRUE	1	0
FBgn0003391	454	433	368	355	822	788	TRUE	TRUE	TRUE	1	TRUE	TRUE	1	1
FBgn0003396	597	568	501	446	1098	1014	TRUE	FALSE	FALSE	0	TRUE	TRUE	1	0
FBgn0003401	78	90	66	54	144	144	TRUE	TRUE	TRUE	1	TRUE	TRUE	1	1
FBgn0003410	179	170	144	159	323	329	TRUE	TRUE	TRUE	1	TRUE	TRUE	1	1
FBgn0003415	195	209	165	170	360	379	TRUE	TRUE	TRUE	1	TRUE	TRUE	1	1
FBgn0003429	807	775	693	672	1500	1447	TRUE	TRUE	TRUE	1	TRUE	TRUE	1	1
FBgn0003430	137	112	100	108	237	220	TRUE	TRUE	TRUE	1	TRUE	TRUE	1	1
FBgn0003435	909	891	697	712	1606	1603	TRUE	TRUE	TRUE	1	TRUE	TRUE	1	1
FBgn0003444	80	67	62	55	142	122	TRUE	TRUE	TRUE	1	TRUE	TRUE	1	1
FBgn0003448	107	128	103	88	210	216	TRUE	TRUE	TRUE	1	TRUE	TRUE	1	1
FBgn0003450	135	142	96	101	231	243	TRUE	TRUE	TRUE	1	TRUE	TRUE	1	1
FBgn0003459	210	239	229	250	439	489	TRUE	TRUE	TRUE	1	TRUE	TRUE	1	1
FBgn0003460	208	154	137	130	345	284	FALSE	TRUE	FALSE	0	TRUE	TRUE	1	0
FBgn0003462	81	75	62	54	143	129	TRUE	TRUE	TRUE	1	TRUE	TRUE	1	1
FBgn0003475	481	419	387	443	868	862	FALSE	FALSE	TRUE	0	TRUE	TRUE	1	0
FBgn0003479	81	86	76	61	157	147	TRUE	TRUE	TRUE	1	TRUE	TRUE	1	1
FBgn0003480	98	99	88	97	186	196	TRUE	TRUE	TRUE	1	TRUE	TRUE	1	1
FBgn0003482	74	68	47	51	121	119	TRUE	TRUE	TRUE	1	TRUE	TRUE	1	1
FBgn0003486	162	167	132	131	294	298	TRUE	TRUE	TRUE	1	TRUE	TRUE	1	1
FBgn0003495	162	182	137	135	299	317	TRUE	TRUE	TRUE	1	TRUE	TRUE	1	1
FBgn0003499	535	526	456	423	991	949	TRUE	TRUE	TRUE	1	TRUE	TRUE	1	1
FBgn0003502	671	682	576	549	1247	1231	TRUE	TRUE	TRUE	1	TRUE	TRUE	1	1
FBgn0003507	170	174	126	144	296	318	TRUE	TRUE	TRUE	1	TRUE	TRUE	1	1
FBgn0003512	75	74	64	58	139	132	TRUE	TRUE	TRUE	1	TRUE	TRUE	1	1
FBgn0003513	385	380	308	298	693	678	TRUE	TRUE	TRUE	1	TRUE	TRUE	1	1
FBgn0003515	216	230	167	175	383	405	TRUE	TRUE	TRUE	1	TRUE	TRUE	1	1
FBgn0003520	327	358	319	287	646	645	TRUE	TRUE	TRUE	1	TRUE	TRUE	1	1
FBgn0003525	240	274	191	228	431	502	TRUE	FALSE	FALSE	0	TRUE	TRUE	1	0
FBgn0003527	74	74	64	57	138	131	TRUE	TRUE	TRUE	1	TRUE	TRUE	1	1
FBgn0003545	76	83	80	70	156	153	TRUE	TRUE	TRUE	1	TRUE	TRUE	1	1
FBgn0003557	75	73	68	73	143	146	TRUE	TRUE	TRUE	1	TRUE	TRUE	1	1
FBgn0003567	231	238	208	188	439	426	TRUE	TRUE	TRUE	1	TRUE	TRUE	1	1
FBgn0003598	80	70	57	59	137	129	TRUE	TRUE	TRUE	1	TRUE	TRUE	1	1
FBgn0003607	64	75	57	48	121	123	TRUE	TRUE	TRUE	1	TRUE	TRUE	1	1
FBgn0003612	137	145	125	126	262	271	TRUE	TRUE	TRUE	1	TRUE	TRUE	1	1
FBgn0003651	308	264	230	237	538	501	FALSE	TRUE	TRUE	0	TRUE	TRUE	1	0
FBgn0003660	101	75	82	88	183	163	FALSE	TRUE	TRUE	0	TRUE	TRUE	1	0
FBgn0003683	26	34	35	37	61	71	TRUE	TRUE	TRUE	1	TRUE	TRUE	1	1
FBgn0003687	123	102	75	88	198	190	TRUE	TRUE	TRUE	1	TRUE	TRUE	1	1
FBgn0003701	205	198	159	156	364	354	TRUE	TRUE	TRUE	1	TRUE	TRUE	1	1
FBgn0003710	183	175	178	150	361	325	TRUE	TRUE	TRUE	1	TRUE	TRUE	1	1
FBgn0003716	367	394	342	312	709	706	TRUE	TRUE	TRUE	1	TRUE	TRUE	1	1
FBgn0003719	315	311	237	261	552	572	TRUE	TRUE	TRUE	1	TRUE	TRUE	1	1
FBgn0003720	172	139	164	153	336	292	FALSE	TRUE	FALSE	0	TRUE	TRUE	1	0
FBgn0003721	509	522	399	423	908	945	TRUE	TRUE	TRUE	1	TRUE	TRUE	1	1
FBgn0003731	349	349	296	302	645	651	TRUE	TRUE	TRUE	1	TRUE	TRUE	1	1
FBgn0003733	239	197	170	190	409	387	FALSE	TRUE	TRUE	0	TRUE	TRUE	1	0
FBgn0003741	46	34	26	23	72	57	TRUE	TRUE	TRUE	1	TRUE	TRUE	1	1
FBgn0003742	94	113	72	63	166	176	TRUE	TRUE	TRUE	1	TRUE	TRUE	1	1
FBgn0003748	369	341	269	311	638	652	TRUE	FALSE	TRUE	0	TRUE	TRUE	1	0
FBgn0003751	48	45	36	30	84	75	TRUE	TRUE	TRUE	1	TRUE	TRUE	1	1
FBgn0003861	406	381	336	339	742	720	TRUE	TRUE	TRUE	1	TRUE	TRUE	1	1
FBgn0003862	603	626	522	548	1125	1174	TRUE	TRUE	TRUE	1	TRUE	TRUE	1	1
FBgn0003863	34	22	20	17	54	39	TRUE	TRUE	TRUE	1	FALSE	TRUE	0	0
FBgn0003866	61	61	66	62	127	123	TRUE	TRUE	TRUE	1	TRUE	TRUE	1	1
FBgn0003867	168	142	120	135	288	277	TRUE	TRUE	TRUE	1	TRUE	TRUE	1	1
FBgn0003870	156	169	108	130	264	299	TRUE	TRUE	TRUE	1	TRUE	TRUE	1	1
FBgn0003882	70	66	65	77	135	143	TRUE	TRUE	TRUE	1	TRUE	TRUE	1	1
FBgn0003886	28	15	22	18	50	33	FALSE	TRUE	FALSE	0	FALSE	TRUE	0	0
FBgn0003888	181	203	185	167	366	370	TRUE	TRUE	TRUE	1	TRUE	TRUE	1	1
FBgn0003889	90	87	65	69	155	156	TRUE	TRUE	TRUE	1	TRUE	TRUE	1	1
FBgn0003890	196	217	165	171	361	388	TRUE	TRUE	TRUE	1	TRUE	TRUE	1	1
FBgn0003891	559	537	502	485	1061	1022	TRUE	TRUE	TRUE	1	TRUE	TRUE	1	1
FBgn0003892	189	211	157	146	346	357	TRUE	TRUE	TRUE	1	TRUE	TRUE	1	1
FBgn0003896	217	219	194	167	411	386	TRUE	TRUE	TRUE	1	TRUE	TRUE	1	1
FBgn0003900	143	122	124	119	267	241	TRUE	TRUE	TRUE	1	TRUE	TRUE	1	1
FBgn0003916	25	17	18	14	43	31	TRUE	TRUE	TRUE	1	TRUE	TRUE	1	1
FBgn0003922	88	46	77	41	165	87	FALSE	FALSE	FALSE	0	FALSE	FALSE	0	0
FBgn0003926	31	24	26	20	57	44	TRUE	TRUE	TRUE	1	TRUE	TRUE	1	1
FBgn0003930	25	27	27	24	52	51	TRUE	TRUE	TRUE	1	TRUE	TRUE	1	1
FBgn0003931	38	26	38	34	76	60	TRUE	TRUE	TRUE	1	TRUE	TRUE	1	1
FBgn0003935	29	21	26	29	55	50	TRUE	TRUE	TRUE	1	TRUE	TRUE	1	1
FBgn0003936	72	37	43	26	115	63	FALSE	FALSE	FALSE	0	FALSE	FALSE	0	0
FBgn0003941	46	38	33	33	79	71	TRUE	TRUE	TRUE	1	TRUE	TRUE	1	1
FBgn0003942	37	40	23	23	60	63	TRUE	TRUE	TRUE	1	TRUE	TRUE	1	1
FBgn0003943	117	99	93	96	210	195	TRUE	TRUE	TRUE	1	TRUE	TRUE	1	1
FBgn0003944	128	148	136	116	264	264	TRUE	TRUE	TRUE	1	TRUE	TRUE	1	1
FBgn0003961	112	113	86	92	198	205	TRUE	TRUE	TRUE	1	TRUE	TRUE	1	1
FBgn0003963	377	410	346	299	723	709	TRUE	FALSE	TRUE	0	TRUE	TRUE	1	0
FBgn0003975	360	344	282	294	642	638	TRUE	TRUE	TRUE	1	TRUE	TRUE	1	1
FBgn0003977	422	398	318	335	740	733	TRUE	TRUE	TRUE	1	TRUE	TRUE	1	1
FBgn0003978	81	105	76	82	157	187	FALSE	TRUE	TRUE	0	TRUE	TRUE	1	0
FBgn0003980	26	52	29	21	55	73	FALSE	TRUE	TRUE	0	FALSE	TRUE	0	0
FBgn0003983	98	87	29	26	127	113	TRUE	TRUE	TRUE	1	TRUE	TRUE	1	1
FBgn0003984	149	149	130	125	279	274	TRUE	TRUE	TRUE	1	TRUE	TRUE	1	1
FBgn0003997	37	36	32	39	69	75	TRUE	TRUE	TRUE	1	TRUE	TRUE	1	1
FBgn0004003	109	119	106	112	215	231	TRUE	TRUE	TRUE	1	TRUE	TRUE	1	1
FBgn0004049	249	229	155	200	404	429	TRUE	FALSE	TRUE	0	TRUE	TRUE	1	0
FBgn0004052	13	20	18	16	31	36	TRUE	TRUE	TRUE	1	FALSE	TRUE	0	0
FBgn0004053	43	31	33	29	76	60	TRUE	TRUE	TRUE	1	TRUE	TRUE	1	1
FBgn0004054	51	49	55	43	106	92	TRUE	TRUE	TRUE	1	TRUE	TRUE	1	1
FBgn0004055	145	159	98	92	243	251	TRUE	TRUE	TRUE	1	TRUE	TRUE	1	1
FBgn0004087	33	24	27	16	60	40	TRUE	TRUE	FALSE	0	TRUE	FALSE	0	0
FBgn0004101	171	188	164	151	335	339	TRUE	TRUE	TRUE	1	TRUE	TRUE	1	1
FBgn0004103	50	60	41	52	91	112	TRUE	TRUE	TRUE	1	TRUE	TRUE	1	1
FBgn0004106	31	17	24	20	55	37	FALSE	TRUE	FALSE	0	FALSE	TRUE	0	0
FBgn0004107	40	46	49	44	89	90	TRUE	TRUE	TRUE	1	TRUE	TRUE	1	1
FBgn0004108	150	175	103	112	253	287	TRUE	TRUE	TRUE	1	TRUE	TRUE	1	1
FBgn0004110	147	134	114	85	261	219	TRUE	FALSE	FALSE	0	TRUE	TRUE	1	0
FBgn0004117	176	178	145	146	321	324	TRUE	TRUE	TRUE	1	TRUE	TRUE	1	1
FBgn0004118	447	481	395	360	842	841	TRUE	TRUE	TRUE	1	TRUE	TRUE	1	1
FBgn0004132	43	41	35	42	78	83	TRUE	TRUE	TRUE	1	TRUE	TRUE	1	1
FBgn0004133	144	129	118	102	262	231	TRUE	TRUE	TRUE	1	TRUE	TRUE	1	1
FBgn0004167	928	916	746	748	1674	1664	TRUE	TRUE	TRUE	1	TRUE	TRUE	1	1
FBgn0004168	350	338	285	317	635	655	TRUE	TRUE	TRUE	1	TRUE	TRUE	1	1
FBgn0004171	59	58	51	38	110	96	TRUE	TRUE	TRUE	1	TRUE	TRUE	1	1
FBgn0004177	211	217	174	202	385	419	TRUE	TRUE	TRUE	1	TRUE	TRUE	1	1
FBgn0004179	42	38	41	44	83	82	TRUE	TRUE	TRUE	1	TRUE	TRUE	1	1
FBgn0004181	85	62	86	65	171	127	FALSE	TRUE	FALSE	0	TRUE	TRUE	1	0
FBgn0004185	29	25	15	18	44	43	TRUE	TRUE	TRUE	1	TRUE	TRUE	1	1
FBgn0004186	39	43	33	36	72	79	TRUE	TRUE	TRUE	1	TRUE	TRUE	1	1
FBgn0004187	33	38	19	27	52	65	TRUE	TRUE	TRUE	1	TRUE	TRUE	1	1
FBgn0004189	13	23	16	19	29	42	TRUE	TRUE	TRUE	1	FALSE	TRUE	0	0
FBgn0004197	494	511	452	436	946	947	TRUE	TRUE	TRUE	1	TRUE	TRUE	1	1
FBgn0004228	52	66	70	55	122	121	TRUE	TRUE	TRUE	1	TRUE	TRUE	1	1
FBgn0004237	66	78	52	42	118	120	TRUE	TRUE	TRUE	1	TRUE	TRUE	1	1
FBgn0004240	55	70	62	51	117	121	TRUE	TRUE	TRUE	1	TRUE	TRUE	1	1
FBgn0004242	273	279	235	198	508	477	TRUE	FALSE	TRUE	0	TRUE	TRUE	1	0
FBgn0004244	513	510	428	455	941	965	TRUE	TRUE	TRUE	1	TRUE	TRUE	1	1
FBgn0004359	152	161	130	132	282	293	TRUE	TRUE	TRUE	1	TRUE	TRUE	1	1
FBgn0004360	141	170	145	152	286	322	TRUE	TRUE	TRUE	1	TRUE	TRUE	1	1
FBgn0004362	161	138	122	124	283	262	TRUE	TRUE	TRUE	1	TRUE	TRUE	1	1
FBgn0004363	157	137	129	141	286	278	TRUE	TRUE	TRUE	1	TRUE	TRUE	1	1
FBgn0004364	332	362	323	325	655	687	TRUE	TRUE	TRUE	1	TRUE	TRUE	1	1
FBgn0004369	763	839	649	708	1412	1547	FALSE	TRUE	FALSE	0	TRUE	TRUE	1	0
FBgn0004372	202	244	197	209	399	453	FALSE	TRUE	FALSE	0	TRUE	TRUE	1	0
FBgn0004373	221	226	194	191	415	417	TRUE	TRUE	TRUE	1	TRUE	TRUE	1	1
FBgn0004374	208	203	170	170	378	373	TRUE	TRUE	TRUE	1	TRUE	TRUE	1	1
FBgn0004378	132	133	128	97	260	230	TRUE	FALSE	TRUE	0	TRUE	TRUE	1	0
FBgn0004379	216	192	142	183	358	375	TRUE	FALSE	TRUE	0	TRUE	TRUE	1	0
FBgn0004380	59	38	44	56	103	94	FALSE	TRUE	TRUE	0	FALSE	TRUE	0	0
FBgn0004381	142	173	115	124	257	297	FALSE	TRUE	FALSE	0	TRUE	TRUE	1	0
FBgn0004387	453	474	403	375	856	849	TRUE	TRUE	TRUE	1	TRUE	TRUE	1	1
FBgn0004390	310	298	247	258	557	556	TRUE	TRUE	TRUE	1	TRUE	TRUE	1	1
FBgn0004394	373	368	330	335	703	703	TRUE	TRUE	TRUE	1	TRUE	TRUE	1	1
FBgn0004395	551	500	461	431	1012	931	TRUE	TRUE	FALSE	0	TRUE	TRUE	1	0
FBgn0004396	163	151	124	124	287	275	TRUE	TRUE	TRUE	1	TRUE	TRUE	1	1
FBgn0004400	78	85	54	55	132	140	TRUE	TRUE	TRUE	1	TRUE	TRUE	1	1
FBgn0004401	90	84	79	85	169	169	TRUE	TRUE	TRUE	1	TRUE	TRUE	1	1
FBgn0004406	283	322	225	263	508	585	TRUE	FALSE	FALSE	0	TRUE	TRUE	1	0
FBgn0004419	113	118	108	85	221	203	TRUE	TRUE	TRUE	1	TRUE	TRUE	1	1
FBgn0004425	53	58	50	52	103	110	TRUE	TRUE	TRUE	1	TRUE	TRUE	1	1
FBgn0004428	84	55	55	54	139	109	FALSE	TRUE	FALSE	0	FALSE	TRUE	0	0
FBgn0004429	68	66	62	46	130	112	TRUE	TRUE	TRUE	1	TRUE	TRUE	1	1
FBgn0004430	23	26	16	17	39	43	TRUE	TRUE	TRUE	1	TRUE	TRUE	1	1
FBgn0004431	75	81	69	70	144	151	TRUE	TRUE	TRUE	1	TRUE	TRUE	1	1
FBgn0004435	282	265	207	228	489	493	TRUE	TRUE	TRUE	1	TRUE	TRUE	1	1
FBgn0004436	32	27	27	27	59	54	TRUE	TRUE	TRUE	1	TRUE	TRUE	1	1
FBgn0004449	241	251	255	215	496	466	TRUE	FALSE	TRUE	0	TRUE	TRUE	1	0
FBgn0004463	259	283	262	211	521	494	TRUE	FALSE	TRUE	0	TRUE	TRUE	1	0
FBgn0004465	50	67	44	31	94	98	TRUE	TRUE	TRUE	1	TRUE	TRUE	1	1
FBgn0004507	192	207	152	155	344	362	TRUE	TRUE	TRUE	1	TRUE	TRUE	1	1
FBgn0004509	732	698	583	575	1315	1273	TRUE	TRUE	TRUE	1	TRUE	TRUE	1	1
FBgn0004510	147	150	108	124	255	274	TRUE	TRUE	TRUE	1	TRUE	TRUE	1	1
FBgn0004512	465	424	420	375	885	799	TRUE	TRUE	FALSE	0	TRUE	TRUE	1	0
FBgn0004513	354	362	317	328	671	690	TRUE	TRUE	TRUE	1	TRUE	TRUE	1	1
FBgn0004514	100	87	74	71	174	158	TRUE	TRUE	TRUE	1	TRUE	TRUE	1	1
FBgn0004516	384	401	375	329	759	730	TRUE	FALSE	TRUE	0	TRUE	TRUE	1	0
FBgn0004552	25	35	31	25	56	60	TRUE	TRUE	TRUE	1	TRUE	TRUE	1	1
FBgn0004554	86	72	70	53	156	125	TRUE	TRUE	FALSE	0	TRUE	TRUE	1	0
FBgn0004556	47	47	46	37	93	84	TRUE	TRUE	TRUE	1	TRUE	TRUE	1	1
FBgn0004567	62	59	62	61	124	120	TRUE	TRUE	TRUE	1	TRUE	TRUE	1	1
FBgn0004569	121	107	96	94	217	201	TRUE	TRUE	TRUE	1	TRUE	TRUE	1	1
FBgn0004573	317	314	262	248	579	562	TRUE	TRUE	TRUE	1	TRUE	TRUE	1	1
FBgn0004574	166	157	109	128	275	285	TRUE	TRUE	TRUE	1	TRUE	TRUE	1	1
FBgn0004575	119	116	98	104	217	220	TRUE	TRUE	TRUE	1	TRUE	TRUE	1	1
FBgn0004577	109	109	71	70	180	179	TRUE	TRUE	TRUE	1	TRUE	TRUE	1	1
FBgn0004580	377	356	320	299	697	655	TRUE	TRUE	TRUE	1	TRUE	TRUE	1	1
FBgn0004581	293	320	220	246	513	566	TRUE	TRUE	TRUE	1	TRUE	TRUE	1	1
FBgn0004583	207	203	161	144	368	347	TRUE	TRUE	TRUE	1	TRUE	TRUE	1	1
FBgn0004584	103	84	85	82	188	166	TRUE	TRUE	TRUE	1	TRUE	TRUE	1	1
FBgn0004587	61	48	47	36	108	84	TRUE	TRUE	FALSE	0	TRUE	TRUE	1	0
FBgn0004588	43	48	38	44	81	92	TRUE	TRUE	TRUE	1	TRUE	TRUE	1	1
FBgn0004589	95	85	62	61	157	146	TRUE	TRUE	TRUE	1	TRUE	TRUE	1	1
FBgn0004590	39	50	39	41	78	91	TRUE	TRUE	TRUE	1	TRUE	TRUE	1	1
FBgn0004591	81	87	67	83	148	170	TRUE	TRUE	TRUE	1	TRUE	TRUE	1	1
FBgn0004592	118	97	104	101	222	198	TRUE	TRUE	TRUE	1	TRUE	TRUE	1	1
FBgn0004593	58	56	54	42	112	98	TRUE	TRUE	TRUE	1	TRUE	TRUE	1	1
FBgn0004594	66	79	56	59	122	138	TRUE	TRUE	TRUE	1	TRUE	TRUE	1	1
FBgn0004595	1024	1137	931	900	1955	2037	FALSE	TRUE	TRUE	0	TRUE	TRUE	1	0
FBgn0004606	568	595	418	425	986	1020	TRUE	TRUE	TRUE	1	TRUE	TRUE	1	1
FBgn0004607	96	79	79	71	175	150	TRUE	TRUE	TRUE	1	TRUE	TRUE	1	1
FBgn0004611	355	441	306	339	661	780	FALSE	TRUE	FALSE	0	TRUE	TRUE	1	0
FBgn0004618	293	294	251	246	544	540	TRUE	TRUE	TRUE	1	TRUE	TRUE	1	1
FBgn0004619	316	313	277	280	593	593	TRUE	TRUE	TRUE	1	TRUE	TRUE	1	1
FBgn0004620	264	251	263	238	527	489	TRUE	TRUE	TRUE	1	TRUE	TRUE	1	1
FBgn0004622	323	309	233	253	556	562	TRUE	TRUE	TRUE	1	TRUE	TRUE	1	1
FBgn0004623	123	134	121	112	244	246	TRUE	TRUE	TRUE	1	TRUE	TRUE	1	1
FBgn0004635	226	247	221	225	447	472	TRUE	TRUE	TRUE	1	TRUE	TRUE	1	1
FBgn0004636	79	92	64	67	143	159	TRUE	TRUE	TRUE	1	TRUE	TRUE	1	1
FBgn0004638	207	181	153	173	360	354	TRUE	TRUE	TRUE	1	TRUE	TRUE	1	1
FBgn0004644	211	181	155	186	366	367	TRUE	TRUE	TRUE	1	TRUE	TRUE	1	1
FBgn0004652	1318	1272	999	1062	2317	2334	TRUE	TRUE	TRUE	1	TRUE	TRUE	1	1
FBgn0004666	196	195	162	151	358	346	TRUE	TRUE	TRUE	1	TRUE	TRUE	1	1
FBgn0004698	329	306	305	272	634	578	TRUE	TRUE	TRUE	1	TRUE	TRUE	1	1
FBgn0004778	29	25	23	29	52	54	TRUE	TRUE	TRUE	1	TRUE	TRUE	1	1
FBgn0004779	34	37	17	21	51	58	TRUE	TRUE	TRUE	1	TRUE	TRUE	1	1
FBgn0004780	35	22	32	14	67	36	TRUE	FALSE	FALSE	0	FALSE	FALSE	0	0
FBgn0004782	47	61	30	40	77	101	TRUE	TRUE	FALSE	0	TRUE	TRUE	1	0
FBgn0004783	26	34	22	17	48	51	TRUE	TRUE	TRUE	1	TRUE	TRUE	1	1
FBgn0004784	285	287	226	252	511	539	TRUE	TRUE	TRUE	1	TRUE	TRUE	1	1
FBgn0004795	451	407	380	329	831	736	TRUE	FALSE	FALSE	0	TRUE	TRUE	1	0
FBgn0004797	130	154	126	133	256	287	TRUE	TRUE	TRUE	1	TRUE	TRUE	1	1
FBgn0004811	128	125	128	131	256	256	TRUE	TRUE	TRUE	1	TRUE	TRUE	1	1
FBgn0004837	186	209	161	169	347	378	TRUE	TRUE	TRUE	1	TRUE	TRUE	1	1
FBgn0004838	217	220	188	153	405	373	TRUE	FALSE	TRUE	0	TRUE	TRUE	1	0
FBgn0004839	439	439	313	367	752	806	TRUE	FALSE	TRUE	0	TRUE	TRUE	1	0
FBgn0004841	266	258	245	259	511	517	TRUE	TRUE	TRUE	1	TRUE	TRUE	1	1
FBgn0004842	255	311	276	274	531	585	FALSE	TRUE	TRUE	0	TRUE	TRUE	1	0
FBgn0004852	333	334	298	348	631	682	TRUE	FALSE	TRUE	0	TRUE	TRUE	1	0
FBgn0004855	61	63	42	44	103	107	TRUE	TRUE	TRUE	1	TRUE	TRUE	1	1
FBgn0004858	184	175	174	138	358	313	TRUE	FALSE	FALSE	0	TRUE	TRUE	1	0
FBgn0004859	50	51	53	37	103	88	TRUE	TRUE	TRUE	1	TRUE	TRUE	1	1
FBgn0004862	101	134	88	84	189	218	FALSE	TRUE	TRUE	0	TRUE	TRUE	1	0
FBgn0004863	206	207	145	199	351	406	TRUE	FALSE	FALSE	0	TRUE	TRUE	1	0
FBgn0004865	204	166	157	129	361	295	FALSE	TRUE	FALSE	0	TRUE	TRUE	1	0
FBgn0004867	61	45	52	44	113	89	TRUE	TRUE	TRUE	1	TRUE	TRUE	1	1
FBgn0004868	241	236	163	141	404	377	TRUE	TRUE	TRUE	1	TRUE	TRUE	1	1
FBgn0004870	223	238	189	156	412	394	TRUE	FALSE	TRUE	0	TRUE	TRUE	1	0
FBgn0004872	223	186	202	155	425	341	FALSE	FALSE	FALSE	0	TRUE	TRUE	1	0
FBgn0004875	525	544	420	461	945	1005	TRUE	TRUE	TRUE	1	TRUE	TRUE	1	1
FBgn0004876	422	396	355	337	777	733	TRUE	TRUE	TRUE	1	TRUE	TRUE	1	1
FBgn0004880	290	316	248	283	538	599	TRUE	TRUE	FALSE	0	TRUE	TRUE	1	0
FBgn0004882	383	447	328	374	711	821	FALSE	FALSE	FALSE	0	TRUE	TRUE	1	0
FBgn0004885	593	557	545	529	1138	1086	TRUE	TRUE	TRUE	1	TRUE	TRUE	1	1
FBgn0004888	153	157	127	124	280	281	TRUE	TRUE	TRUE	1	TRUE	TRUE	1	1
FBgn0004889	211	185	178	193	389	378	TRUE	TRUE	TRUE	1	TRUE	TRUE	1	1
FBgn0004892	226	246	211	156	437	402	TRUE	FALSE	TRUE	0	TRUE	TRUE	1	0
FBgn0004893	313	324	266	229	579	553	TRUE	TRUE	TRUE	1	TRUE	TRUE	1	1
FBgn0004895	137	168	119	108	256	276	FALSE	TRUE	TRUE	0	TRUE	TRUE	1	0
FBgn0004896	177	194	150	134	327	328	TRUE	TRUE	TRUE	1	TRUE	TRUE	1	1
FBgn0004897	114	116	99	92	213	208	TRUE	TRUE	TRUE	1	TRUE	TRUE	1	1
FBgn0004898	91	106	72	70	163	176	TRUE	TRUE	TRUE	1	TRUE	TRUE	1	1
FBgn0004903	176	156	161	135	337	291	TRUE	TRUE	FALSE	0	TRUE	TRUE	1	0
FBgn0004907	162	182	154	139	316	321	TRUE	TRUE	TRUE	1	TRUE	TRUE	1	1
FBgn0004910	341	343	272	277	613	620	TRUE	TRUE	TRUE	1	TRUE	TRUE	1	1
FBgn0004911	79	86	81	66	160	152	TRUE	TRUE	TRUE	1	TRUE	TRUE	1	1
FBgn0004913	39	36	21	31	60	67	TRUE	TRUE	TRUE	1	TRUE	TRUE	1	1
FBgn0004914	401	402	352	328	753	730	TRUE	TRUE	TRUE	1	TRUE	TRUE	1	1
FBgn0004915	67	63	66	53	133	116	TRUE	TRUE	TRUE	1	TRUE	TRUE	1	1
FBgn0004919	130	127	132	119	262	246	TRUE	TRUE	TRUE	1	TRUE	TRUE	1	1
FBgn0004921	65	57	39	41	104	98	TRUE	TRUE	TRUE	1	TRUE	TRUE	1	1
FBgn0004926	113	82	93	92	206	174	FALSE	TRUE	TRUE	0	TRUE	TRUE	1	0
FBgn0005198	160	171	135	135	295	306	TRUE	TRUE	TRUE	1	TRUE	TRUE	1	1
FBgn0005278	88	67	85	52	173	119	TRUE	FALSE	FALSE	0	TRUE	FALSE	0	0
FBgn0005322	112	110	102	88	214	198	TRUE	TRUE	TRUE	1	TRUE	TRUE	1	1
FBgn0005355	44	37	37	26	81	63	TRUE	TRUE	TRUE	1	TRUE	TRUE	1	1
FBgn0005386	274	254	195	238	469	492	TRUE	FALSE	TRUE	0	TRUE	TRUE	1	0
FBgn0005533	63	52	39	41	102	93	TRUE	TRUE	TRUE	1	TRUE	TRUE	1	1
FBgn0005536	666	649	504	533	1170	1182	TRUE	TRUE	TRUE	1	TRUE	TRUE	1	1
FBgn0005558	38	44	42	36	80	80	TRUE	TRUE	TRUE	1	TRUE	TRUE	1	1
FBgn0005561	122	144	95	95	217	239	TRUE	TRUE	TRUE	1	TRUE	TRUE	1	1
FBgn0005564	199	224	142	166	341	390	TRUE	TRUE	FALSE	0	TRUE	TRUE	1	0
FBgn0005585	67	64	53	54	120	118	TRUE	TRUE	TRUE	1	TRUE	TRUE	1	1
FBgn0005586	295	291	238	206	533	497	TRUE	TRUE	TRUE	1	TRUE	TRUE	1	1
FBgn0005590	141	143	104	105	245	248	TRUE	TRUE	TRUE	1	TRUE	TRUE	1	1
FBgn0005593	39	21	35	32	74	53	FALSE	TRUE	FALSE	0	FALSE	TRUE	0	0
FBgn0005596	213	177	141	164	354	341	FALSE	TRUE	TRUE	0	TRUE	TRUE	1	0
FBgn0005612	140	151	119	110	259	261	TRUE	TRUE	TRUE	1	TRUE	TRUE	1	1
FBgn0005613	128	127	110	111	238	238	TRUE	TRUE	TRUE	1	TRUE	TRUE	1	1
FBgn0005614	336	348	261	316	597	664	TRUE	FALSE	FALSE	0	TRUE	TRUE	1	0
FBgn0005616	232	237	164	181	396	418	TRUE	TRUE	TRUE	1	TRUE	TRUE	1	1
FBgn0005617	182	169	160	167	342	336	TRUE	TRUE	TRUE	1	TRUE	TRUE	1	1
FBgn0005619	350	397	272	330	622	727	FALSE	FALSE	FALSE	0	TRUE	TRUE	1	0
FBgn0005624	360	344	289	324	649	668	TRUE	TRUE	TRUE	1	TRUE	TRUE	1	1
FBgn0005626	300	311	254	253	554	564	TRUE	TRUE	TRUE	1	TRUE	TRUE	1	1
FBgn0005631	437	445	389	406	826	851	TRUE	TRUE	TRUE	1	TRUE	TRUE	1	1
FBgn0005632	222	236	197	176	419	412	TRUE	TRUE	TRUE	1	TRUE	TRUE	1	1
FBgn0005633	31	23	23	23	54	46	TRUE	TRUE	TRUE	1	TRUE	TRUE	1	1
FBgn0005636	273	294	215	244	488	538	TRUE	TRUE	TRUE	1	TRUE	TRUE	1	1
FBgn0005638	135	140	114	96	249	236	TRUE	TRUE	TRUE	1	TRUE	TRUE	1	1
FBgn0005640	567	503	448	445	1015	948	FALSE	TRUE	TRUE	0	TRUE	TRUE	1	0
FBgn0005642	76	85	63	75	139	160	TRUE	TRUE	TRUE	1	TRUE	TRUE	1	1
FBgn0005648	84	95	63	74	147	169	TRUE	TRUE	TRUE	1	TRUE	TRUE	1	1
FBgn0005649	143	163	122	119	265	282	TRUE	TRUE	TRUE	1	TRUE	TRUE	1	1
FBgn0005655	72	72	64	70	136	142	TRUE	TRUE	TRUE	1	TRUE	TRUE	1	1
FBgn0005658	403	403	340	330	743	733	TRUE	TRUE	TRUE	1	TRUE	TRUE	1	1
FBgn0005659	209	243	198	188	407	431	TRUE	TRUE	TRUE	1	TRUE	TRUE	1	1
FBgn0005660	322	299	231	222	553	521	TRUE	TRUE	TRUE	1	TRUE	TRUE	1	1
FBgn0005664	173	143	175	136	348	279	TRUE	FALSE	FALSE	0	TRUE	TRUE	1	0
FBgn0005666	234	223	149	162	383	385	TRUE	TRUE	TRUE	1	TRUE	TRUE	1	1
FBgn0005671	129	132	96	101	225	233	TRUE	TRUE	TRUE	1	TRUE	TRUE	1	1
FBgn0005672	101	132	114	115	215	247	FALSE	TRUE	TRUE	0	TRUE	TRUE	1	0
FBgn0005674	422	372	320	319	742	691	FALSE	TRUE	TRUE	0	TRUE	TRUE	1	0
FBgn0005677	293	263	243	216	536	479	TRUE	TRUE	FALSE	0	TRUE	TRUE	1	0
FBgn0005683	143	138	102	106	245	244	TRUE	TRUE	TRUE	1	TRUE	TRUE	1	1
FBgn0005694	126	104	92	84	218	188	TRUE	TRUE	TRUE	1	TRUE	TRUE	1	1
FBgn0005695	51	59	49	50	100	109	TRUE	TRUE	TRUE	1	TRUE	TRUE	1	1
FBgn0005696	87	98	67	77	154	175	TRUE	TRUE	TRUE	1	TRUE	TRUE	1	1
FBgn0005771	186	204	170	154	356	358	TRUE	TRUE	TRUE	1	TRUE	TRUE	1	1
FBgn0005775	348	340	329	296	677	636	TRUE	TRUE	TRUE	1	TRUE	TRUE	1	1
FBgn0005777	24	14	24	18	48	32	TRUE	TRUE	FALSE	0	FALSE	TRUE	0	0
FBgn0005778	112	140	109	104	221	244	FALSE	TRUE	TRUE	0	TRUE	TRUE	1	0
FBgn0005779	93	90	78	84	171	174	TRUE	TRUE	TRUE	1	TRUE	TRUE	1	1
FBgn0008636	209	203	186	165	395	368	TRUE	TRUE	TRUE	1	TRUE	TRUE	1	1
FBgn0008646	106	125	90	105	196	230	TRUE	TRUE	TRUE	1	TRUE	TRUE	1	1
FBgn0008651	186	193	162	160	348	353	TRUE	TRUE	TRUE	1	TRUE	TRUE	1	1
FBgn0010015	284	291	243	244	527	535	TRUE	TRUE	TRUE	1	TRUE	TRUE	1	1
FBgn0010038	43	27	42	32	85	59	FALSE	TRUE	FALSE	0	FALSE	TRUE	0	0
FBgn0010039	49	61	37	43	86	104	TRUE	TRUE	TRUE	1	TRUE	TRUE	1	1
FBgn0010040	93	96	73	90	166	186	TRUE	TRUE	TRUE	1	TRUE	TRUE	1	1
FBgn0010041	96	77	74	80	170	157	TRUE	TRUE	TRUE	1	TRUE	TRUE	1	1
FBgn0010042	83	87	69	86	152	173	TRUE	TRUE	TRUE	1	TRUE	TRUE	1	1
FBgn0010043	74	74	69	63	143	137	TRUE	TRUE	TRUE	1	TRUE	TRUE	1	1
FBgn0010044	75	66	69	44	144	110	TRUE	FALSE	FALSE	0	TRUE	FALSE	0	0
FBgn0010051	194	204	161	145	355	349	TRUE	TRUE	TRUE	1	TRUE	TRUE	1	1
FBgn0010052	273	263	212	219	485	482	TRUE	TRUE	TRUE	1	TRUE	TRUE	1	1
FBgn0010053	112	97	95	71	207	168	TRUE	FALSE	FALSE	0	TRUE	TRUE	1	0
FBgn0010078	53	51	44	37	97	88	TRUE	TRUE	TRUE	1	TRUE	TRUE	1	1
FBgn0010097	137	132	98	101	235	233	TRUE	TRUE	TRUE	1	TRUE	TRUE	1	1
FBgn0010100	56	76	46	52	102	128	FALSE	TRUE	FALSE	0	TRUE	TRUE	1	0
FBgn0010105	99	107	100	94	199	201	TRUE	TRUE	TRUE	1	TRUE	TRUE	1	1
FBgn0010109	23	9	15	22	38	31	FALSE	TRUE	TRUE	0	FALSE	TRUE	0	0
FBgn0010113	936	1014	814	829	1750	1843	FALSE	TRUE	TRUE	0	TRUE	TRUE	1	0
FBgn0010114	163	172	159	140	322	312	TRUE	TRUE	TRUE	1	TRUE	TRUE	1	1
FBgn0010173	37	42	33	42	70	84	TRUE	TRUE	TRUE	1	TRUE	TRUE	1	1
FBgn0010197	525	481	390	357	915	838	TRUE	TRUE	FALSE	0	TRUE	TRUE	1	0
FBgn0010213	131	102	70	84	201	186	FALSE	TRUE	TRUE	0	TRUE	TRUE	1	0
FBgn0010215	49	43	43	37	92	80	TRUE	TRUE	TRUE	1	TRUE	TRUE	1	1
FBgn0010220	101	101	95	80	196	181	TRUE	TRUE	TRUE	1	TRUE	TRUE	1	1
FBgn0010222	31	31	28	25	59	56	TRUE	TRUE	TRUE	1	TRUE	TRUE	1	1
FBgn0010223	123	120	103	82	226	202	TRUE	TRUE	TRUE	1	TRUE	TRUE	1	1
FBgn0010226	96	89	70	80	166	169	TRUE	TRUE	TRUE	1	TRUE	TRUE	1	1
FBgn0010228	133	129	104	90	237	219	TRUE	TRUE	TRUE	1	TRUE	TRUE	1	1
FBgn0010235	187	218	147	136	334	354	TRUE	TRUE	TRUE	1	TRUE	TRUE	1	1
FBgn0010238	141	146	111	130	252	276	TRUE	TRUE	TRUE	1	TRUE	TRUE	1	1
FBgn0010241	361	359	301	295	662	654	TRUE	TRUE	TRUE	1	TRUE	TRUE	1	1
FBgn0010246	378	354	282	272	660	626	TRUE	TRUE	TRUE	1	TRUE	TRUE	1	1
FBgn0010247	28	24	33	20	61	44	TRUE	FALSE	TRUE	0	TRUE	FALSE	0	0
FBgn0010263	326	308	264	227	590	535	TRUE	TRUE	TRUE	1	TRUE	TRUE	1	1
FBgn0010265	71	89	72	79	143	168	TRUE	TRUE	TRUE	1	TRUE	TRUE	1	1
FBgn0010278	118	133	87	99	205	232	TRUE	TRUE	TRUE	1	TRUE	TRUE	1	1
FBgn0010280	244	226	214	197	458	423	TRUE	TRUE	TRUE	1	TRUE	TRUE	1	1
FBgn0010287	78	68	49	64	127	132	TRUE	TRUE	TRUE	1	TRUE	TRUE	1	1
FBgn0010288	26	37	36	29	62	66	TRUE	TRUE	TRUE	1	TRUE	TRUE	1	1
FBgn0010300	403	425	351	381	754	806	TRUE	TRUE	TRUE	1	TRUE	TRUE	1	1
FBgn0010309	175	177	156	152	331	329	TRUE	TRUE	TRUE	1	TRUE	TRUE	1	1
FBgn0010313	235	224	169	173	404	397	TRUE	TRUE	TRUE	1	TRUE	TRUE	1	1
FBgn0010314	97	122	97	102	194	224	TRUE	TRUE	TRUE	1	TRUE	TRUE	1	1
FBgn0010316	122	132	88	101	210	233	TRUE	TRUE	TRUE	1	TRUE	TRUE	1	1
FBgn0010317	120	87	68	66	188	153	FALSE	TRUE	FALSE	0	TRUE	TRUE	1	0
FBgn0010323	258	275	194	166	452	441	TRUE	TRUE	TRUE	1	TRUE	TRUE	1	1
FBgn0010328	207	233	169	167	376	400	TRUE	TRUE	TRUE	1	TRUE	TRUE	1	1
FBgn0010339	82	84	52	54	134	138	TRUE	TRUE	TRUE	1	TRUE	TRUE	1	1
FBgn0010340	53	54	36	31	89	85	TRUE	TRUE	TRUE	1	TRUE	TRUE	1	1
FBgn0010342	91	96	78	56	169	152	TRUE	FALSE	TRUE	0	TRUE	TRUE	1	0
FBgn0010348	45	31	28	23	73	54	TRUE	TRUE	TRUE	1	TRUE	TRUE	1	1
FBgn0010350	105	118	72	79	177	197	TRUE	TRUE	TRUE	1	TRUE	TRUE	1	1
FBgn0010352	358	321	269	247	627	568	TRUE	TRUE	FALSE	0	TRUE	TRUE	1	0
FBgn0010355	239	237	227	232	466	469	TRUE	TRUE	TRUE	1	TRUE	TRUE	1	1
FBgn0010356	78	125	75	62	153	187	FALSE	TRUE	FALSE	0	FALSE	TRUE	0	0
FBgn0010379	88	99	89	81	177	180	TRUE	TRUE	TRUE	1	TRUE	TRUE	1	1
FBgn0010382	344	302	275	297	619	599	TRUE	TRUE	TRUE	1	TRUE	TRUE	1	1
FBgn0010385	60	66	43	46	103	112	TRUE	TRUE	TRUE	1	TRUE	TRUE	1	1
FBgn0010387	80	79	78	76	158	155	TRUE	TRUE	TRUE	1	TRUE	TRUE	1	1
FBgn0010388	62	89	67	74	129	163	FALSE	TRUE	FALSE	0	TRUE	TRUE	1	0
FBgn0010389	203	193	132	170	335	363	TRUE	FALSE	TRUE	0	TRUE	TRUE	1	0
FBgn0010395	108	120	120	101	228	221	TRUE	TRUE	TRUE	1	TRUE	TRUE	1	1
FBgn0010397	208	237	197	165	405	402	TRUE	TRUE	TRUE	1	TRUE	TRUE	1	1
FBgn0010398	84	63	70	69	154	132	FALSE	TRUE	TRUE	0	TRUE	TRUE	1	0
FBgn0010399	116	121	91	102	207	223	TRUE	TRUE	TRUE	1	TRUE	TRUE	1	1
FBgn0010406	116	119	101	115	217	234	TRUE	TRUE	TRUE	1	TRUE	TRUE	1	1
FBgn0010407	186	189	124	155	310	344	TRUE	FALSE	TRUE	0	TRUE	TRUE	1	0
FBgn0010408	59	54	60	78	119	132	TRUE	TRUE	TRUE	1	TRUE	TRUE	1	1
FBgn0010409	41	43	28	27	69	70	TRUE	TRUE	TRUE	1	TRUE	TRUE	1	1
FBgn0010411	57	79	45	37	102	116	FALSE	TRUE	TRUE	0	TRUE	TRUE	1	0
FBgn0010414	228	244	180	217	408	461	TRUE	FALSE	FALSE	0	TRUE	TRUE	1	0
FBgn0010415	354	330	258	269	612	599	TRUE	TRUE	TRUE	1	TRUE	TRUE	1	1
FBgn0010417	20	21	26	27	46	48	TRUE	TRUE	TRUE	1	TRUE	TRUE	1	1
FBgn0010421	37	32	27	25	64	57	TRUE	TRUE	TRUE	1	TRUE	TRUE	1	1
FBgn0010422	113	95	103	93	216	188	TRUE	TRUE	TRUE	1	TRUE	TRUE	1	1
FBgn0010423	128	118	102	96	230	214	TRUE	TRUE	TRUE	1	TRUE	TRUE	1	1
FBgn0010424	93	101	79	89	172	190	TRUE	TRUE	TRUE	1	TRUE	TRUE	1	1
FBgn0010425	36	48	26	25	62	73	TRUE	TRUE	TRUE	1	TRUE	TRUE	1	1
FBgn0010431	84	70	72	81	156	151	TRUE	TRUE	TRUE	1	TRUE	TRUE	1	1
FBgn0010434	619	613	484	455	1103	1068	TRUE	TRUE	TRUE	1	TRUE	TRUE	1	1
FBgn0010435	153	136	116	96	269	232	TRUE	TRUE	TRUE	1	TRUE	TRUE	1	1
FBgn0010438	29	30	32	34	61	64	TRUE	TRUE	TRUE	1	TRUE	TRUE	1	1
FBgn0010441	132	146	125	123	257	269	TRUE	TRUE	TRUE	1	TRUE	TRUE	1	1
FBgn0010452	195	234	187	161	382	395	FALSE	TRUE	TRUE	0	TRUE	TRUE	1	0
FBgn0010453	197	194	152	162	349	356	TRUE	TRUE	TRUE	1	TRUE	TRUE	1	1
FBgn0010470	195	200	188	191	383	391	TRUE	TRUE	TRUE	1	TRUE	TRUE	1	1
FBgn0010473	768	815	664	655	1432	1470	TRUE	TRUE	TRUE	1	TRUE	TRUE	1	1
FBgn0010482	359	341	308	272	667	613	TRUE	TRUE	TRUE	1	TRUE	TRUE	1	1
FBgn0010488	295	279	254	225	549	504	TRUE	TRUE	TRUE	1	TRUE	TRUE	1	1
FBgn0010497	242	249	197	175	439	424	TRUE	TRUE	TRUE	1	TRUE	TRUE	1	1
FBgn0010501	56	56	35	56	91	112	TRUE	FALSE	TRUE	0	TRUE	FALSE	0	0
FBgn0010504	76	68	70	64	146	132	TRUE	TRUE	TRUE	1	TRUE	TRUE	1	1
FBgn0010516	127	122	92	105	219	227	TRUE	TRUE	TRUE	1	TRUE	TRUE	1	1
FBgn0010520	61	88	58	59	119	147	FALSE	TRUE	FALSE	0	TRUE	TRUE	1	0
FBgn0010531	72	65	44	41	116	106	TRUE	TRUE	TRUE	1	TRUE	TRUE	1	1
FBgn0010548	214	247	225	215	439	462	TRUE	TRUE	TRUE	1	TRUE	TRUE	1	1
FBgn0010549	243	236	192	207	435	443	TRUE	TRUE	TRUE	1	TRUE	TRUE	1	1
FBgn0010551	181	155	144	160	325	315	TRUE	TRUE	TRUE	1	TRUE	TRUE	1	1
FBgn0010583	230	185	192	153	422	338	FALSE	FALSE	FALSE	0	TRUE	TRUE	1	0
FBgn0010590	62	47	55	55	117	102	TRUE	TRUE	TRUE	1	TRUE	TRUE	1	1
FBgn0010591	133	180	121	156	254	336	FALSE	FALSE	FALSE	0	TRUE	TRUE	1	0
FBgn0010602	135	130	113	129	248	259	TRUE	TRUE	TRUE	1	TRUE	TRUE	1	1
FBgn0010607	47	51	31	48	78	99	TRUE	FALSE	TRUE	0	TRUE	FALSE	0	0
FBgn0010611	164	208	150	161	314	369	FALSE	TRUE	FALSE	0	TRUE	TRUE	1	0
FBgn0010612	51	66	45	58	96	124	TRUE	TRUE	FALSE	0	TRUE	TRUE	1	0
FBgn0010620	62	63	63	39	125	102	TRUE	FALSE	TRUE	0	TRUE	FALSE	0	0
FBgn0010622	62	63	43	37	105	100	TRUE	TRUE	TRUE	1	TRUE	TRUE	1	1
FBgn0010638	40	47	20	38	60	85	TRUE	FALSE	FALSE	0	TRUE	FALSE	0	0
FBgn0010651	248	279	247	234	495	513	TRUE	TRUE	TRUE	1	TRUE	TRUE	1	1
FBgn0010660	161	143	138	117	299	260	TRUE	TRUE	TRUE	1	TRUE	TRUE	1	1
FBgn0010741	79	72	61	61	140	133	TRUE	TRUE	TRUE	1	TRUE	TRUE	1	1
FBgn0010747	113	147	129	124	242	271	FALSE	TRUE	TRUE	0	TRUE	TRUE	1	0
FBgn0010750	48	50	39	29	87	79	TRUE	TRUE	TRUE	1	TRUE	TRUE	1	1
FBgn0010762	338	329	269	255	607	584	TRUE	TRUE	TRUE	1	TRUE	TRUE	1	1
FBgn0010768	276	266	209	222	485	488	TRUE	TRUE	TRUE	1	TRUE	TRUE	1	1
FBgn0010770	114	110	72	105	186	215	TRUE	FALSE	TRUE	0	TRUE	TRUE	1	0
FBgn0010772	96	78	62	62	158	140	TRUE	TRUE	TRUE	1	TRUE	TRUE	1	1
FBgn0010774	110	93	84	103	194	196	TRUE	TRUE	TRUE	1	TRUE	TRUE	1	1
FBgn0010786	169	155	137	139	306	294	TRUE	TRUE	TRUE	1	TRUE	TRUE	1	1
FBgn0010803	97	74	80	48	177	122	FALSE	FALSE	FALSE	0	TRUE	FALSE	0	0
FBgn0010808	75	92	52	65	127	157	TRUE	TRUE	FALSE	0	TRUE	TRUE	1	0
FBgn0010812	120	114	98	96	218	210	TRUE	TRUE	TRUE	1	TRUE	TRUE	1	1
FBgn0010825	629	686	531	495	1160	1181	TRUE	TRUE	TRUE	1	TRUE	TRUE	1	1
FBgn0010830	48	36	34	31	82	67	TRUE	TRUE	TRUE	1	TRUE	TRUE	1	1
FBgn0010877	322	263	263	243	585	506	FALSE	TRUE	FALSE	0	TRUE	TRUE	1	0
FBgn0010894	124	159	105	93	229	252	FALSE	TRUE	TRUE	0	TRUE	TRUE	1	0
FBgn0010905	828	794	734	653	1562	1447	TRUE	FALSE	FALSE	0	TRUE	TRUE	1	0
FBgn0010909	570	535	510	454	1080	989	TRUE	FALSE	FALSE	0	TRUE	TRUE	1	0
FBgn0010926	199	207	161	173	360	380	TRUE	TRUE	TRUE	1	TRUE	TRUE	1	1
FBgn0011016	23	30	29	21	52	51	TRUE	TRUE	TRUE	1	TRUE	TRUE	1	1
FBgn0011020	60	64	55	58	115	122	TRUE	TRUE	TRUE	1	TRUE	TRUE	1	1
FBgn0011202	299	284	243	234	542	518	TRUE	TRUE	TRUE	1	TRUE	TRUE	1	1
FBgn0011204	180	160	153	167	333	327	TRUE	TRUE	TRUE	1	TRUE	TRUE	1	1
FBgn0011205	99	119	93	78	192	197	TRUE	TRUE	TRUE	1	TRUE	TRUE	1	1
FBgn0011206	568	518	447	440	1015	958	TRUE	TRUE	TRUE	1	TRUE	TRUE	1	1
FBgn0011207	212	210	157	153	369	363	TRUE	TRUE	TRUE	1	TRUE	TRUE	1	1
FBgn0011211	152	138	130	133	282	271	TRUE	TRUE	TRUE	1	TRUE	TRUE	1	1
FBgn0011217	123	138	105	125	228	263	TRUE	TRUE	TRUE	1	TRUE	TRUE	1	1
FBgn0011224	679	671	618	579	1297	1250	TRUE	TRUE	TRUE	1	TRUE	TRUE	1	1
FBgn0011225	523	493	424	402	947	895	TRUE	TRUE	TRUE	1	TRUE	TRUE	1	1
FBgn0011230	1261	1183	991	1008	2252	2191	TRUE	TRUE	TRUE	1	TRUE	TRUE	1	1
FBgn0011232	293	318	210	208	503	526	TRUE	TRUE	TRUE	1	TRUE	TRUE	1	1
FBgn0011236	94	85	79	66	173	151	TRUE	TRUE	TRUE	1	TRUE	TRUE	1	1
FBgn0011239	114	93	69	80	183	173	TRUE	TRUE	TRUE	1	TRUE	TRUE	1	1
FBgn0011244	153	133	107	115	260	248	TRUE	TRUE	TRUE	1	TRUE	TRUE	1	1
FBgn0011259	906	827	734	777	1640	1604	FALSE	TRUE	TRUE	0	TRUE	TRUE	1	0
FBgn0011260	490	454	426	431	916	885	TRUE	TRUE	TRUE	1	TRUE	TRUE	1	1
FBgn0011270	60	66	58	46	118	112	TRUE	TRUE	TRUE	1	TRUE	TRUE	1	1
FBgn0011272	108	87	73	72	181	159	TRUE	TRUE	TRUE	1	TRUE	TRUE	1	1
FBgn0011274	379	412	316	326	695	738	TRUE	TRUE	TRUE	1	TRUE	TRUE	1	1
FBgn0011278	146	154	141	141	287	295	TRUE	TRUE	TRUE	1	TRUE	TRUE	1	1
FBgn0011279	60	53	39	49	99	102	TRUE	TRUE	TRUE	1	TRUE	TRUE	1	1
FBgn0011283	48	42	44	33	92	75	TRUE	TRUE	TRUE	1	TRUE	TRUE	1	1
FBgn0011284	94	135	80	94	174	229	FALSE	TRUE	FALSE	0	TRUE	TRUE	1	0
FBgn0011286	619	607	472	498	1091	1105	TRUE	TRUE	TRUE	1	TRUE	TRUE	1	1
FBgn0011288	126	115	92	105	218	220	TRUE	TRUE	TRUE	1	TRUE	TRUE	1	1
FBgn0011289	170	160	143	137	313	297	TRUE	TRUE	TRUE	1	TRUE	TRUE	1	1
FBgn0011290	34	35	24	23	58	58	TRUE	TRUE	TRUE	1	TRUE	TRUE	1	1
FBgn0011291	56	48	34	40	90	88	TRUE	TRUE	TRUE	1	TRUE	TRUE	1	1
FBgn0011293	23	37	27	31	50	68	FALSE	TRUE	TRUE	0	FALSE	TRUE	0	0
FBgn0011294	72	102	73	75	145	177	FALSE	TRUE	FALSE	0	TRUE	TRUE	1	0
FBgn0011296	35	51	38	41	73	92	TRUE	TRUE	TRUE	1	TRUE	TRUE	1	1
FBgn0011297	111	104	73	93	184	197	TRUE	TRUE	TRUE	1	TRUE	TRUE	1	1
FBgn0011300	125	123	105	104	230	227	TRUE	TRUE	TRUE	1	TRUE	TRUE	1	1
FBgn0011305	105	109	63	106	168	215	TRUE	FALSE	FALSE	0	TRUE	FALSE	0	0
FBgn0011327	51	55	41	50	92	105	TRUE	TRUE	TRUE	1	TRUE	TRUE	1	1
FBgn0011335	106	105	103	72	209	177	TRUE	FALSE	TRUE	0	TRUE	TRUE	1	0
FBgn0011336	141	147	123	138	264	285	TRUE	TRUE	TRUE	1	TRUE	TRUE	1	1
FBgn0011361	70	63	53	67	123	130	TRUE	TRUE	TRUE	1	TRUE	TRUE	1	1
FBgn0011455	61	52	47	46	108	98	TRUE	TRUE	TRUE	1	TRUE	TRUE	1	1
FBgn0011474	164	139	119	129	283	268	TRUE	TRUE	TRUE	1	TRUE	TRUE	1	1
FBgn0011481	207	196	154	156	361	352	TRUE	TRUE	TRUE	1	TRUE	TRUE	1	1
FBgn0011509	837	839	68	76	905	915	TRUE	TRUE	TRUE	1	TRUE	TRUE	1	1
FBgn0011554	85	107	72	83	157	190	TRUE	TRUE	FALSE	0	TRUE	TRUE	1	0
FBgn0011555	76	87	62	69	138	156	TRUE	TRUE	TRUE	1	TRUE	TRUE	1	1
FBgn0011556	90	71	77	69	167	140	TRUE	TRUE	TRUE	1	TRUE	TRUE	1	1
FBgn0011559	176	167	172	188	348	355	TRUE	TRUE	TRUE	1	TRUE	TRUE	1	1
FBgn0011569	264	285	218	224	482	509	TRUE	TRUE	TRUE	1	TRUE	TRUE	1	1
FBgn0011570	128	128	86	106	214	234	TRUE	TRUE	TRUE	1	TRUE	TRUE	1	1
FBgn0011573	82	68	77	54	159	122	TRUE	FALSE	FALSE	0	TRUE	TRUE	1	0
FBgn0011581	92	127	98	104	190	231	FALSE	TRUE	FALSE	0	TRUE	TRUE	1	0
FBgn0011582	1073	1052	913	905	1986	1957	TRUE	TRUE	TRUE	1	TRUE	TRUE	1	1
FBgn0011584	223	232	205	177	428	409	TRUE	TRUE	TRUE	1	TRUE	TRUE	1	1
FBgn0011589	610	609	483	545	1093	1154	TRUE	FALSE	TRUE	0	TRUE	TRUE	1	0
FBgn0011591	85	76	68	65	153	141	TRUE	TRUE	TRUE	1	TRUE	TRUE	1	1
FBgn0011592	450	480	397	375	847	855	TRUE	TRUE	TRUE	1	TRUE	TRUE	1	1
FBgn0011596	223	224	187	215	410	439	TRUE	TRUE	TRUE	1	TRUE	TRUE	1	1
FBgn0011603	439	465	341	366	780	831	TRUE	TRUE	TRUE	1	TRUE	TRUE	1	1
FBgn0011604	156	151	138	140	294	291	TRUE	TRUE	TRUE	1	TRUE	TRUE	1	1
FBgn0011638	45	28	34	35	79	63	FALSE	TRUE	TRUE	0	FALSE	TRUE	0	0
FBgn0011640	59	21	34	41	93	62	FALSE	TRUE	FALSE	0	FALSE	TRUE	0	0
FBgn0011642	40	27	20	29	60	56	TRUE	TRUE	TRUE	1	TRUE	TRUE	1	1
FBgn0011648	201	230	177	202	378	432	TRUE	TRUE	FALSE	0	TRUE	TRUE	1	0
FBgn0011653	337	369	283	243	620	612	TRUE	FALSE	TRUE	0	TRUE	TRUE	1	0
FBgn0011655	97	91	65	61	162	152	TRUE	TRUE	TRUE	1	TRUE	TRUE	1	1
FBgn0011656	461	455	358	380	819	835	TRUE	TRUE	TRUE	1	TRUE	TRUE	1	1
FBgn0011659	42	28	19	24	61	52	TRUE	TRUE	TRUE	1	TRUE	TRUE	1	1
FBgn0011660	145	154	126	112	271	266	TRUE	TRUE	TRUE	1	TRUE	TRUE	1	1
FBgn0011666	733	741	589	604	1322	1345	TRUE	TRUE	TRUE	1	TRUE	TRUE	1	1
FBgn0011668	50	44	45	40	95	84	TRUE	TRUE	TRUE	1	TRUE	TRUE	1	1
FBgn0011669	24	26	18	20	42	46	TRUE	TRUE	TRUE	1	TRUE	TRUE	1	1
FBgn0011670	42	54	50	62	92	116	TRUE	TRUE	TRUE	1	TRUE	TRUE	1	1
FBgn0011672	394	404	339	347	733	751	TRUE	TRUE	TRUE	1	TRUE	TRUE	1	1
FBgn0011674	267	269	198	239	465	508	TRUE	FALSE	TRUE	0	TRUE	TRUE	1	0
FBgn0011676	542	590	502	478	1044	1068	TRUE	TRUE	TRUE	1	TRUE	TRUE	1	1
FBgn0011692	180	207	218	162	398	369	TRUE	FALSE	TRUE	0	TRUE	TRUE	1	0
FBgn0011693	41	33	31	27	72	60	TRUE	TRUE	TRUE	1	TRUE	TRUE	1	1
FBgn0011694	28	33	27	18	55	51	TRUE	TRUE	TRUE	1	TRUE	TRUE	1	1
FBgn0011695	58	64	54	47	112	111	TRUE	TRUE	TRUE	1	TRUE	TRUE	1	1
FBgn0011701	186	210	168	189	354	399	TRUE	TRUE	TRUE	1	TRUE	TRUE	1	1
FBgn0011703	182	175	137	125	319	300	TRUE	TRUE	TRUE	1	TRUE	TRUE	1	1
FBgn0011704	77	48	56	68	133	116	FALSE	TRUE	TRUE	0	FALSE	TRUE	0	0
FBgn0011705	159	143	131	147	290	290	TRUE	TRUE	TRUE	1	TRUE	TRUE	1	1
FBgn0011706	65	72	56	62	121	134	TRUE	TRUE	TRUE	1	TRUE	TRUE	1	1
FBgn0011708	97	119	77	94	174	213	TRUE	TRUE	FALSE	0	TRUE	TRUE	1	0
FBgn0011715	75	70	51	64	126	134	TRUE	TRUE	TRUE	1	TRUE	TRUE	1	1
FBgn0011722	601	610	465	487	1066	1097	TRUE	TRUE	TRUE	1	TRUE	TRUE	1	1
FBgn0011723	268	302	245	213	513	515	TRUE	TRUE	TRUE	1	TRUE	TRUE	1	1
FBgn0011725	320	350	263	291	583	641	TRUE	TRUE	TRUE	1	TRUE	TRUE	1	1
FBgn0011726	40	27	31	28	71	55	TRUE	TRUE	TRUE	1	TRUE	TRUE	1	1
FBgn0011737	168	179	152	154	320	333	TRUE	TRUE	TRUE	1	TRUE	TRUE	1	1
FBgn0011739	428	441	322	349	750	790	TRUE	TRUE	TRUE	1	TRUE	TRUE	1	1
FBgn0011740	116	138	118	126	234	264	TRUE	TRUE	TRUE	1	TRUE	TRUE	1	1
FBgn0011743	102	80	71	64	173	144	TRUE	TRUE	TRUE	1	TRUE	TRUE	1	1
FBgn0011745	106	98	96	78	202	176	TRUE	TRUE	TRUE	1	TRUE	TRUE	1	1
FBgn0011746	174	194	207	167	381	361	TRUE	FALSE	TRUE	0	TRUE	TRUE	1	0
FBgn0011747	145	135	103	132	248	267	TRUE	FALSE	TRUE	0	TRUE	TRUE	1	0
FBgn0011762	89	97	90	80	179	177	TRUE	TRUE	TRUE	1	TRUE	TRUE	1	1
FBgn0011763	112	108	90	80	202	188	TRUE	TRUE	TRUE	1	TRUE	TRUE	1	1
FBgn0011766	401	381	338	331	739	712	TRUE	TRUE	TRUE	1	TRUE	TRUE	1	1
FBgn0011768	58	37	41	45	99	82	FALSE	TRUE	TRUE	0	FALSE	TRUE	0	0
FBgn0011769	78	79	78	58	156	137	TRUE	TRUE	TRUE	1	TRUE	TRUE	1	1
FBgn0011771	77	66	55	52	132	118	TRUE	TRUE	TRUE	1	TRUE	TRUE	1	1
FBgn0011774	104	75	79	84	183	159	FALSE	TRUE	TRUE	0	TRUE	TRUE	1	0
FBgn0011785	360	311	274	262	634	573	FALSE	TRUE	FALSE	0	TRUE	TRUE	1	0
FBgn0011787	17	23	18	14	35	37	TRUE	TRUE	TRUE	1	TRUE	TRUE	1	1
FBgn0011802	451	397	364	380	815	777	FALSE	TRUE	TRUE	0	TRUE	TRUE	1	0
FBgn0011812	51	65	42	51	93	116	TRUE	TRUE	TRUE	1	TRUE	TRUE	1	1
FBgn0011817	476	450	379	411	855	861	TRUE	TRUE	TRUE	1	TRUE	TRUE	1	1
FBgn0011818	250	270	234	218	484	488	TRUE	TRUE	TRUE	1	TRUE	TRUE	1	1
FBgn0011824	67	79	76	78	143	157	TRUE	TRUE	TRUE	1	TRUE	TRUE	1	1
FBgn0011828	592	544	453	470	1045	1014	TRUE	TRUE	TRUE	1	TRUE	TRUE	1	1
FBgn0011829	196	174	157	188	353	362	TRUE	TRUE	TRUE	1	TRUE	TRUE	1	1
FBgn0011832	44	28	30	22	74	50	FALSE	TRUE	FALSE	0	FALSE	TRUE	0	0
FBgn0011836	277	305	220	222	497	527	TRUE	TRUE	TRUE	1	TRUE	TRUE	1	1
FBgn0011844	19	28	15	19	34	47	TRUE	TRUE	TRUE	1	TRUE	TRUE	1	1
FBgn0011861	36	24	23	27	59	51	TRUE	TRUE	TRUE	1	TRUE	TRUE	1	1
FBgn0011862	27	42	20	36	47	78	FALSE	FALSE	FALSE	0	FALSE	FALSE	0	0
FBgn0011865	31	32	16	23	47	55	TRUE	TRUE	TRUE	1	TRUE	TRUE	1	1
FBgn0011867	34	29	31	34	65	63	TRUE	TRUE	TRUE	1	TRUE	TRUE	1	1
FBgn0011869	37	33	27	26	64	59	TRUE	TRUE	TRUE	1	TRUE	TRUE	1	1
FBgn0011881	21	19	13	22	34	41	TRUE	TRUE	TRUE	1	TRUE	FALSE	0	0
FBgn0011883	28	36	28	21	56	57	TRUE	TRUE	TRUE	1	TRUE	TRUE	1	1
FBgn0011884	29	21	15	18	44	39	TRUE	TRUE	TRUE	1	TRUE	TRUE	1	1
FBgn0011890	22	22	17	15	39	37	TRUE	TRUE	TRUE	1	TRUE	TRUE	1	1
FBgn0011892	17	28	21	15	38	43	TRUE	TRUE	TRUE	1	FALSE	TRUE	0	0
FBgn0011896	46	33	32	35	78	68	TRUE	TRUE	TRUE	1	TRUE	TRUE	1	1
FBgn0011897	21	32	24	17	45	49	TRUE	TRUE	TRUE	1	FALSE	TRUE	0	0
FBgn0011905	12	27	24	16	36	43	FALSE	TRUE	TRUE	0	FALSE	TRUE	0	0
FBgn0011909	31	29	19	25	50	54	TRUE	TRUE	TRUE	1	TRUE	TRUE	1	1
FBgn0011910	33	28	23	22	56	50	TRUE	TRUE	TRUE	1	TRUE	TRUE	1	1
FBgn0011916	22	16	20	17	42	33	TRUE	TRUE	TRUE	1	TRUE	TRUE	1	1
FBgn0011921	27	23	27	25	54	48	TRUE	TRUE	TRUE	1	TRUE	TRUE	1	1
FBgn0011927	28	17	29	19	57	36	TRUE	TRUE	FALSE	0	FALSE	FALSE	0	0
FBgn0011955	25	33	26	29	51	62	TRUE	TRUE	TRUE	1	TRUE	TRUE	1	1
FBgn0011956	14	18	18	24	32	42	TRUE	TRUE	TRUE	1	TRUE	TRUE	1	1
FBgn0011961	19	13	20	20	39	33	TRUE	TRUE	TRUE	1	TRUE	TRUE	1	1
FBgn0011962	16	19	12	26	28	45	TRUE	FALSE	FALSE	0	TRUE	FALSE	0	0
FBgn0011963	19	17	16	25	35	42	TRUE	TRUE	TRUE	1	TRUE	FALSE	0	0
FBgn0011971	43	33	23	32	66	65	TRUE	TRUE	TRUE	1	TRUE	TRUE	1	1
FBgn0011994	18	27	20	25	38	52	TRUE	TRUE	TRUE	1	TRUE	TRUE	1	1
FBgn0012002	21	25	30	27	51	52	TRUE	TRUE	TRUE	1	TRUE	TRUE	1	1
FBgn0012003	29	32	20	31	49	63	TRUE	TRUE	TRUE	1	TRUE	FALSE	0	0
FBgn0012004	33	37	19	23	52	60	TRUE	TRUE	TRUE	1	TRUE	TRUE	1	1
FBgn0012010	34	28	20	25	54	53	TRUE	TRUE	TRUE	1	TRUE	TRUE	1	1
FBgn0012016	26	31	16	19	42	50	TRUE	TRUE	TRUE	1	TRUE	TRUE	1	1
FBgn0012034	97	85	63	71	160	156	TRUE	TRUE	TRUE	1	TRUE	TRUE	1	1
FBgn0012036	168	147	120	150	288	297	TRUE	FALSE	TRUE	0	TRUE	TRUE	1	0
FBgn0012037	194	201	155	163	349	364	TRUE	TRUE	TRUE	1	TRUE	TRUE	1	1
FBgn0012042	101	77	70	63	171	140	FALSE	TRUE	FALSE	0	TRUE	TRUE	1	0
FBgn0012051	433	414	351	331	784	745	TRUE	TRUE	TRUE	1	TRUE	TRUE	1	1
FBgn0012058	231	177	138	163	369	340	FALSE	TRUE	TRUE	0	TRUE	TRUE	1	0
FBgn0012344	102	116	94	104	196	220	TRUE	TRUE	TRUE	1	TRUE	TRUE	1	1
FBgn0013263	79	61	56	74	135	135	TRUE	TRUE	TRUE	1	TRUE	TRUE	1	1
FBgn0013269	26	24	31	26	57	50	TRUE	TRUE	TRUE	1	TRUE	TRUE	1	1
FBgn0013272	330	337	287	283	617	620	TRUE	TRUE	TRUE	1	TRUE	TRUE	1	1
FBgn0013276	17	26	21	22	38	48	TRUE	TRUE	TRUE	1	FALSE	TRUE	0	0
FBgn0013300	81	77	76	81	157	158	TRUE	TRUE	TRUE	1	TRUE	TRUE	1	1
FBgn0013301	26	27	40	24	66	51	TRUE	FALSE	TRUE	0	TRUE	FALSE	0	0
FBgn0013305	209	222	205	192	414	414	TRUE	TRUE	TRUE	1	TRUE	TRUE	1	1
FBgn0013307	91	102	71	79	162	181	TRUE	TRUE	TRUE	1	TRUE	TRUE	1	1
FBgn0013308	140	160	132	97	272	257	TRUE	FALSE	TRUE	0	TRUE	TRUE	1	0
FBgn0013323	58	72	64	63	122	135	TRUE	TRUE	TRUE	1	TRUE	TRUE	1	1
FBgn0013325	97	98	77	93	174	191	TRUE	TRUE	TRUE	1	TRUE	TRUE	1	1
FBgn0013334	253	253	206	231	459	484	TRUE	TRUE	TRUE	1	TRUE	TRUE	1	1
FBgn0013342	159	159	133	123	292	282	TRUE	TRUE	TRUE	1	TRUE	TRUE	1	1
FBgn0013343	177	162	159	134	336	296	TRUE	TRUE	TRUE	1	TRUE	TRUE	1	1
FBgn0013347	53	57	42	45	95	102	TRUE	TRUE	TRUE	1	TRUE	TRUE	1	1
FBgn0013348	155	129	127	128	282	257	TRUE	TRUE	TRUE	1	TRUE	TRUE	1	1
FBgn0013433	327	311	262	266	589	577	TRUE	TRUE	TRUE	1	TRUE	TRUE	1	1
FBgn0013435	88	84	71	56	159	140	TRUE	TRUE	TRUE	1	TRUE	TRUE	1	1
FBgn0013467	233	237	182	191	415	428	TRUE	TRUE	TRUE	1	TRUE	TRUE	1	1
FBgn0013469	350	355	296	260	646	615	TRUE	TRUE	TRUE	1	TRUE	TRUE	1	1
FBgn0013531	66	54	58	58	124	112	TRUE	TRUE	TRUE	1	TRUE	TRUE	1	1
FBgn0013548	145	164	95	94	240	258	TRUE	TRUE	TRUE	1	TRUE	TRUE	1	1
FBgn0013563	261	278	238	240	499	518	TRUE	TRUE	TRUE	1	TRUE	TRUE	1	1
FBgn0013576	486	412	375	346	861	758	FALSE	TRUE	FALSE	0	TRUE	TRUE	1	0
FBgn0013672	10207	51	3897	15	14104	66	FALSE	FALSE	FALSE	0	FALSE	FALSE	0	0
FBgn0013674	12342	48	5188	27	17530	75	FALSE	FALSE	FALSE	0	FALSE	FALSE	0	0
FBgn0013675	12697	48	4800	18	17497	66	FALSE	FALSE	FALSE	0	FALSE	FALSE	0	0
FBgn0013676	5228	12	2051	5	7279	17	FALSE	FALSE	FALSE	0	FALSE	FALSE	0	0
FBgn0013679	14255	171	5224	68	19479	239	FALSE	FALSE	FALSE	0	FALSE	FALSE	0	0
FBgn0013680	11528	35	4356	17	15884	52	FALSE	FALSE	FALSE	0	FALSE	FALSE	0	0
FBgn0013684	15250	54	5940	27	21190	81	FALSE	FALSE	FALSE	0	FALSE	FALSE	0	0
FBgn0013685	7613	27	2749	13	10362	40	FALSE	FALSE	FALSE	0	FALSE	FALSE	0	0
FBgn0013687	23700	2564	7603	756	31303	3320	FALSE	FALSE	FALSE	0	FALSE	FALSE	0	0
FBgn0013717	188	222	170	156	358	378	TRUE	TRUE	TRUE	1	TRUE	TRUE	1	1
FBgn0013718	549	515	468	499	1017	1014	TRUE	TRUE	TRUE	1	TRUE	TRUE	1	1
FBgn0013725	142	129	125	128	267	257	TRUE	TRUE	TRUE	1	TRUE	TRUE	1	1
FBgn0013726	41	35	29	29	70	64	TRUE	TRUE	TRUE	1	TRUE	TRUE	1	1
FBgn0013732	91	74	60	81	151	155	TRUE	FALSE	TRUE	0	TRUE	TRUE	1	0
FBgn0013733	2501	2580	2176	2041	4677	4621	TRUE	FALSE	TRUE	0	TRUE	TRUE	1	0
FBgn0013746	156	158	134	144	290	302	TRUE	TRUE	TRUE	1	TRUE	TRUE	1	1
FBgn0013750	61	53	33	47	94	100	TRUE	TRUE	TRUE	1	TRUE	TRUE	1	1
FBgn0013751	202	237	179	211	381	448	TRUE	TRUE	FALSE	0	TRUE	TRUE	1	0
FBgn0013756	255	269	254	215	509	484	TRUE	FALSE	TRUE	0	TRUE	TRUE	1	0
FBgn0013759	617	548	469	477	1086	1025	FALSE	TRUE	TRUE	0	TRUE	TRUE	1	0
FBgn0013762	131	129	115	108	246	237	TRUE	TRUE	TRUE	1	TRUE	TRUE	1	1
FBgn0013763	198	189	166	172	364	361	TRUE	TRUE	TRUE	1	TRUE	TRUE	1	1
FBgn0013764	90	83	91	77	181	160	TRUE	TRUE	TRUE	1	TRUE	TRUE	1	1
FBgn0013765	480	452	394	407	874	859	TRUE	TRUE	TRUE	1	TRUE	TRUE	1	1
FBgn0013767	61	90	95	103	156	193	FALSE	TRUE	FALSE	0	TRUE	TRUE	1	0
FBgn0013770	130	102	105	100	235	202	FALSE	TRUE	TRUE	0	TRUE	TRUE	1	0
FBgn0013771	134	103	117	118	251	221	FALSE	TRUE	TRUE	0	TRUE	TRUE	1	0
FBgn0013772	130	124	109	121	239	245	TRUE	TRUE	TRUE	1	TRUE	TRUE	1	1
FBgn0013773	104	111	75	85	179	196	TRUE	TRUE	TRUE	1	TRUE	TRUE	1	1
FBgn0013799	37	35	26	30	63	65	TRUE	TRUE	TRUE	1	TRUE	TRUE	1	1
FBgn0013810	964	953	768	801	1732	1754	TRUE	TRUE	TRUE	1	TRUE	TRUE	1	1
FBgn0013811	573	598	414	465	987	1063	TRUE	FALSE	FALSE	0	TRUE	TRUE	1	0
FBgn0013812	1033	1038	868	914	1901	1952	TRUE	TRUE	TRUE	1	TRUE	TRUE	1	1
FBgn0013813	1011	1026	854	841	1865	1867	TRUE	TRUE	TRUE	1	TRUE	TRUE	1	1
FBgn0013949	147	145	107	119	254	264	TRUE	TRUE	TRUE	1	TRUE	TRUE	1	1
FBgn0013953	263	292	224	227	487	519	TRUE	TRUE	TRUE	1	TRUE	TRUE	1	1
FBgn0013954	70	60	50	44	120	104	TRUE	TRUE	TRUE	1	TRUE	TRUE	1	1
FBgn0013972	195	204	157	173	352	377	TRUE	TRUE	TRUE	1	TRUE	TRUE	1	1
FBgn0013973	422	472	382	402	804	874	TRUE	TRUE	FALSE	0	TRUE	TRUE	1	0
FBgn0013981	19	34	19	22	38	56	FALSE	TRUE	FALSE	0	FALSE	TRUE	0	0
FBgn0013983	98	120	79	90	177	210	TRUE	TRUE	TRUE	1	TRUE	TRUE	1	1
FBgn0013995	646	650	496	536	1142	1186	TRUE	TRUE	TRUE	1	TRUE	TRUE	1	1
FBgn0013997	547	472	447	404	994	876	FALSE	TRUE	FALSE	0	TRUE	TRUE	1	0
FBgn0014000	93	100	97	88	190	188	TRUE	TRUE	TRUE	1	TRUE	TRUE	1	1
FBgn0014006	364	357	279	304	643	661	TRUE	TRUE	TRUE	1	TRUE	TRUE	1	1
FBgn0014007	335	310	256	250	591	560	TRUE	TRUE	TRUE	1	TRUE	TRUE	1	1
FBgn0014009	72	61	39	55	111	116	TRUE	TRUE	TRUE	1	TRUE	TRUE	1	1
FBgn0014010	240	266	241	206	481	472	TRUE	TRUE	TRUE	1	TRUE	TRUE	1	1
FBgn0014011	174	172	130	155	304	327	TRUE	TRUE	TRUE	1	TRUE	TRUE	1	1
FBgn0014018	103	96	109	94	212	190	TRUE	TRUE	TRUE	1	TRUE	TRUE	1	1
FBgn0014019	110	128	99	119	209	247	TRUE	TRUE	FALSE	0	TRUE	TRUE	1	0
FBgn0014020	123	139	112	100	235	239	TRUE	TRUE	TRUE	1	TRUE	TRUE	1	1
FBgn0014022	30	19	33	26	63	45	TRUE	TRUE	TRUE	1	FALSE	TRUE	0	0
FBgn0014023	31	37	16	15	47	52	TRUE	TRUE	TRUE	1	TRUE	TRUE	1	1
FBgn0014028	23	24	17	33	40	57	TRUE	FALSE	TRUE	0	TRUE	FALSE	0	0
FBgn0014029	58	58	50	67	108	125	TRUE	TRUE	TRUE	1	TRUE	TRUE	1	1
FBgn0014033	237	228	202	182	439	410	TRUE	TRUE	TRUE	1	TRUE	TRUE	1	1
FBgn0014037	118	143	124	112	242	255	TRUE	TRUE	TRUE	1	TRUE	TRUE	1	1
FBgn0014073	460	453	396	395	856	848	TRUE	TRUE	TRUE	1	TRUE	TRUE	1	1
FBgn0014075	186	186	152	152	338	338	TRUE	TRUE	TRUE	1	TRUE	TRUE	1	1
FBgn0014076	84	83	46	66	130	149	TRUE	FALSE	TRUE	0	TRUE	TRUE	1	0
FBgn0014092	58	66	56	36	114	102	TRUE	FALSE	TRUE	0	TRUE	FALSE	0	0
FBgn0014127	181	156	150	150	331	306	TRUE	TRUE	TRUE	1	TRUE	TRUE	1	1
FBgn0014135	346	358	282	291	628	649	TRUE	TRUE	TRUE	1	TRUE	TRUE	1	1
FBgn0014141	789	765	666	624	1455	1389	TRUE	TRUE	TRUE	1	TRUE	TRUE	1	1
FBgn0014143	65	75	58	59	123	134	TRUE	TRUE	TRUE	1	TRUE	TRUE	1	1
FBgn0014163	221	208	156	168	377	376	TRUE	TRUE	TRUE	1	TRUE	TRUE	1	1
FBgn0014179	79	86	42	51	121	137	TRUE	TRUE	TRUE	1	TRUE	TRUE	1	1
FBgn0014189	209	215	183	168	392	383	TRUE	TRUE	TRUE	1	TRUE	TRUE	1	1
FBgn0014269	129	119	90	107	219	226	TRUE	TRUE	TRUE	1	TRUE	TRUE	1	1
FBgn0014342	38	33	29	32	67	65	TRUE	TRUE	TRUE	1	TRUE	TRUE	1	1
FBgn0014343	344	333	252	257	596	590	TRUE	TRUE	TRUE	1	TRUE	TRUE	1	1
FBgn0014368	52	60	46	67	98	127	TRUE	FALSE	FALSE	0	TRUE	TRUE	1	0
FBgn0014380	31	28	37	32	68	60	TRUE	TRUE	TRUE	1	TRUE	TRUE	1	1
FBgn0014388	332	323	258	253	590	576	TRUE	TRUE	TRUE	1	TRUE	TRUE	1	1
FBgn0014396	636	539	487	496	1123	1035	FALSE	TRUE	FALSE	0	TRUE	TRUE	1	0
FBgn0014417	167	161	155	131	322	292	TRUE	TRUE	TRUE	1	TRUE	TRUE	1	1
FBgn0014427	111	121	83	108	194	229	TRUE	FALSE	FALSE	0	TRUE	TRUE	1	0
FBgn0014454	59	62	50	46	109	108	TRUE	TRUE	TRUE	1	TRUE	TRUE	1	1
FBgn0014469	92	109	111	71	203	180	TRUE	FALSE	TRUE	0	TRUE	FALSE	0	0
FBgn0014848	50	59	40	37	90	96	TRUE	TRUE	TRUE	1	TRUE	TRUE	1	1
FBgn0014849	85	79	55	56	140	135	TRUE	TRUE	TRUE	1	TRUE	TRUE	1	1
FBgn0014850	42	35	36	37	78	72	TRUE	TRUE	TRUE	1	TRUE	TRUE	1	1
FBgn0014851	79	63	53	55	132	118	TRUE	TRUE	TRUE	1	TRUE	TRUE	1	1
FBgn0014857	32	30	20	19	52	49	TRUE	TRUE	TRUE	1	TRUE	TRUE	1	1
FBgn0014859	394	416	335	352	729	768	TRUE	TRUE	TRUE	1	TRUE	TRUE	1	1
FBgn0014861	67	60	52	45	119	105	TRUE	TRUE	TRUE	1	TRUE	TRUE	1	1
FBgn0014863	106	105	66	74	172	179	TRUE	TRUE	TRUE	1	TRUE	TRUE	1	1
FBgn0014865	47	37	39	32	86	69	TRUE	TRUE	TRUE	1	TRUE	TRUE	1	1
FBgn0014869	91	101	75	71	166	172	TRUE	TRUE	TRUE	1	TRUE	TRUE	1	1
FBgn0014870	236	240	221	197	457	437	TRUE	TRUE	TRUE	1	TRUE	TRUE	1	1
FBgn0014877	133	119	99	90	232	209	TRUE	TRUE	TRUE	1	TRUE	TRUE	1	1
FBgn0014879	79	86	71	76	150	162	TRUE	TRUE	TRUE	1	TRUE	TRUE	1	1
FBgn0014906	138	153	101	127	239	280	TRUE	FALSE	FALSE	0	TRUE	TRUE	1	0
FBgn0014931	17	14	18	22	35	36	TRUE	TRUE	TRUE	1	TRUE	TRUE	1	1
FBgn0014949	18	24	25	10	43	34	TRUE	FALSE	TRUE	0	TRUE	FALSE	0	0
FBgn0015000	137	131	91	136	228	267	TRUE	FALSE	FALSE	0	TRUE	TRUE	1	0
FBgn0015001	43	43	30	35	73	78	TRUE	TRUE	TRUE	1	TRUE	TRUE	1	1
FBgn0015008	21	39	39	27	60	66	FALSE	TRUE	TRUE	0	FALSE	TRUE	0	0
FBgn0015011	154	125	115	104	269	229	FALSE	TRUE	FALSE	0	TRUE	TRUE	1	0
FBgn0015019	54	55	40	27	94	82	TRUE	TRUE	TRUE	1	TRUE	TRUE	1	1
FBgn0015025	105	86	95	94	200	180	TRUE	TRUE	TRUE	1	TRUE	TRUE	1	1
FBgn0015031	27	42	30	36	57	78	FALSE	TRUE	FALSE	0	FALSE	TRUE	0	0
FBgn0015032	192	172	132	144	324	316	TRUE	TRUE	TRUE	1	TRUE	TRUE	1	1
FBgn0015033	113	105	87	85	200	190	TRUE	TRUE	TRUE	1	TRUE	TRUE	1	1
FBgn0015034	75	72	71	57	146	129	TRUE	TRUE	TRUE	1	TRUE	TRUE	1	1
FBgn0015035	217	227	168	193	385	420	TRUE	TRUE	TRUE	1	TRUE	TRUE	1	1
FBgn0015037	158	192	138	159	296	351	FALSE	TRUE	FALSE	0	TRUE	TRUE	1	0
FBgn0015038	61	42	47	50	108	92	FALSE	TRUE	TRUE	0	TRUE	TRUE	1	0
FBgn0015039	129	104	93	99	222	203	TRUE	TRUE	TRUE	1	TRUE	TRUE	1	1
FBgn0015218	151	153	144	136	295	289	TRUE	TRUE	TRUE	1	TRUE	TRUE	1	1
FBgn0015221	143	141	123	125	266	266	TRUE	TRUE	TRUE	1	TRUE	TRUE	1	1
FBgn0015222	119	103	80	90	199	193	TRUE	TRUE	TRUE	1	TRUE	TRUE	1	1
FBgn0015229	113	99	95	92	208	191	TRUE	TRUE	TRUE	1	TRUE	TRUE	1	1
FBgn0015230	82	77	60	50	142	127	TRUE	TRUE	TRUE	1	TRUE	TRUE	1	1
FBgn0015240	81	81	72	77	153	158	TRUE	TRUE	TRUE	1	TRUE	TRUE	1	1
FBgn0015247	84	61	64	52	148	113	FALSE	TRUE	FALSE	0	TRUE	TRUE	1	0
FBgn0015268	41	32	17	33	58	65	TRUE	FALSE	TRUE	0	TRUE	FALSE	0	0
FBgn0015269	605	585	527	521	1132	1106	TRUE	TRUE	TRUE	1	TRUE	TRUE	1	1
FBgn0015270	73	83	74	75	147	158	TRUE	TRUE	TRUE	1	TRUE	TRUE	1	1
FBgn0015271	99	110	79	78	178	188	TRUE	TRUE	TRUE	1	TRUE	TRUE	1	1
FBgn0015277	253	264	206	209	459	473	TRUE	TRUE	TRUE	1	TRUE	TRUE	1	1
FBgn0015278	478	519	364	414	842	933	TRUE	FALSE	FALSE	0	TRUE	TRUE	1	0
FBgn0015279	246	253	168	176	414	429	TRUE	TRUE	TRUE	1	TRUE	TRUE	1	1
FBgn0015282	46	66	49	51	95	117	FALSE	TRUE	TRUE	0	TRUE	TRUE	1	0
FBgn0015283	39	25	22	25	61	50	TRUE	TRUE	TRUE	1	FALSE	TRUE	0	0
FBgn0015295	247	240	175	180	422	420	TRUE	TRUE	TRUE	1	TRUE	TRUE	1	1
FBgn0015296	135	124	91	92	226	216	TRUE	TRUE	TRUE	1	TRUE	TRUE	1	1
FBgn0015298	35	24	23	18	58	42	TRUE	TRUE	TRUE	1	TRUE	TRUE	1	1
FBgn0015300	78	105	69	81	147	186	FALSE	TRUE	FALSE	0	TRUE	TRUE	1	0
FBgn0015316	93	81	74	58	167	139	TRUE	TRUE	TRUE	1	TRUE	TRUE	1	1
FBgn0015320	81	89	75	94	156	183	TRUE	TRUE	TRUE	1	TRUE	TRUE	1	1
FBgn0015321	124	106	93	84	217	190	TRUE	TRUE	TRUE	1	TRUE	TRUE	1	1
FBgn0015338	77	48	47	69	124	117	FALSE	FALSE	TRUE	0	FALSE	TRUE	0	0
FBgn0015351	52	63	61	56	113	119	TRUE	TRUE	TRUE	1	TRUE	TRUE	1	1
FBgn0015359	90	93	51	62	141	155	TRUE	TRUE	TRUE	1	TRUE	TRUE	1	1
FBgn0015360	326	390	184	204	510	594	FALSE	TRUE	FALSE	0	TRUE	TRUE	1	0
FBgn0015371	354	367	274	275	628	642	TRUE	TRUE	TRUE	1	TRUE	TRUE	1	1
FBgn0015372	112	110	89	91	201	201	TRUE	TRUE	TRUE	1	TRUE	TRUE	1	1
FBgn0015376	272	277	241	219	513	496	TRUE	TRUE	TRUE	1	TRUE	TRUE	1	1
FBgn0015380	257	248	192	212	449	460	TRUE	TRUE	TRUE	1	TRUE	TRUE	1	1
FBgn0015381	308	358	279	256	587	614	FALSE	TRUE	TRUE	0	TRUE	TRUE	1	0
FBgn0015391	223	214	159	185	382	399	TRUE	TRUE	TRUE	1	TRUE	TRUE	1	1
FBgn0015396	45	59	58	58	103	117	TRUE	TRUE	TRUE	1	TRUE	TRUE	1	1
FBgn0015399	373	368	329	322	702	690	TRUE	TRUE	TRUE	1	TRUE	TRUE	1	1
FBgn0015400	540	520	412	406	952	926	TRUE	TRUE	TRUE	1	TRUE	TRUE	1	1
FBgn0015402	58	59	41	49	99	108	TRUE	TRUE	TRUE	1	TRUE	TRUE	1	1
FBgn0015477	395	429	333	355	728	784	TRUE	TRUE	TRUE	1	TRUE	TRUE	1	1
FBgn0015509	45	40	41	37	86	77	TRUE	TRUE	TRUE	1	TRUE	TRUE	1	1
FBgn0015513	635	687	541	546	1176	1233	TRUE	TRUE	TRUE	1	TRUE	TRUE	1	1
FBgn0015520	107	120	102	124	209	244	TRUE	TRUE	TRUE	1	TRUE	TRUE	1	1
FBgn0015521	74	80	42	67	116	147	TRUE	FALSE	FALSE	0	TRUE	FALSE	0	0
FBgn0015522	142	126	104	126	246	252	TRUE	TRUE	TRUE	1	TRUE	TRUE	1	1
FBgn0015524	312	272	249	269	561	541	TRUE	TRUE	TRUE	1	TRUE	TRUE	1	1
FBgn0015543	14	23	21	13	35	36	TRUE	TRUE	TRUE	1	FALSE	FALSE	0	0
FBgn0015544	85	86	85	72	170	158	TRUE	TRUE	TRUE	1	TRUE	TRUE	1	1
FBgn0015546	331	355	294	283	625	638	TRUE	TRUE	TRUE	1	TRUE	TRUE	1	1
FBgn0015550	81	95	77	81	158	176	TRUE	TRUE	TRUE	1	TRUE	TRUE	1	1
FBgn0015553	168	163	131	118	299	281	TRUE	TRUE	TRUE	1	TRUE	TRUE	1	1
FBgn0015561	77	56	48	46	125	102	FALSE	TRUE	TRUE	0	TRUE	TRUE	1	0
FBgn0015569	127	134	105	114	232	248	TRUE	TRUE	TRUE	1	TRUE	TRUE	1	1
FBgn0015570	52	51	33	46	85	97	TRUE	TRUE	TRUE	1	TRUE	TRUE	1	1
FBgn0015572	56	57	34	39	90	96	TRUE	TRUE	TRUE	1	TRUE	TRUE	1	1
FBgn0015574	36	35	30	28	66	63	TRUE	TRUE	TRUE	1	TRUE	TRUE	1	1
FBgn0015575	31	31	17	32	48	63	TRUE	FALSE	TRUE	0	TRUE	FALSE	0	0
FBgn0015576	210	190	151	152	361	342	TRUE	TRUE	TRUE	1	TRUE	TRUE	1	1
FBgn0015577	77	77	66	73	143	150	TRUE	TRUE	TRUE	1	TRUE	TRUE	1	1
FBgn0015582	73	76	49	49	122	125	TRUE	TRUE	TRUE	1	TRUE	TRUE	1	1
FBgn0015583	50	39	30	36	80	75	TRUE	TRUE	TRUE	1	TRUE	TRUE	1	1
FBgn0015584	32	36	40	30	72	66	TRUE	TRUE	TRUE	1	TRUE	TRUE	1	1
FBgn0015586	120	126	100	89	220	215	TRUE	TRUE	TRUE	1	TRUE	TRUE	1	1
FBgn0015589	568	529	481	426	1049	955	TRUE	FALSE	FALSE	0	TRUE	TRUE	1	0
FBgn0015591	112	138	98	112	210	250	TRUE	TRUE	FALSE	0	TRUE	TRUE	1	0
FBgn0015600	518	550	434	446	952	996	TRUE	TRUE	TRUE	1	TRUE	TRUE	1	1
FBgn0015602	41	46	29	43	70	89	TRUE	TRUE	TRUE	1	TRUE	TRUE	1	1
FBgn0015609	993	1030	890	916	1883	1946	TRUE	TRUE	TRUE	1	TRUE	TRUE	1	1
FBgn0015614	115	134	87	93	202	227	TRUE	TRUE	TRUE	1	TRUE	TRUE	1	1
FBgn0015618	135	137	138	107	273	244	TRUE	FALSE	TRUE	0	TRUE	TRUE	1	0
FBgn0015621	54	62	41	53	95	115	TRUE	TRUE	TRUE	1	TRUE	TRUE	1	1
FBgn0015622	276	265	259	257	535	522	TRUE	TRUE	TRUE	1	TRUE	TRUE	1	1
FBgn0015623	319	270	269	210	588	480	FALSE	FALSE	FALSE	0	TRUE	TRUE	1	0
FBgn0015625	123	108	91	82	214	190	TRUE	TRUE	TRUE	1	TRUE	TRUE	1	1
FBgn0015663	140	140	142	141	282	281	TRUE	TRUE	TRUE	1	TRUE	TRUE	1	1
FBgn0015664	233	251	200	182	433	433	TRUE	TRUE	TRUE	1	TRUE	TRUE	1	1
FBgn0015714	6	31	11	24	17	55	FALSE	FALSE	FALSE	0	FALSE	FALSE	0	0
FBgn0015721	243	233	173	187	416	420	TRUE	TRUE	TRUE	1	TRUE	TRUE	1	1
FBgn0015737	156	143	151	147	307	290	TRUE	TRUE	TRUE	1	TRUE	TRUE	1	1
FBgn0015754	250	204	211	201	461	405	FALSE	TRUE	FALSE	0	TRUE	TRUE	1	0
FBgn0015756	76	73	64	76	140	149	TRUE	TRUE	TRUE	1	TRUE	TRUE	1	1
FBgn0015765	189	164	144	116	333	280	TRUE	FALSE	FALSE	0	TRUE	TRUE	1	0
FBgn0015766	197	181	168	171	365	352	TRUE	TRUE	TRUE	1	TRUE	TRUE	1	1
FBgn0015770	87	87	77	69	164	156	TRUE	TRUE	TRUE	1	TRUE	TRUE	1	1
FBgn0015772	338	310	310	281	648	591	TRUE	TRUE	TRUE	1	TRUE	TRUE	1	1
FBgn0015776	186	188	159	154	345	342	TRUE	TRUE	TRUE	1	TRUE	TRUE	1	1
FBgn0015777	393	395	365	353	758	748	TRUE	TRUE	TRUE	1	TRUE	TRUE	1	1
FBgn0015778	187	202	171	150	358	352	TRUE	TRUE	TRUE	1	TRUE	TRUE	1	1
FBgn0015781	41	47	36	22	77	69	TRUE	FALSE	TRUE	0	TRUE	FALSE	0	0
FBgn0015790	190	157	132	151	322	308	FALSE	TRUE	TRUE	0	TRUE	TRUE	1	0
FBgn0015791	201	148	174	165	375	313	FALSE	TRUE	FALSE	0	TRUE	TRUE	1	0
FBgn0015793	152	120	96	90	248	210	FALSE	TRUE	FALSE	0	TRUE	TRUE	1	0
FBgn0015795	123	105	109	137	232	242	TRUE	FALSE	TRUE	0	TRUE	TRUE	1	0
FBgn0015797	75	79	74	66	149	145	TRUE	TRUE	TRUE	1	TRUE	TRUE	1	1
FBgn0015801	69	56	53	58	122	114	TRUE	TRUE	TRUE	1	TRUE	TRUE	1	1
FBgn0015803	379	370	354	319	733	689	TRUE	TRUE	TRUE	1	TRUE	TRUE	1	1
FBgn0015805	105	114	106	93	211	207	TRUE	TRUE	TRUE	1	TRUE	TRUE	1	1
FBgn0015808	93	93	75	80	168	173	TRUE	TRUE	TRUE	1	TRUE	TRUE	1	1
FBgn0015828	142	144	99	112	241	256	TRUE	TRUE	TRUE	1	TRUE	TRUE	1	1
FBgn0015829	153	154	115	127	268	281	TRUE	TRUE	TRUE	1	TRUE	TRUE	1	1
FBgn0015834	72	95	62	63	134	158	FALSE	TRUE	TRUE	0	TRUE	TRUE	1	0
FBgn0015838	146	125	115	120	261	245	TRUE	TRUE	TRUE	1	TRUE	TRUE	1	1
FBgn0015872	303	253	263	245	566	498	FALSE	TRUE	FALSE	0	TRUE	TRUE	1	0
FBgn0015903	314	329	276	282	590	611	TRUE	TRUE	TRUE	1	TRUE	TRUE	1	1
FBgn0015904	287	262	218	210	505	472	TRUE	TRUE	TRUE	1	TRUE	TRUE	1	1
FBgn0015905	268	233	198	216	466	449	TRUE	TRUE	TRUE	1	TRUE	TRUE	1	1
FBgn0015919	294	273	221	235	515	508	TRUE	TRUE	TRUE	1	TRUE	TRUE	1	1
FBgn0015924	135	132	110	118	245	250	TRUE	TRUE	TRUE	1	TRUE	TRUE	1	1
FBgn0015925	158	105	88	104	246	209	FALSE	TRUE	FALSE	0	FALSE	TRUE	0	0
FBgn0015929	142	179	140	121	282	300	FALSE	TRUE	TRUE	0	TRUE	TRUE	1	0
FBgn0015946	23	15	20	12	43	27	TRUE	TRUE	FALSE	0	FALSE	FALSE	0	0
FBgn0015949	307	305	282	267	589	572	TRUE	TRUE	TRUE	1	TRUE	TRUE	1	1
FBgn0016013	152	154	140	146	292	300	TRUE	TRUE	TRUE	1	TRUE	TRUE	1	1
FBgn0016031	378	324	304	332	682	656	FALSE	TRUE	TRUE	0	TRUE	TRUE	1	0
FBgn0016032	117	104	118	98	235	202	TRUE	TRUE	TRUE	1	TRUE	TRUE	1	1
FBgn0016034	41	46	38	28	79	74	TRUE	TRUE	TRUE	1	TRUE	TRUE	1	1
FBgn0016036	92	82	86	85	178	167	TRUE	TRUE	TRUE	1	TRUE	TRUE	1	1
FBgn0016047	436	468	418	379	854	847	TRUE	TRUE	TRUE	1	TRUE	TRUE	1	1
FBgn0016053	44	52	42	44	86	96	TRUE	TRUE	TRUE	1	TRUE	TRUE	1	1
FBgn0016054	60	68	57	65	117	133	TRUE	TRUE	TRUE	1	TRUE	TRUE	1	1
FBgn0016059	443	480	348	376	791	856	TRUE	TRUE	TRUE	1	TRUE	TRUE	1	1
FBgn0016061	840	879	764	730	1604	1609	TRUE	TRUE	TRUE	1	TRUE	TRUE	1	1
FBgn0016070	322	300	234	228	556	528	TRUE	TRUE	TRUE	1	TRUE	TRUE	1	1
FBgn0016075	453	475	364	372	817	847	TRUE	TRUE	TRUE	1	TRUE	TRUE	1	1
FBgn0016076	218	243	188	190	406	433	TRUE	TRUE	TRUE	1	TRUE	TRUE	1	1
FBgn0016078	166	211	160	147	326	358	FALSE	TRUE	TRUE	0	TRUE	TRUE	1	0
FBgn0016081	1009	1052	957	909	1966	1961	TRUE	TRUE	TRUE	1	TRUE	TRUE	1	1
FBgn0016119	81	81	43	57	124	138	TRUE	TRUE	TRUE	1	TRUE	TRUE	1	1
FBgn0016120	59	51	45	62	104	113	TRUE	TRUE	TRUE	1	TRUE	TRUE	1	1
FBgn0016122	236	222	178	190	414	412	TRUE	TRUE	TRUE	1	TRUE	TRUE	1	1
FBgn0016123	225	222	136	182	361	404	TRUE	FALSE	TRUE	0	TRUE	TRUE	1	0
FBgn0016126	39	39	36	32	75	71	TRUE	TRUE	TRUE	1	TRUE	TRUE	1	1
FBgn0016131	140	149	121	123	261	272	TRUE	TRUE	TRUE	1	TRUE	TRUE	1	1
FBgn0016641	273	323	220	223	493	546	FALSE	TRUE	TRUE	0	TRUE	TRUE	1	0
FBgn0016650	337	388	299	312	636	700	FALSE	TRUE	FALSE	0	TRUE	TRUE	1	0
FBgn0016660	242	255	215	218	457	473	TRUE	TRUE	TRUE	1	TRUE	TRUE	1	1
FBgn0016672	136	101	101	89	237	190	FALSE	TRUE	FALSE	0	TRUE	TRUE	1	0
FBgn0016675	61	71	40	42	101	113	TRUE	TRUE	TRUE	1	TRUE	TRUE	1	1
FBgn0016684	123	139	120	117	243	256	TRUE	TRUE	TRUE	1	TRUE	TRUE	1	1
FBgn0016685	55	58	53	54	108	112	TRUE	TRUE	TRUE	1	TRUE	TRUE	1	1
FBgn0016687	75	80	74	60	149	140	TRUE	TRUE	TRUE	1	TRUE	TRUE	1	1
FBgn0016693	104	117	84	97	188	214	TRUE	TRUE	TRUE	1	TRUE	TRUE	1	1
FBgn0016694	756	718	652	707	1408	1425	TRUE	TRUE	TRUE	1	TRUE	TRUE	1	1
FBgn0016696	77	89	71	64	148	153	TRUE	TRUE	TRUE	1	TRUE	TRUE	1	1
FBgn0016697	60	63	60	41	120	104	TRUE	FALSE	TRUE	0	TRUE	TRUE	1	0
FBgn0016698	121	161	116	139	237	300	FALSE	TRUE	FALSE	0	TRUE	TRUE	1	0
FBgn0016701	40	35	37	26	77	61	TRUE	TRUE	TRUE	1	TRUE	TRUE	1	1
FBgn0016715	93	115	94	89	187	204	TRUE	TRUE	TRUE	1	TRUE	TRUE	1	1
FBgn0016754	507	495	418	474	925	969	TRUE	FALSE	TRUE	0	TRUE	TRUE	1	0
FBgn0016756	261	265	233	244	494	509	TRUE	TRUE	TRUE	1	TRUE	TRUE	1	1
FBgn0016762	48	55	46	52	94	107	TRUE	TRUE	TRUE	1	TRUE	TRUE	1	1
FBgn0016794	418	424	335	324	753	748	TRUE	TRUE	TRUE	1	TRUE	TRUE	1	1
FBgn0016797	421	383	350	348	771	731	TRUE	TRUE	TRUE	1	TRUE	TRUE	1	1
FBgn0016917	164	193	167	173	331	366	TRUE	TRUE	TRUE	1	TRUE	TRUE	1	1
FBgn0016919	116	96	91	100	207	196	TRUE	TRUE	TRUE	1	TRUE	TRUE	1	1
FBgn0016920	719	664	574	535	1293	1199	TRUE	TRUE	FALSE	0	TRUE	TRUE	1	0
FBgn0016926	199	219	169	170	368	389	TRUE	TRUE	TRUE	1	TRUE	TRUE	1	1
FBgn0016930	365	408	343	357	708	765	TRUE	TRUE	TRUE	1	TRUE	TRUE	1	1
FBgn0016970	54	54	44	46	98	100	TRUE	TRUE	TRUE	1	TRUE	TRUE	1	1
FBgn0016977	376	379	350	364	726	743	TRUE	TRUE	TRUE	1	TRUE	TRUE	1	1
FBgn0016978	132	128	118	119	250	247	TRUE	TRUE	TRUE	1	TRUE	TRUE	1	1
FBgn0016983	290	288	207	231	497	519	TRUE	TRUE	TRUE	1	TRUE	TRUE	1	1
FBgn0016984	225	221	154	187	379	408	TRUE	FALSE	TRUE	0	TRUE	TRUE	1	0
FBgn0017414	48	52	40	51	88	103	TRUE	TRUE	TRUE	1	TRUE	TRUE	1	1
FBgn0017424	13	31	19	23	32	54	FALSE	TRUE	FALSE	0	FALSE	TRUE	0	0
FBgn0017429	117	113	132	91	249	204	TRUE	FALSE	FALSE	0	TRUE	TRUE	1	0
FBgn0017430	138	112	95	81	233	193	TRUE	TRUE	FALSE	0	TRUE	TRUE	1	0
FBgn0017448	71	64	52	43	123	107	TRUE	TRUE	TRUE	1	TRUE	TRUE	1	1
FBgn0017457	51	57	47	44	98	101	TRUE	TRUE	TRUE	1	TRUE	TRUE	1	1
FBgn0017482	93	98	84	52	177	150	TRUE	FALSE	TRUE	0	TRUE	FALSE	0	0
FBgn0017551	175	169	120	121	295	290	TRUE	TRUE	TRUE	1	TRUE	TRUE	1	1
FBgn0017556	131	123	91	89	222	212	TRUE	TRUE	TRUE	1	TRUE	TRUE	1	1
FBgn0017558	169	188	171	158	340	346	TRUE	TRUE	TRUE	1	TRUE	TRUE	1	1
FBgn0017572	25	24	24	25	49	49	TRUE	TRUE	TRUE	1	TRUE	TRUE	1	1
FBgn0017577	86	88	55	66	141	154	TRUE	TRUE	TRUE	1	TRUE	TRUE	1	1
FBgn0017578	84	98	77	75	161	173	TRUE	TRUE	TRUE	1	TRUE	TRUE	1	1
FBgn0017579	44	20	24	28	68	48	FALSE	TRUE	FALSE	0	FALSE	TRUE	0	0
FBgn0017581	337	301	279	282	616	583	TRUE	TRUE	TRUE	1	TRUE	TRUE	1	1
FBgn0017590	410	395	334	314	744	709	TRUE	TRUE	TRUE	1	TRUE	TRUE	1	1
FBgn0019624	25	19	20	19	45	38	TRUE	TRUE	TRUE	1	TRUE	TRUE	1	1
FBgn0019643	121	129	98	104	219	233	TRUE	TRUE	TRUE	1	TRUE	TRUE	1	1
FBgn0019644	88	94	66	73	154	167	TRUE	TRUE	TRUE	1	TRUE	TRUE	1	1
FBgn0019650	97	90	83	73	180	163	TRUE	TRUE	TRUE	1	TRUE	TRUE	1	1
FBgn0019662	160	117	104	128	264	245	FALSE	TRUE	TRUE	0	TRUE	TRUE	1	0
FBgn0019686	107	91	114	106	221	197	TRUE	TRUE	TRUE	1	TRUE	TRUE	1	1
FBgn0019809	195	230	182	179	377	409	FALSE	TRUE	TRUE	0	TRUE	TRUE	1	0
FBgn0019828	62	49	55	54	117	103	TRUE	TRUE	TRUE	1	TRUE	TRUE	1	1
FBgn0019830	54	56	58	38	112	94	TRUE	FALSE	TRUE	0	TRUE	FALSE	0	0
FBgn0019890	393	429	323	325	716	754	TRUE	TRUE	TRUE	1	TRUE	TRUE	1	1
FBgn0019928	28	60	37	45	65	105	FALSE	TRUE	FALSE	0	FALSE	TRUE	0	0
FBgn0019932	143	141	125	114	268	255	TRUE	TRUE	TRUE	1	TRUE	TRUE	1	1
FBgn0019938	366	367	285	307	651	674	TRUE	TRUE	TRUE	1	TRUE	TRUE	1	1
FBgn0019940	113	121	98	87	211	208	TRUE	TRUE	TRUE	1	TRUE	TRUE	1	1
FBgn0019949	66	52	61	56	127	108	TRUE	TRUE	TRUE	1	TRUE	TRUE	1	1
FBgn0019952	203	222	161	156	364	378	TRUE	TRUE	TRUE	1	TRUE	TRUE	1	1
FBgn0019957	85	87	99	93	184	180	TRUE	TRUE	TRUE	1	TRUE	TRUE	1	1
FBgn0019960	281	292	222	205	503	497	TRUE	TRUE	TRUE	1	TRUE	TRUE	1	1
FBgn0019968	667	589	533	589	1200	1178	FALSE	TRUE	TRUE	0	TRUE	TRUE	1	0
FBgn0019972	112	119	82	93	194	212	TRUE	TRUE	TRUE	1	TRUE	TRUE	1	1
FBgn0019982	113	119	92	93	205	212	TRUE	TRUE	TRUE	1	TRUE	TRUE	1	1
FBgn0019985	187	186	162	167	349	353	TRUE	TRUE	TRUE	1	TRUE	TRUE	1	1
FBgn0019990	354	331	289	306	643	637	TRUE	TRUE	TRUE	1	TRUE	TRUE	1	1
FBgn0020018	101	96	91	90	192	186	TRUE	TRUE	TRUE	1	TRUE	TRUE	1	1
FBgn0020224	482	414	369	357	851	771	FALSE	TRUE	FALSE	0	TRUE	TRUE	1	0
FBgn0020235	60	60	48	63	108	123	TRUE	TRUE	TRUE	1	TRUE	TRUE	1	1
FBgn0020236	294	297	216	236	510	533	TRUE	TRUE	TRUE	1	TRUE	TRUE	1	1
FBgn0020238	83	82	86	82	169	164	TRUE	TRUE	TRUE	1	TRUE	TRUE	1	1
FBgn0020248	303	252	272	227	575	479	FALSE	FALSE	FALSE	0	TRUE	TRUE	1	0
FBgn0020251	447	466	414	441	861	907	TRUE	TRUE	TRUE	1	TRUE	TRUE	1	1
FBgn0020257	128	141	116	131	244	272	TRUE	TRUE	TRUE	1	TRUE	TRUE	1	1
FBgn0020258	258	237	201	212	459	449	TRUE	TRUE	TRUE	1	TRUE	TRUE	1	1
FBgn0020269	173	186	153	148	326	334	TRUE	TRUE	TRUE	1	TRUE	TRUE	1	1
FBgn0020270	118	114	101	111	219	225	TRUE	TRUE	TRUE	1	TRUE	TRUE	1	1
FBgn0020277	54	49	46	27	100	76	TRUE	FALSE	FALSE	0	TRUE	FALSE	0	0
FBgn0020278	318	302	260	244	578	546	TRUE	TRUE	TRUE	1	TRUE	TRUE	1	1
FBgn0020279	161	170	150	146	311	316	TRUE	TRUE	TRUE	1	TRUE	TRUE	1	1
FBgn0020280	47	41	38	47	85	88	TRUE	TRUE	TRUE	1	TRUE	TRUE	1	1
FBgn0020294	62	56	55	55	117	111	TRUE	TRUE	TRUE	1	TRUE	TRUE	1	1
FBgn0020299	393	406	330	302	723	708	TRUE	TRUE	TRUE	1	TRUE	TRUE	1	1
FBgn0020300	161	164	159	139	320	303	TRUE	TRUE	TRUE	1	TRUE	TRUE	1	1
FBgn0020304	370	364	298	296	668	660	TRUE	TRUE	TRUE	1	TRUE	TRUE	1	1
FBgn0020305	79	90	58	75	137	165	TRUE	TRUE	TRUE	1	TRUE	TRUE	1	1
FBgn0020306	409	463	372	317	781	780	FALSE	FALSE	TRUE	0	TRUE	TRUE	1	0
FBgn0020307	374	388	306	315	680	703	TRUE	TRUE	TRUE	1	TRUE	TRUE	1	1
FBgn0020309	350	246	237	262	587	508	FALSE	TRUE	FALSE	0	TRUE	TRUE	1	0
FBgn0020312	349	296	264	257	613	553	FALSE	TRUE	FALSE	0	TRUE	TRUE	1	0
FBgn0020370	264	279	230	228	494	507	TRUE	TRUE	TRUE	1	TRUE	TRUE	1	1
FBgn0020371	80	60	56	45	136	105	TRUE	TRUE	FALSE	0	TRUE	TRUE	1	0
FBgn0020372	96	99	74	61	170	160	TRUE	TRUE	TRUE	1	TRUE	TRUE	1	1
FBgn0020376	137	129	93	116	230	245	TRUE	TRUE	TRUE	1	TRUE	TRUE	1	1
FBgn0020377	220	190	174	184	394	374	TRUE	TRUE	TRUE	1	TRUE	TRUE	1	1
FBgn0020379	342	361	292	272	634	633	TRUE	TRUE	TRUE	1	TRUE	TRUE	1	1
FBgn0020385	240	243	204	185	444	428	TRUE	TRUE	TRUE	1	TRUE	TRUE	1	1
FBgn0020386	145	114	90	136	235	250	FALSE	FALSE	TRUE	0	TRUE	FALSE	0	0
FBgn0020388	125	142	90	108	215	250	TRUE	TRUE	TRUE	1	TRUE	TRUE	1	1
FBgn0020389	192	159	142	130	334	289	FALSE	TRUE	FALSE	0	TRUE	TRUE	1	0
FBgn0020391	159	157	94	130	253	287	TRUE	FALSE	TRUE	0	TRUE	TRUE	1	0
FBgn0020392	133	130	118	94	251	224	TRUE	TRUE	TRUE	1	TRUE	TRUE	1	1
FBgn0020399	25	13	24	21	49	34	FALSE	TRUE	TRUE	0	FALSE	TRUE	0	0
FBgn0020407	159	162	163	130	322	292	TRUE	FALSE	TRUE	0	TRUE	TRUE	1	0
FBgn0020412	429	428	332	379	761	807	TRUE	FALSE	TRUE	0	TRUE	TRUE	1	0
FBgn0020414	368	279	250	265	618	544	FALSE	TRUE	FALSE	0	TRUE	TRUE	1	0
FBgn0020415	178	185	132	138	310	323	TRUE	TRUE	TRUE	1	TRUE	TRUE	1	1
FBgn0020416	146	140	134	126	280	266	TRUE	TRUE	TRUE	1	TRUE	TRUE	1	1
FBgn0020429	356	333	290	264	646	597	TRUE	TRUE	TRUE	1	TRUE	TRUE	1	1
FBgn0020440	458	479	409	389	867	868	TRUE	TRUE	TRUE	1	TRUE	TRUE	1	1
FBgn0020443	260	266	232	218	492	484	TRUE	TRUE	TRUE	1	TRUE	TRUE	1	1
FBgn0020445	277	273	210	232	487	505	TRUE	TRUE	TRUE	1	TRUE	TRUE	1	1
FBgn0020493	62	58	48	40	110	98	TRUE	TRUE	TRUE	1	TRUE	TRUE	1	1
FBgn0020496	237	239	216	193	453	432	TRUE	TRUE	TRUE	1	TRUE	TRUE	1	1
FBgn0020497	198	146	170	134	368	280	FALSE	FALSE	FALSE	0	TRUE	TRUE	1	0
FBgn0020503	705	696	584	619	1289	1315	TRUE	TRUE	TRUE	1	TRUE	TRUE	1	1
FBgn0020506	164	153	111	120	275	273	TRUE	TRUE	TRUE	1	TRUE	TRUE	1	1
FBgn0020509	75	63	48	72	123	135	TRUE	FALSE	TRUE	0	TRUE	TRUE	1	0
FBgn0020510	236	249	172	207	408	456	TRUE	FALSE	TRUE	0	TRUE	TRUE	1	0
FBgn0020521	247	251	180	218	427	469	TRUE	FALSE	TRUE	0	TRUE	TRUE	1	0
FBgn0020545	98	130	103	99	201	229	FALSE	TRUE	TRUE	0	TRUE	TRUE	1	0
FBgn0020546	273	246	238	237	511	483	TRUE	TRUE	TRUE	1	TRUE	TRUE	1	1
FBgn0020556	338	298	272	287	610	585	TRUE	TRUE	TRUE	1	TRUE	TRUE	1	1
FBgn0020616	216	186	171	176	387	362	TRUE	TRUE	TRUE	1	TRUE	TRUE	1	1
FBgn0020617	294	290	251	248	545	538	TRUE	TRUE	TRUE	1	TRUE	TRUE	1	1
FBgn0020618	116	91	71	74	187	165	FALSE	TRUE	TRUE	0	TRUE	TRUE	1	0
FBgn0020620	197	196	142	161	339	357	TRUE	TRUE	TRUE	1	TRUE	TRUE	1	1
FBgn0020621	495	467	371	383	866	850	TRUE	TRUE	TRUE	1	TRUE	TRUE	1	1
FBgn0020622	194	196	178	166	372	362	TRUE	TRUE	TRUE	1	TRUE	TRUE	1	1
FBgn0020626	110	129	102	74	212	203	TRUE	FALSE	TRUE	0	TRUE	TRUE	1	0
FBgn0020633	25	34	25	27	50	61	TRUE	TRUE	TRUE	1	TRUE	TRUE	1	1
FBgn0020637	38	48	35	37	73	85	TRUE	TRUE	TRUE	1	TRUE	TRUE	1	1
FBgn0020638	27	45	14	34	41	79	FALSE	FALSE	FALSE	0	FALSE	FALSE	0	0
FBgn0020639	67	69	44	60	111	129	TRUE	TRUE	TRUE	1	TRUE	TRUE	1	1
FBgn0020640	77	73	54	53	131	126	TRUE	TRUE	TRUE	1	TRUE	TRUE	1	1
FBgn0020641	106	93	84	90	190	183	TRUE	TRUE	TRUE	1	TRUE	TRUE	1	1
FBgn0020642	25	34	31	30	56	64	TRUE	TRUE	TRUE	1	TRUE	TRUE	1	1
FBgn0020647	396	415	326	339	722	754	TRUE	TRUE	TRUE	1	TRUE	TRUE	1	1
FBgn0020655	151	152	135	120	286	272	TRUE	TRUE	TRUE	1	TRUE	TRUE	1	1
FBgn0020762	524	520	398	392	922	912	TRUE	TRUE	TRUE	1	TRUE	TRUE	1	1
FBgn0020764	133	128	98	91	231	219	TRUE	TRUE	TRUE	1	TRUE	TRUE	1	1
FBgn0020765	16	28	22	23	38	51	FALSE	TRUE	TRUE	0	FALSE	TRUE	0	0
FBgn0020767	310	271	229	263	539	534	TRUE	TRUE	TRUE	1	TRUE	TRUE	1	1
FBgn0020880	227	203	192	159	419	362	TRUE	FALSE	FALSE	0	TRUE	TRUE	1	0
FBgn0020887	134	116	124	102	258	218	TRUE	TRUE	FALSE	0	TRUE	TRUE	1	0
FBgn0020906	49	43	29	44	78	87	TRUE	TRUE	TRUE	1	TRUE	FALSE	0	0
FBgn0020907	83	69	65	76	148	145	TRUE	TRUE	TRUE	1	TRUE	TRUE	1	1
FBgn0020908	48	34	39	40	87	74	TRUE	TRUE	TRUE	1	TRUE	TRUE	1	1
FBgn0020910	124	126	125	120	249	246	TRUE	TRUE	TRUE	1	TRUE	TRUE	1	1
FBgn0020912	247	221	186	187	433	408	TRUE	TRUE	TRUE	1	TRUE	TRUE	1	1
FBgn0020930	100	103	82	82	182	185	TRUE	TRUE	TRUE	1	TRUE	TRUE	1	1
FBgn0021761	325	314	224	268	549	582	TRUE	FALSE	TRUE	0	TRUE	TRUE	1	0
FBgn0021768	191	224	191	172	382	396	TRUE	TRUE	TRUE	1	TRUE	TRUE	1	1
FBgn0021776	261	267	215	219	476	486	TRUE	TRUE	TRUE	1	TRUE	TRUE	1	1
FBgn0021795	82	68	60	73	142	141	TRUE	TRUE	TRUE	1	TRUE	TRUE	1	1
FBgn0021796	33	23	20	14	53	37	TRUE	TRUE	TRUE	1	TRUE	TRUE	1	1
FBgn0021800	116	121	106	102	222	223	TRUE	TRUE	TRUE	1	TRUE	TRUE	1	1
FBgn0021814	61	42	30	45	91	87	FALSE	TRUE	TRUE	0	TRUE	TRUE	1	0
FBgn0021825	74	57	39	34	113	91	TRUE	TRUE	TRUE	1	TRUE	TRUE	1	1
FBgn0021847	99	82	79	53	178	135	TRUE	FALSE	FALSE	0	TRUE	TRUE	1	0
FBgn0021856	42	39	50	37	92	76	TRUE	TRUE	TRUE	1	TRUE	TRUE	1	1
FBgn0021872	108	85	80	69	188	154	TRUE	TRUE	FALSE	0	TRUE	TRUE	1	0
FBgn0021874	97	102	76	78	173	180	TRUE	TRUE	TRUE	1	TRUE	TRUE	1	1
FBgn0021875	88	89	94	105	182	194	TRUE	TRUE	TRUE	1	TRUE	TRUE	1	1
FBgn0021895	84	61	75	45	159	106	FALSE	FALSE	FALSE	0	TRUE	FALSE	0	0
FBgn0021906	118	116	84	112	202	228	TRUE	FALSE	TRUE	0	TRUE	TRUE	1	0
FBgn0021944	47	51	39	37	86	88	TRUE	TRUE	TRUE	1	TRUE	TRUE	1	1
FBgn0021967	54	56	30	49	84	105	TRUE	FALSE	TRUE	0	TRUE	FALSE	0	0
FBgn0021979	305	276	217	229	522	505	TRUE	TRUE	TRUE	1	TRUE	TRUE	1	1
FBgn0021995	67	82	80	57	147	139	TRUE	FALSE	TRUE	0	TRUE	TRUE	1	0
FBgn0022023	67	66	54	65	121	131	TRUE	TRUE	TRUE	1	TRUE	TRUE	1	1
FBgn0022029	184	187	151	166	335	353	TRUE	TRUE	TRUE	1	TRUE	TRUE	1	1
FBgn0022069	172	167	112	117	284	284	TRUE	TRUE	TRUE	1	TRUE	TRUE	1	1
FBgn0022097	43	35	50	28	93	63	TRUE	FALSE	FALSE	0	TRUE	FALSE	0	0
FBgn0022153	420	456	341	328	761	784	TRUE	TRUE	TRUE	1	TRUE	TRUE	1	1
FBgn0022160	386	342	312	289	698	631	TRUE	TRUE	FALSE	0	TRUE	TRUE	1	0
FBgn0022213	145	140	128	115	273	255	TRUE	TRUE	TRUE	1	TRUE	TRUE	1	1
FBgn0022238	136	158	118	118	254	276	TRUE	TRUE	TRUE	1	TRUE	TRUE	1	1
FBgn0022288	81	87	73	87	154	174	TRUE	TRUE	TRUE	1	TRUE	TRUE	1	1
FBgn0022338	91	59	66	68	157	127	FALSE	TRUE	FALSE	0	FALSE	TRUE	0	0
FBgn0022344	73	49	54	55	127	104	FALSE	TRUE	TRUE	0	TRUE	TRUE	1	0
FBgn0022349	54	56	49	43	103	99	TRUE	TRUE	TRUE	1	TRUE	TRUE	1	1
FBgn0022359	50	36	39	35	89	71	TRUE	TRUE	TRUE	1	TRUE	TRUE	1	1
FBgn0022361	33	34	29	32	62	66	TRUE	TRUE	TRUE	1	TRUE	TRUE	1	1
FBgn0022382	427	428	359	361	786	789	TRUE	TRUE	TRUE	1	TRUE	TRUE	1	1
FBgn0022699	80	60	78	77	158	137	TRUE	TRUE	TRUE	1	TRUE	TRUE	1	1
FBgn0022700	143	160	131	126	274	286	TRUE	TRUE	TRUE	1	TRUE	TRUE	1	1
FBgn0022702	109	82	88	77	197	159	FALSE	TRUE	FALSE	0	TRUE	TRUE	1	0
FBgn0022709	98	93	83	86	181	179	TRUE	TRUE	TRUE	1	TRUE	TRUE	1	1
FBgn0022740	133	143	118	106	251	249	TRUE	TRUE	TRUE	1	TRUE	TRUE	1	1
FBgn0022764	527	558	400	463	927	1021	TRUE	FALSE	FALSE	0	TRUE	TRUE	1	0
FBgn0022774	70	67	52	47	122	114	TRUE	TRUE	TRUE	1	TRUE	TRUE	1	1
FBgn0022787	109	105	99	90	208	195	TRUE	TRUE	TRUE	1	TRUE	TRUE	1	1
FBgn0022800	294	285	229	242	523	527	TRUE	TRUE	TRUE	1	TRUE	TRUE	1	1
FBgn0022893	29	25	29	27	58	52	TRUE	TRUE	TRUE	1	TRUE	TRUE	1	1
FBgn0022935	127	154	102	98	229	252	TRUE	TRUE	TRUE	1	TRUE	TRUE	1	1
FBgn0022936	21	20	21	12	42	32	TRUE	TRUE	TRUE	1	TRUE	FALSE	0	0
FBgn0022959	110	100	74	81	184	181	TRUE	TRUE	TRUE	1	TRUE	TRUE	1	1
FBgn0022960	98	104	89	76	187	180	TRUE	TRUE	TRUE	1	TRUE	TRUE	1	1
FBgn0022984	108	112	83	88	191	200	TRUE	TRUE	TRUE	1	TRUE	TRUE	1	1
FBgn0022985	65	55	44	51	109	106	TRUE	TRUE	TRUE	1	TRUE	TRUE	1	1
FBgn0022986	114	125	123	121	237	246	TRUE	TRUE	TRUE	1	TRUE	TRUE	1	1
FBgn0022987	228	226	199	191	427	417	TRUE	TRUE	TRUE	1	TRUE	TRUE	1	1
FBgn0023000	234	216	205	213	439	429	TRUE	TRUE	TRUE	1	TRUE	TRUE	1	1
FBgn0023001	422	392	335	305	757	697	TRUE	TRUE	TRUE	1	TRUE	TRUE	1	1
FBgn0023023	91	89	61	71	152	160	TRUE	TRUE	TRUE	1	TRUE	TRUE	1	1
FBgn0023076	238	276	219	226	457	502	TRUE	TRUE	TRUE	1	TRUE	TRUE	1	1
FBgn0023081	303	315	264	245	567	560	TRUE	TRUE	TRUE	1	TRUE	TRUE	1	1
FBgn0023083	291	286	230	228	521	514	TRUE	TRUE	TRUE	1	TRUE	TRUE	1	1
FBgn0023090	273	229	224	232	497	461	FALSE	TRUE	TRUE	0	TRUE	TRUE	1	0
FBgn0023091	88	105	86	117	174	222	TRUE	FALSE	FALSE	0	TRUE	TRUE	1	0
FBgn0023094	46	56	32	42	78	98	TRUE	TRUE	TRUE	1	TRUE	TRUE	1	1
FBgn0023095	329	319	279	269	608	588	TRUE	TRUE	TRUE	1	TRUE	TRUE	1	1
FBgn0023096	654	694	602	556	1256	1250	TRUE	TRUE	TRUE	1	TRUE	TRUE	1	1
FBgn0023097	303	298	240	226	543	524	TRUE	TRUE	TRUE	1	TRUE	TRUE	1	1
FBgn0023143	102	86	84	66	186	152	TRUE	TRUE	FALSE	0	TRUE	TRUE	1	0
FBgn0023170	33	21	28	19	61	40	TRUE	TRUE	FALSE	0	FALSE	TRUE	0	0
FBgn0023171	57	35	33	45	90	80	FALSE	TRUE	TRUE	0	FALSE	TRUE	0	0
FBgn0023172	308	263	261	241	569	504	FALSE	TRUE	FALSE	0	TRUE	TRUE	1	0
FBgn0023174	46	57	28	31	74	88	TRUE	TRUE	TRUE	1	TRUE	TRUE	1	1
FBgn0023175	29	18	13	18	42	36	TRUE	TRUE	TRUE	1	FALSE	TRUE	0	0
FBgn0023178	69	73	66	76	135	149	TRUE	TRUE	TRUE	1	TRUE	TRUE	1	1
FBgn0023179	404	367	356	341	760	708	TRUE	TRUE	TRUE	1	TRUE	TRUE	1	1
FBgn0023181	38	44	38	21	76	65	TRUE	FALSE	TRUE	0	TRUE	FALSE	0	0
FBgn0023197	89	76	61	62	150	138	TRUE	TRUE	TRUE	1	TRUE	TRUE	1	1
FBgn0023212	107	79	86	76	193	155	FALSE	TRUE	FALSE	0	TRUE	TRUE	1	0
FBgn0023213	122	111	99	101	221	212	TRUE	TRUE	TRUE	1	TRUE	TRUE	1	1
FBgn0023214	138	150	128	121	266	271	TRUE	TRUE	TRUE	1	TRUE	TRUE	1	1
FBgn0023388	203	191	168	181	371	372	TRUE	TRUE	TRUE	1	TRUE	TRUE	1	1
FBgn0023395	107	95	108	90	215	185	TRUE	TRUE	TRUE	1	TRUE	TRUE	1	1
FBgn0023407	470	415	329	377	799	792	FALSE	FALSE	TRUE	0	TRUE	TRUE	1	0
FBgn0023415	71	70	50	60	121	130	TRUE	TRUE	TRUE	1	TRUE	TRUE	1	1
FBgn0023416	300	309	274	281	574	590	TRUE	TRUE	TRUE	1	TRUE	TRUE	1	1
FBgn0023441	388	439	353	346	741	785	FALSE	TRUE	TRUE	0	TRUE	TRUE	1	0
FBgn0023477	115	102	103	85	218	187	TRUE	TRUE	TRUE	1	TRUE	TRUE	1	1
FBgn0023479	758	813	608	645	1366	1458	TRUE	TRUE	FALSE	0	TRUE	TRUE	1	0
FBgn0023489	150	130	119	130	269	260	TRUE	TRUE	TRUE	1	TRUE	TRUE	1	1
FBgn0023495	54	60	37	39	91	99	TRUE	TRUE	TRUE	1	TRUE	TRUE	1	1
FBgn0023496	171	181	161	181	332	362	TRUE	TRUE	TRUE	1	TRUE	TRUE	1	1
FBgn0024177	101	103	62	77	163	180	TRUE	TRUE	TRUE	1	TRUE	TRUE	1	1
FBgn0024179	247	283	215	223	462	506	TRUE	TRUE	TRUE	1	TRUE	TRUE	1	1
FBgn0024183	204	162	143	154	347	316	FALSE	TRUE	TRUE	0	TRUE	TRUE	1	0
FBgn0024187	580	628	529	466	1109	1094	TRUE	FALSE	TRUE	0	TRUE	TRUE	1	0
FBgn0024188	57	54	44	52	101	106	TRUE	TRUE	TRUE	1	TRUE	TRUE	1	1
FBgn0024189	509	540	409	446	918	986	TRUE	TRUE	TRUE	1	TRUE	TRUE	1	1
FBgn0024191	196	189	179	168	375	357	TRUE	TRUE	TRUE	1	TRUE	TRUE	1	1
FBgn0024194	62	83	53	59	115	142	FALSE	TRUE	TRUE	0	TRUE	TRUE	1	0
FBgn0024196	49	60	53	51	102	111	TRUE	TRUE	TRUE	1	TRUE	TRUE	1	1
FBgn0024222	105	117	95	79	200	196	TRUE	TRUE	TRUE	1	TRUE	TRUE	1	1
FBgn0024227	145	124	82	103	227	227	TRUE	TRUE	TRUE	1	TRUE	TRUE	1	1
FBgn0024230	97	100	75	90	172	190	TRUE	TRUE	TRUE	1	TRUE	TRUE	1	1
FBgn0024232	585	607	479	491	1064	1098	TRUE	TRUE	TRUE	1	TRUE	TRUE	1	1
FBgn0024234	84	83	78	66	162	149	TRUE	TRUE	TRUE	1	TRUE	TRUE	1	1
FBgn0024236	324	316	262	249	586	565	TRUE	TRUE	TRUE	1	TRUE	TRUE	1	1
FBgn0024244	136	120	116	113	252	233	TRUE	TRUE	TRUE	1	TRUE	TRUE	1	1
FBgn0024245	226	206	183	201	409	407	TRUE	TRUE	TRUE	1	TRUE	TRUE	1	1
FBgn0024248	265	269	193	226	458	495	TRUE	TRUE	TRUE	1	TRUE	TRUE	1	1
FBgn0024249	40	55	46	42	86	97	TRUE	TRUE	TRUE	1	TRUE	TRUE	1	1
FBgn0024273	117	108	123	95	240	203	TRUE	FALSE	FALSE	0	TRUE	TRUE	1	0
FBgn0024277	824	849	758	705	1582	1554	TRUE	TRUE	TRUE	1	TRUE	TRUE	1	1
FBgn0024285	165	165	124	132	289	297	TRUE	TRUE	TRUE	1	TRUE	TRUE	1	1
FBgn0024288	222	220	190	167	412	387	TRUE	TRUE	TRUE	1	TRUE	TRUE	1	1
FBgn0024289	82	75	63	57	145	132	TRUE	TRUE	TRUE	1	TRUE	TRUE	1	1
FBgn0024291	37	33	33	35	70	68	TRUE	TRUE	TRUE	1	TRUE	TRUE	1	1
FBgn0024293	72	90	70	85	142	175	TRUE	TRUE	FALSE	0	TRUE	TRUE	1	0
FBgn0024294	77	77	56	61	133	138	TRUE	TRUE	TRUE	1	TRUE	TRUE	1	1
FBgn0024314	125	124	103	121	228	245	TRUE	TRUE	TRUE	1	TRUE	TRUE	1	1
FBgn0024315	355	354	298	331	653	685	TRUE	TRUE	TRUE	1	TRUE	TRUE	1	1
FBgn0024319	210	182	170	181	380	363	TRUE	TRUE	TRUE	1	TRUE	TRUE	1	1
FBgn0024320	556	523	465	430	1021	953	TRUE	TRUE	TRUE	1	TRUE	TRUE	1	1
FBgn0024321	152	177	115	106	267	283	TRUE	TRUE	TRUE	1	TRUE	TRUE	1	1
FBgn0024326	117	125	113	99	230	224	TRUE	TRUE	TRUE	1	TRUE	TRUE	1	1
FBgn0024329	335	328	292	295	627	623	TRUE	TRUE	TRUE	1	TRUE	TRUE	1	1
FBgn0024352	81	62	63	79	144	141	TRUE	TRUE	TRUE	1	TRUE	TRUE	1	1
FBgn0024371	69	97	70	72	139	169	FALSE	TRUE	FALSE	0	TRUE	TRUE	1	0
FBgn0024432	95	42	70	53	165	95	FALSE	TRUE	FALSE	0	FALSE	TRUE	0	0
FBgn0024491	197	195	171	203	368	398	TRUE	TRUE	TRUE	1	TRUE	TRUE	1	1
FBgn0024509	139	143	135	127	274	270	TRUE	TRUE	TRUE	1	TRUE	TRUE	1	1
FBgn0024510	214	243	187	192	401	435	TRUE	TRUE	TRUE	1	TRUE	TRUE	1	1
FBgn0024542	65	70	56	34	121	104	TRUE	FALSE	TRUE	0	TRUE	FALSE	0	0
FBgn0024555	162	160	140	156	302	316	TRUE	TRUE	TRUE	1	TRUE	TRUE	1	1
FBgn0024556	139	156	106	96	245	252	TRUE	TRUE	TRUE	1	TRUE	TRUE	1	1
FBgn0024558	47	52	40	41	87	93	TRUE	TRUE	TRUE	1	TRUE	TRUE	1	1
FBgn0024689	106	104	81	88	187	192	TRUE	TRUE	TRUE	1	TRUE	TRUE	1	1
FBgn0024698	36	58	40	58	76	116	FALSE	FALSE	FALSE	0	FALSE	TRUE	0	0
FBgn0024728	54	64	53	45	107	109	TRUE	TRUE	TRUE	1	TRUE	TRUE	1	1
FBgn0024732	214	200	154	188	368	388	TRUE	FALSE	TRUE	0	TRUE	TRUE	1	0
FBgn0024733	67	70	99	65	166	135	TRUE	FALSE	FALSE	0	TRUE	FALSE	0	0
FBgn0024734	77	104	98	59	175	163	FALSE	FALSE	TRUE	0	TRUE	FALSE	0	0
FBgn0024740	305	274	244	262	549	536	TRUE	TRUE	TRUE	1	TRUE	TRUE	1	1
FBgn0024754	207	184	140	149	347	333	TRUE	TRUE	TRUE	1	TRUE	TRUE	1	1
FBgn0024804	126	126	79	108	205	234	TRUE	FALSE	TRUE	0	TRUE	TRUE	1	0
FBgn0024806	66	60	52	46	118	106	TRUE	TRUE	TRUE	1	TRUE	TRUE	1	1
FBgn0024811	31	19	20	24	51	43	TRUE	TRUE	TRUE	1	FALSE	TRUE	0	0
FBgn0024814	37	41	26	38	63	79	TRUE	TRUE	TRUE	1	TRUE	TRUE	1	1
FBgn0024833	29	22	18	19	47	41	TRUE	TRUE	TRUE	1	TRUE	TRUE	1	1
FBgn0024836	971	953	771	807	1742	1760	TRUE	TRUE	TRUE	1	TRUE	TRUE	1	1
FBgn0024841	55	71	54	51	109	122	TRUE	TRUE	TRUE	1	TRUE	TRUE	1	1
FBgn0024846	95	104	72	88	167	192	TRUE	TRUE	TRUE	1	TRUE	TRUE	1	1
FBgn0024889	35	33	28	32	63	65	TRUE	TRUE	TRUE	1	TRUE	TRUE	1	1
FBgn0024912	41	47	24	34	65	81	TRUE	TRUE	TRUE	1	TRUE	TRUE	1	1
FBgn0024913	46	37	30	26	76	63	TRUE	TRUE	TRUE	1	TRUE	TRUE	1	1
FBgn0024920	47	41	35	30	82	71	TRUE	TRUE	TRUE	1	TRUE	TRUE	1	1
FBgn0024921	290	246	219	185	509	431	FALSE	TRUE	FALSE	0	TRUE	TRUE	1	0
FBgn0024944	459	458	377	391	836	849	TRUE	TRUE	TRUE	1	TRUE	TRUE	1	1
FBgn0024947	37	30	33	22	70	52	TRUE	TRUE	TRUE	1	TRUE	TRUE	1	1
FBgn0024956	90	82	59	65	149	147	TRUE	TRUE	TRUE	1	TRUE	TRUE	1	1
FBgn0024957	125	138	98	115	223	253	TRUE	TRUE	TRUE	1	TRUE	TRUE	1	1
FBgn0024958	62	67	50	58	112	125	TRUE	TRUE	TRUE	1	TRUE	TRUE	1	1
FBgn0024963	353	247	214	252	567	499	FALSE	FALSE	FALSE	0	TRUE	TRUE	1	0
FBgn0025109	73	89	56	58	129	147	TRUE	TRUE	TRUE	1	TRUE	TRUE	1	1
FBgn0025115	62	90	60	50	122	140	FALSE	TRUE	TRUE	0	TRUE	TRUE	1	0
FBgn0025185	101	89	81	73	182	162	TRUE	TRUE	TRUE	1	TRUE	TRUE	1	1
FBgn0025186	192	181	132	172	324	353	TRUE	FALSE	TRUE	0	TRUE	TRUE	1	0
FBgn0025334	114	99	93	95	207	194	TRUE	TRUE	TRUE	1	TRUE	TRUE	1	1
FBgn0025335	99	95	76	84	175	179	TRUE	TRUE	TRUE	1	TRUE	TRUE	1	1
FBgn0025336	106	115	86	102	192	217	TRUE	TRUE	TRUE	1	TRUE	TRUE	1	1
FBgn0025352	55	59	48	52	103	111	TRUE	TRUE	TRUE	1	TRUE	TRUE	1	1
FBgn0025360	162	130	159	146	321	276	FALSE	TRUE	FALSE	0	TRUE	TRUE	1	0
FBgn0025366	68	79	57	57	125	136	TRUE	TRUE	TRUE	1	TRUE	TRUE	1	1
FBgn0025373	99	113	98	97	197	210	TRUE	TRUE	TRUE	1	TRUE	TRUE	1	1
FBgn0025455	237	211	175	187	412	398	TRUE	TRUE	TRUE	1	TRUE	TRUE	1	1
FBgn0025456	95	94	91	84	186	178	TRUE	TRUE	TRUE	1	TRUE	TRUE	1	1
FBgn0025457	78	91	76	63	154	154	TRUE	TRUE	TRUE	1	TRUE	TRUE	1	1
FBgn0025469	98	104	100	70	198	174	TRUE	FALSE	TRUE	0	TRUE	TRUE	1	0
FBgn0025519	181	200	150	115	331	315	TRUE	FALSE	TRUE	0	TRUE	TRUE	1	0
FBgn0025525	220	223	194	208	414	431	TRUE	TRUE	TRUE	1	TRUE	TRUE	1	1
FBgn0025571	271	236	195	232	466	468	TRUE	FALSE	TRUE	0	TRUE	TRUE	1	0
FBgn0025573	115	124	85	92	200	216	TRUE	TRUE	TRUE	1	TRUE	TRUE	1	1
FBgn0025574	268	293	260	259	528	552	TRUE	TRUE	TRUE	1	TRUE	TRUE	1	1
FBgn0025582	42	52	39	31	81	83	TRUE	TRUE	TRUE	1	TRUE	TRUE	1	1
FBgn0025583	53	45	48	40	101	85	TRUE	TRUE	TRUE	1	TRUE	TRUE	1	1
FBgn0025595	236	274	199	236	435	510	TRUE	FALSE	FALSE	0	TRUE	TRUE	1	0
FBgn0025608	124	91	94	96	218	187	FALSE	TRUE	TRUE	0	TRUE	TRUE	1	0
FBgn0025674	239	207	158	200	397	407	TRUE	FALSE	TRUE	0	TRUE	TRUE	1	0
FBgn0025676	161	158	140	136	301	294	TRUE	TRUE	TRUE	1	TRUE	TRUE	1	1
FBgn0025678	156	144	118	150	274	294	TRUE	FALSE	TRUE	0	TRUE	TRUE	1	0
FBgn0025680	158	146	113	144	271	290	TRUE	FALSE	TRUE	0	TRUE	TRUE	1	0
FBgn0025681	368	373	312	281	680	654	TRUE	TRUE	TRUE	1	TRUE	TRUE	1	1
FBgn0025683	81	64	96	63	177	127	TRUE	FALSE	FALSE	0	TRUE	FALSE	0	0
FBgn0025684	122	125	85	98	207	223	TRUE	TRUE	TRUE	1	TRUE	TRUE	1	1
FBgn0025686	30	35	18	42	48	77	TRUE	FALSE	FALSE	0	TRUE	FALSE	0	0
FBgn0025693	207	185	168	171	375	356	TRUE	TRUE	TRUE	1	TRUE	TRUE	1	1
FBgn0025697	433	420	385	359	818	779	TRUE	TRUE	TRUE	1	TRUE	TRUE	1	1
FBgn0025700	49	38	48	34	97	72	TRUE	TRUE	FALSE	0	TRUE	TRUE	1	0
FBgn0025702	155	122	115	91	270	213	FALSE	TRUE	FALSE	0	TRUE	TRUE	1	0
FBgn0025709	152	158	119	122	271	280	TRUE	TRUE	TRUE	1	TRUE	TRUE	1	1
FBgn0025716	47	41	43	28	90	69	TRUE	FALSE	TRUE	0	TRUE	FALSE	0	0
FBgn0025720	180	165	142	126	322	291	TRUE	TRUE	TRUE	1	TRUE	TRUE	1	1
FBgn0025724	161	184	105	68	266	252	TRUE	FALSE	TRUE	0	TRUE	FALSE	0	0
FBgn0025726	377	406	332	339	709	745	TRUE	TRUE	TRUE	1	TRUE	TRUE	1	1
FBgn0025740	47	36	37	26	84	62	TRUE	TRUE	FALSE	0	TRUE	TRUE	1	0
FBgn0025741	48	54	47	46	95	100	TRUE	TRUE	TRUE	1	TRUE	TRUE	1	1
FBgn0025742	133	183	162	109	295	292	FALSE	FALSE	TRUE	0	TRUE	TRUE	1	0
FBgn0025776	62	52	48	44	110	96	TRUE	TRUE	TRUE	1	TRUE	TRUE	1	1
FBgn0025777	135	150	124	114	259	264	TRUE	TRUE	TRUE	1	TRUE	TRUE	1	1
FBgn0025781	134	140	122	136	256	276	TRUE	TRUE	TRUE	1	TRUE	TRUE	1	1
FBgn0025790	108	117	81	78	189	195	TRUE	TRUE	TRUE	1	TRUE	TRUE	1	1
FBgn0025802	141	131	131	94	272	225	TRUE	FALSE	FALSE	0	TRUE	TRUE	1	0
FBgn0025807	63	64	66	43	129	107	TRUE	FALSE	TRUE	0	TRUE	FALSE	0	0
FBgn0025808	48	42	31	46	79	88	TRUE	TRUE	TRUE	1	TRUE	TRUE	1	1
FBgn0025821	82	80	64	71	146	151	TRUE	TRUE	TRUE	1	TRUE	TRUE	1	1
FBgn0025827	75	68	51	48	126	116	TRUE	TRUE	TRUE	1	TRUE	TRUE	1	1
FBgn0025830	255	254	178	176	433	430	TRUE	TRUE	TRUE	1	TRUE	TRUE	1	1
FBgn0025832	93	125	64	84	157	209	FALSE	TRUE	FALSE	0	TRUE	TRUE	1	0
FBgn0025833	287	260	220	238	507	498	TRUE	TRUE	TRUE	1	TRUE	TRUE	1	1
FBgn0025865	258	258	228	204	486	462	TRUE	TRUE	TRUE	1	TRUE	TRUE	1	1
FBgn0025866	202	230	168	177	370	407	TRUE	TRUE	TRUE	1	TRUE	TRUE	1	1
FBgn0025874	145	128	116	106	261	234	TRUE	TRUE	TRUE	1	TRUE	TRUE	1	1
FBgn0025878	228	224	188	175	416	399	TRUE	TRUE	TRUE	1	TRUE	TRUE	1	1
FBgn0025885	117	113	112	112	229	225	TRUE	TRUE	TRUE	1	TRUE	TRUE	1	1
FBgn0025936	123	130	104	117	227	247	TRUE	TRUE	TRUE	1	TRUE	TRUE	1	1
FBgn0026056	183	204	149	161	332	365	TRUE	TRUE	TRUE	1	TRUE	TRUE	1	1
FBgn0026059	494	526	409	494	903	1020	TRUE	FALSE	FALSE	0	TRUE	TRUE	1	0
FBgn0026061	173	142	144	135	317	277	FALSE	TRUE	TRUE	0	TRUE	TRUE	1	0
FBgn0026077	108	70	73	68	181	138	FALSE	TRUE	FALSE	0	FALSE	TRUE	0	0
FBgn0026136	91	88	62	44	153	132	TRUE	FALSE	TRUE	0	TRUE	TRUE	1	0
FBgn0026141	61	66	64	65	125	131	TRUE	TRUE	TRUE	1	TRUE	TRUE	1	1
FBgn0026147	513	517	370	432	883	949	TRUE	FALSE	TRUE	0	TRUE	TRUE	1	0
FBgn0026148	77	72	64	62	141	134	TRUE	TRUE	TRUE	1	TRUE	TRUE	1	1
FBgn0026150	122	125	99	92	221	217	TRUE	TRUE	TRUE	1	TRUE	TRUE	1	1
FBgn0026160	553	574	472	439	1025	1013	TRUE	TRUE	TRUE	1	TRUE	TRUE	1	1
FBgn0026164	33	16	61	13	94	29	FALSE	FALSE	FALSE	0	FALSE	FALSE	0	0
FBgn0026179	317	287	225	265	542	552	TRUE	FALSE	TRUE	0	TRUE	TRUE	1	0
FBgn0026189	455	434	416	385	871	819	TRUE	TRUE	TRUE	1	TRUE	TRUE	1	1
FBgn0026190	143	186	139	153	282	339	FALSE	TRUE	FALSE	0	TRUE	TRUE	1	0
FBgn0026196	113	108	103	80	216	188	TRUE	TRUE	TRUE	1	TRUE	TRUE	1	1
FBgn0026197	52	36	34	32	86	68	TRUE	TRUE	TRUE	1	TRUE	TRUE	1	1
FBgn0026207	207	226	174	190	381	416	TRUE	TRUE	TRUE	1	TRUE	TRUE	1	1
FBgn0026238	39	49	26	46	65	95	TRUE	FALSE	FALSE	0	TRUE	FALSE	0	0
FBgn0026239	670	661	506	553	1176	1214	TRUE	TRUE	TRUE	1	TRUE	TRUE	1	1
FBgn0026250	133	137	105	112	238	249	TRUE	TRUE	TRUE	1	TRUE	TRUE	1	1
FBgn0026252	161	141	110	126	271	267	TRUE	TRUE	TRUE	1	TRUE	TRUE	1	1
FBgn0026255	90	77	63	76	153	153	TRUE	TRUE	TRUE	1	TRUE	TRUE	1	1
FBgn0026257	102	104	79	84	181	188	TRUE	TRUE	TRUE	1	TRUE	TRUE	1	1
FBgn0026259	300	283	264	277	564	560	TRUE	TRUE	TRUE	1	TRUE	TRUE	1	1
FBgn0026261	54	55	36	39	90	94	TRUE	TRUE	TRUE	1	TRUE	TRUE	1	1
FBgn0026262	32	21	38	34	70	55	TRUE	TRUE	TRUE	1	FALSE	TRUE	0	0
FBgn0026263	68	77	75	69	143	146	TRUE	TRUE	TRUE	1	TRUE	TRUE	1	1
FBgn0026309	156	170	130	125	286	295	TRUE	TRUE	TRUE	1	TRUE	TRUE	1	1
FBgn0026314	124	119	99	105	223	224	TRUE	TRUE	TRUE	1	TRUE	TRUE	1	1
FBgn0026315	112	117	102	112	214	229	TRUE	TRUE	TRUE	1	TRUE	TRUE	1	1
FBgn0026316	70	70	56	43	126	113	TRUE	TRUE	TRUE	1	TRUE	TRUE	1	1
FBgn0026317	180	185	141	148	321	333	TRUE	TRUE	TRUE	1	TRUE	TRUE	1	1
FBgn0026319	211	191	140	172	351	363	TRUE	FALSE	TRUE	0	TRUE	TRUE	1	0
FBgn0026320	66	62	47	51	113	113	TRUE	TRUE	TRUE	1	TRUE	TRUE	1	1
FBgn0026326	54	33	31	43	85	76	FALSE	TRUE	TRUE	0	FALSE	TRUE	0	0
FBgn0026361	98	83	94	85	192	168	TRUE	TRUE	TRUE	1	TRUE	TRUE	1	1
FBgn0026369	436	376	342	324	778	700	FALSE	TRUE	FALSE	0	TRUE	TRUE	1	0
FBgn0026371	121	131	89	92	210	223	TRUE	TRUE	TRUE	1	TRUE	TRUE	1	1
FBgn0026372	82	75	65	82	147	157	TRUE	TRUE	TRUE	1	TRUE	TRUE	1	1
FBgn0026373	36	36	17	36	53	72	TRUE	FALSE	TRUE	0	TRUE	FALSE	0	0
FBgn0026376	395	341	311	287	706	628	FALSE	TRUE	FALSE	0	TRUE	TRUE	1	0
FBgn0026378	145	118	113	115	258	233	TRUE	TRUE	TRUE	1	TRUE	TRUE	1	1
FBgn0026379	294	284	237	228	531	512	TRUE	TRUE	TRUE	1	TRUE	TRUE	1	1
FBgn0026384	98	112	91	82	189	194	TRUE	TRUE	TRUE	1	TRUE	TRUE	1	1
FBgn0026385	114	128	89	120	203	248	TRUE	FALSE	FALSE	0	TRUE	TRUE	1	0
FBgn0026386	89	87	62	67	151	154	TRUE	TRUE	TRUE	1	TRUE	TRUE	1	1
FBgn0026389	119	138	116	103	235	241	TRUE	TRUE	TRUE	1	TRUE	TRUE	1	1
FBgn0026390	111	126	121	125	232	251	TRUE	TRUE	TRUE	1	TRUE	TRUE	1	1
FBgn0026391	180	184	144	126	324	310	TRUE	TRUE	TRUE	1	TRUE	TRUE	1	1
FBgn0026392	146	160	128	144	274	304	TRUE	TRUE	TRUE	1	TRUE	TRUE	1	1
FBgn0026393	50	35	33	45	83	80	TRUE	TRUE	TRUE	1	TRUE	TRUE	1	1
FBgn0026394	133	120	97	102	230	222	TRUE	TRUE	TRUE	1	TRUE	TRUE	1	1
FBgn0026395	96	85	93	93	189	178	TRUE	TRUE	TRUE	1	TRUE	TRUE	1	1
FBgn0026396	161	124	112	110	273	234	FALSE	TRUE	FALSE	0	TRUE	TRUE	1	0
FBgn0026397	170	127	120	123	290	250	FALSE	TRUE	FALSE	0	TRUE	TRUE	1	0
FBgn0026398	78	32	65	25	143	57	FALSE	FALSE	FALSE	0	FALSE	FALSE	0	0
FBgn0026399	20	28	32	19	52	47	TRUE	FALSE	TRUE	0	TRUE	FALSE	0	0
FBgn0026400	92	88	64	91	156	179	TRUE	FALSE	TRUE	0	TRUE	TRUE	1	0
FBgn0026401	153	151	117	125	270	276	TRUE	TRUE	TRUE	1	TRUE	TRUE	1	1
FBgn0026402	103	109	89	81	192	190	TRUE	TRUE	TRUE	1	TRUE	TRUE	1	1
FBgn0026403	342	323	250	249	592	572	TRUE	TRUE	TRUE	1	TRUE	TRUE	1	1
FBgn0026404	182	190	157	151	339	341	TRUE	TRUE	TRUE	1	TRUE	TRUE	1	1
FBgn0026409	182	163	142	148	324	311	TRUE	TRUE	TRUE	1	TRUE	TRUE	1	1
FBgn0026417	39	32	38	41	77	73	TRUE	TRUE	TRUE	1	TRUE	TRUE	1	1
FBgn0026418	174	159	155	157	329	316	TRUE	TRUE	TRUE	1	TRUE	TRUE	1	1
FBgn0026427	548	497	441	429	989	926	TRUE	TRUE	TRUE	1	TRUE	TRUE	1	1
FBgn0026431	108	137	105	94	213	231	FALSE	TRUE	TRUE	0	TRUE	TRUE	1	0
FBgn0026432	298	337	248	246	546	583	TRUE	TRUE	TRUE	1	TRUE	TRUE	1	1
FBgn0026438	343	385	306	313	649	698	TRUE	TRUE	TRUE	1	TRUE	TRUE	1	1
FBgn0026439	297	350	239	275	536	625	FALSE	TRUE	FALSE	0	TRUE	TRUE	1	0
FBgn0026441	86	109	77	79	163	188	TRUE	TRUE	TRUE	1	TRUE	TRUE	1	1
FBgn0026479	36	27	20	31	56	58	TRUE	TRUE	TRUE	1	TRUE	FALSE	0	0
FBgn0026533	261	257	234	202	495	459	TRUE	TRUE	TRUE	1	TRUE	TRUE	1	1
FBgn0026562	111	107	103	78	214	185	TRUE	FALSE	TRUE	0	TRUE	TRUE	1	0
FBgn0026563	147	159	152	131	299	290	TRUE	TRUE	TRUE	1	TRUE	TRUE	1	1
FBgn0026566	49	51	48	44	97	95	TRUE	TRUE	TRUE	1	TRUE	TRUE	1	1
FBgn0026570	133	126	101	83	234	209	TRUE	TRUE	TRUE	1	TRUE	TRUE	1	1
FBgn0026573	255	280	215	224	470	504	TRUE	TRUE	TRUE	1	TRUE	TRUE	1	1
FBgn0026576	109	148	104	103	213	251	FALSE	TRUE	FALSE	0	TRUE	TRUE	1	0
FBgn0026577	283	260	252	250	535	510	TRUE	TRUE	TRUE	1	TRUE	TRUE	1	1
FBgn0026582	60	46	50	50	110	96	TRUE	TRUE	TRUE	1	TRUE	TRUE	1	1
FBgn0026592	108	111	88	75	196	186	TRUE	TRUE	TRUE	1	TRUE	TRUE	1	1
FBgn0026593	167	187	151	174	318	361	TRUE	TRUE	TRUE	1	TRUE	TRUE	1	1
FBgn0026597	371	434	338	335	709	769	FALSE	TRUE	TRUE	0	TRUE	TRUE	1	0
FBgn0026598	166	183	137	152	303	335	TRUE	TRUE	TRUE	1	TRUE	TRUE	1	1
FBgn0026602	109	130	99	93	208	223	TRUE	TRUE	TRUE	1	TRUE	TRUE	1	1
FBgn0026616	238	257	202	189	440	446	TRUE	TRUE	TRUE	1	TRUE	TRUE	1	1
FBgn0026619	162	148	130	118	292	266	TRUE	TRUE	TRUE	1	TRUE	TRUE	1	1
FBgn0026620	174	135	131	142	305	277	FALSE	TRUE	TRUE	0	TRUE	TRUE	1	0
FBgn0026630	87	74	87	76	174	150	TRUE	TRUE	TRUE	1	TRUE	TRUE	1	1
FBgn0026718	205	183	154	160	359	343	TRUE	TRUE	TRUE	1	TRUE	TRUE	1	1
FBgn0026721	114	124	126	113	240	237	TRUE	TRUE	TRUE	1	TRUE	TRUE	1	1
FBgn0026722	124	108	115	112	239	220	TRUE	TRUE	TRUE	1	TRUE	TRUE	1	1
FBgn0026754	181	177	127	145	308	322	TRUE	TRUE	TRUE	1	TRUE	TRUE	1	1
FBgn0026755	154	152	125	119	279	271	TRUE	TRUE	TRUE	1	TRUE	TRUE	1	1
FBgn0026756	81	66	64	67	145	133	TRUE	TRUE	TRUE	1	TRUE	TRUE	1	1
FBgn0026760	115	121	73	73	188	194	TRUE	TRUE	TRUE	1	TRUE	TRUE	1	1
FBgn0026761	103	123	100	101	203	224	TRUE	TRUE	TRUE	1	TRUE	TRUE	1	1
FBgn0026777	75	85	69	63	144	148	TRUE	TRUE	TRUE	1	TRUE	TRUE	1	1
FBgn0026787	35	39	29	27	64	66	TRUE	TRUE	TRUE	1	TRUE	TRUE	1	1
FBgn0026869	197	198	148	164	345	362	TRUE	TRUE	TRUE	1	TRUE	TRUE	1	1
FBgn0027052	125	139	113	99	238	238	TRUE	TRUE	TRUE	1	TRUE	TRUE	1	1
FBgn0027053	22	40	29	27	51	67	FALSE	TRUE	TRUE	0	FALSE	TRUE	0	0
FBgn0027054	89	61	68	52	157	113	FALSE	TRUE	FALSE	0	TRUE	TRUE	1	0
FBgn0027057	87	79	75	72	162	151	TRUE	TRUE	TRUE	1	TRUE	TRUE	1	1
FBgn0027066	183	206	146	145	329	351	TRUE	TRUE	TRUE	1	TRUE	TRUE	1	1
FBgn0027070	124	71	68	77	192	148	FALSE	TRUE	FALSE	0	FALSE	TRUE	0	0
FBgn0027073	150	151	105	129	255	280	TRUE	TRUE	TRUE	1	TRUE	TRUE	1	1
FBgn0027074	213	207	228	167	441	374	TRUE	FALSE	FALSE	0	TRUE	TRUE	1	0
FBgn0027079	272	213	196	193	468	406	FALSE	TRUE	FALSE	0	TRUE	TRUE	1	0
FBgn0027080	162	163	138	106	300	269	TRUE	FALSE	TRUE	0	TRUE	TRUE	1	0
FBgn0027081	232	206	204	144	436	350	TRUE	FALSE	FALSE	0	TRUE	TRUE	1	0
FBgn0027082	124	156	100	126	224	282	FALSE	FALSE	FALSE	0	TRUE	TRUE	1	0
FBgn0027083	243	265	242	256	485	521	TRUE	TRUE	TRUE	1	TRUE	TRUE	1	1
FBgn0027085	256	267	235	206	491	473	TRUE	TRUE	TRUE	1	TRUE	TRUE	1	1
FBgn0027086	150	145	105	129	255	274	TRUE	TRUE	TRUE	1	TRUE	TRUE	1	1
FBgn0027088	169	154	174	134	343	288	TRUE	FALSE	FALSE	0	TRUE	TRUE	1	0
FBgn0027090	107	85	87	96	194	181	TRUE	TRUE	TRUE	1	TRUE	TRUE	1	1
FBgn0027091	231	241	196	167	427	408	TRUE	TRUE	TRUE	1	TRUE	TRUE	1	1
FBgn0027094	178	178	162	134	340	312	TRUE	TRUE	TRUE	1	TRUE	TRUE	1	1
FBgn0027095	48	62	48	53	96	115	TRUE	TRUE	TRUE	1	TRUE	TRUE	1	1
FBgn0027101	96	96	98	73	194	169	TRUE	FALSE	TRUE	0	TRUE	TRUE	1	0
FBgn0027109	58	73	75	45	133	118	TRUE	FALSE	TRUE	0	TRUE	FALSE	0	0
FBgn0027111	56	59	40	55	96	114	TRUE	TRUE	TRUE	1	TRUE	TRUE	1	1
FBgn0027338	20	25	32	29	52	54	TRUE	TRUE	TRUE	1	TRUE	TRUE	1	1
FBgn0027339	349	340	272	287	621	627	TRUE	TRUE	TRUE	1	TRUE	TRUE	1	1
FBgn0027341	49	57	44	34	93	91	TRUE	TRUE	TRUE	1	TRUE	TRUE	1	1
FBgn0027348	291	298	261	251	552	549	TRUE	TRUE	TRUE	1	TRUE	TRUE	1	1
FBgn0027356	228	251	160	222	388	473	TRUE	FALSE	FALSE	0	TRUE	TRUE	1	0
FBgn0027363	234	233	168	175	402	408	TRUE	TRUE	TRUE	1	TRUE	TRUE	1	1
FBgn0027364	104	122	90	99	194	221	TRUE	TRUE	TRUE	1	TRUE	TRUE	1	1
FBgn0027375	122	147	107	139	229	286	TRUE	FALSE	FALSE	0	TRUE	TRUE	1	0
FBgn0027376	202	207	199	188	401	395	TRUE	TRUE	TRUE	1	TRUE	TRUE	1	1
FBgn0027453	110	158	118	92	228	250	FALSE	FALSE	TRUE	0	TRUE	TRUE	1	0
FBgn0027490	211	213	145	176	356	389	TRUE	FALSE	TRUE	0	TRUE	TRUE	1	0
FBgn0027491	180	155	126	148	306	303	TRUE	TRUE	TRUE	1	TRUE	TRUE	1	1
FBgn0027492	465	397	370	402	835	799	FALSE	TRUE	TRUE	0	TRUE	TRUE	1	0
FBgn0027493	99	78	52	65	151	143	TRUE	TRUE	TRUE	1	TRUE	TRUE	1	1
FBgn0027494	54	61	37	54	91	115	TRUE	FALSE	TRUE	0	TRUE	TRUE	1	0
FBgn0027495	74	74	61	55	135	129	TRUE	TRUE	TRUE	1	TRUE	TRUE	1	1
FBgn0027496	78	75	83	84	161	159	TRUE	TRUE	TRUE	1	TRUE	TRUE	1	1
FBgn0027497	24	26	20	23	44	49	TRUE	TRUE	TRUE	1	TRUE	TRUE	1	1
FBgn0027499	284	270	222	242	506	512	TRUE	TRUE	TRUE	1	TRUE	TRUE	1	1
FBgn0027500	111	114	62	67	173	181	TRUE	TRUE	TRUE	1	TRUE	TRUE	1	1
FBgn0027503	114	100	96	84	210	184	TRUE	TRUE	TRUE	1	TRUE	TRUE	1	1
FBgn0027504	93	81	92	77	185	158	TRUE	TRUE	TRUE	1	TRUE	TRUE	1	1
FBgn0027505	280	313	258	273	538	586	TRUE	TRUE	TRUE	1	TRUE	TRUE	1	1
FBgn0027506	85	83	72	49	157	132	TRUE	FALSE	TRUE	0	TRUE	TRUE	1	0
FBgn0027507	18	31	12	19	30	50	FALSE	TRUE	FALSE	0	FALSE	FALSE	0	0
FBgn0027508	270	251	215	215	485	466	TRUE	TRUE	TRUE	1	TRUE	TRUE	1	1
FBgn0027509	211	201	206	154	417	355	TRUE	FALSE	FALSE	0	TRUE	TRUE	1	0
FBgn0027512	73	56	70	67	143	123	TRUE	TRUE	TRUE	1	TRUE	TRUE	1	1
FBgn0027513	30	43	18	23	48	66	TRUE	TRUE	TRUE	1	TRUE	TRUE	1	1
FBgn0027514	37	55	58	43	95	98	FALSE	TRUE	TRUE	0	TRUE	TRUE	1	0
FBgn0027515	219	180	170	148	389	328	FALSE	TRUE	FALSE	0	TRUE	TRUE	1	0
FBgn0027518	202	197	196	180	398	377	TRUE	TRUE	TRUE	1	TRUE	TRUE	1	1
FBgn0027524	31	31	23	32	54	63	TRUE	TRUE	TRUE	1	TRUE	TRUE	1	1
FBgn0027525	150	148	132	138	282	286	TRUE	TRUE	TRUE	1	TRUE	TRUE	1	1
FBgn0027526	123	77	72	69	195	146	FALSE	TRUE	FALSE	0	FALSE	TRUE	0	0
FBgn0027529	345	335	217	260	562	595	TRUE	FALSE	TRUE	0	TRUE	TRUE	1	0
FBgn0027532	36	34	18	22	54	56	TRUE	TRUE	TRUE	1	TRUE	TRUE	1	1
FBgn0027535	326	300	213	233	539	533	TRUE	TRUE	TRUE	1	TRUE	TRUE	1	1
FBgn0027538	78	55	50	45	128	100	FALSE	TRUE	FALSE	0	TRUE	TRUE	1	0
FBgn0027539	92	99	78	89	170	188	TRUE	TRUE	TRUE	1	TRUE	TRUE	1	1
FBgn0027547	29	32	23	30	52	62	TRUE	TRUE	TRUE	1	TRUE	TRUE	1	1
FBgn0027548	116	91	100	79	216	170	FALSE	TRUE	FALSE	0	TRUE	TRUE	1	0
FBgn0027549	44	50	46	50	90	100	TRUE	TRUE	TRUE	1	TRUE	TRUE	1	1
FBgn0027550	214	238	183	199	397	437	TRUE	TRUE	TRUE	1	TRUE	TRUE	1	1
FBgn0027552	125	125	95	72	220	197	TRUE	FALSE	TRUE	0	TRUE	TRUE	1	0
FBgn0027554	83	78	73	77	156	155	TRUE	TRUE	TRUE	1	TRUE	TRUE	1	1
FBgn0027558	125	98	78	87	203	185	FALSE	TRUE	TRUE	0	TRUE	TRUE	1	0
FBgn0027560	237	266	221	194	458	460	TRUE	TRUE	TRUE	1	TRUE	TRUE	1	1
FBgn0027561	204	222	199	172	403	394	TRUE	TRUE	TRUE	1	TRUE	TRUE	1	1
FBgn0027562	156	151	120	126	276	277	TRUE	TRUE	TRUE	1	TRUE	TRUE	1	1
FBgn0027563	94	102	101	82	195	184	TRUE	TRUE	TRUE	1	TRUE	TRUE	1	1
FBgn0027565	27	43	41	25	68	68	FALSE	FALSE	TRUE	0	FALSE	FALSE	0	0
FBgn0027567	205	190	206	156	411	346	TRUE	FALSE	FALSE	0	TRUE	TRUE	1	0
FBgn0027568	259	224	225	198	484	422	TRUE	TRUE	FALSE	0	TRUE	TRUE	1	0
FBgn0027569	221	250	190	189	411	439	TRUE	TRUE	TRUE	1	TRUE	TRUE	1	1
FBgn0027570	34	52	43	42	77	94	FALSE	TRUE	TRUE	0	FALSE	TRUE	0	0
FBgn0027572	167	201	145	138	312	339	FALSE	TRUE	TRUE	0	TRUE	TRUE	1	0
FBgn0027574	132	127	88	109	220	236	TRUE	TRUE	TRUE	1	TRUE	TRUE	1	1
FBgn0027575	305	282	236	259	541	541	TRUE	TRUE	TRUE	1	TRUE	TRUE	1	1
FBgn0027578	107	115	83	93	190	208	TRUE	TRUE	TRUE	1	TRUE	TRUE	1	1
FBgn0027579	178	216	154	149	332	365	FALSE	TRUE	TRUE	0	TRUE	TRUE	1	0
FBgn0027580	184	216	161	152	345	368	TRUE	TRUE	TRUE	1	TRUE	TRUE	1	1
FBgn0027581	47	37	35	46	82	83	TRUE	TRUE	TRUE	1	TRUE	TRUE	1	1
FBgn0027582	203	235	155	175	358	410	TRUE	TRUE	FALSE	0	TRUE	TRUE	1	0
FBgn0027583	119	112	107	104	226	216	TRUE	TRUE	TRUE	1	TRUE	TRUE	1	1
FBgn0027584	154	153	140	130	294	283	TRUE	TRUE	TRUE	1	TRUE	TRUE	1	1
FBgn0027585	236	249	181	182	417	431	TRUE	TRUE	TRUE	1	TRUE	TRUE	1	1
FBgn0027586	147	140	111	109	258	249	TRUE	TRUE	TRUE	1	TRUE	TRUE	1	1
FBgn0027587	24	26	23	24	47	50	TRUE	TRUE	TRUE	1	TRUE	TRUE	1	1
FBgn0027589	166	197	192	149	358	346	TRUE	FALSE	TRUE	0	TRUE	TRUE	1	0
FBgn0027590	30	31	21	15	51	46	TRUE	TRUE	TRUE	1	TRUE	TRUE	1	1
FBgn0027592	100	86	84	83	184	169	TRUE	TRUE	TRUE	1	TRUE	TRUE	1	1
FBgn0027594	266	272	245	232	511	504	TRUE	TRUE	TRUE	1	TRUE	TRUE	1	1
FBgn0027596	558	569	437	458	995	1027	TRUE	TRUE	TRUE	1	TRUE	TRUE	1	1
FBgn0027598	469	411	374	328	843	739	FALSE	FALSE	FALSE	0	TRUE	TRUE	1	0
FBgn0027600	151	157	114	121	265	278	TRUE	TRUE	TRUE	1	TRUE	TRUE	1	1
FBgn0027607	33	49	37	28	70	77	FALSE	TRUE	TRUE	0	TRUE	TRUE	1	0
FBgn0027608	115	120	123	106	238	226	TRUE	TRUE	TRUE	1	TRUE	TRUE	1	1
FBgn0027609	104	72	73	65	177	137	FALSE	TRUE	FALSE	0	TRUE	TRUE	1	0
FBgn0027610	86	92	80	90	166	182	TRUE	TRUE	TRUE	1	TRUE	TRUE	1	1
FBgn0027611	396	412	365	312	761	724	TRUE	FALSE	TRUE	0	TRUE	TRUE	1	0
FBgn0027615	163	202	141	148	304	350	FALSE	TRUE	FALSE	0	TRUE	TRUE	1	0
FBgn0027616	122	145	126	106	248	251	TRUE	TRUE	TRUE	1	TRUE	TRUE	1	1
FBgn0027617	45	32	34	30	79	62	TRUE	TRUE	TRUE	1	TRUE	TRUE	1	1
FBgn0027619	93	102	83	98	176	200	TRUE	TRUE	TRUE	1	TRUE	TRUE	1	1
FBgn0027620	110	139	103	84	213	223	FALSE	TRUE	TRUE	0	TRUE	TRUE	1	0
FBgn0027654	211	216	160	187	371	403	TRUE	TRUE	TRUE	1	TRUE	TRUE	1	1
FBgn0027655	1084	1003	828	798	1912	1801	FALSE	TRUE	FALSE	0	TRUE	TRUE	1	0
FBgn0027657	116	109	95	64	211	173	TRUE	FALSE	FALSE	0	TRUE	TRUE	1	0
FBgn0027660	210	180	169	200	379	380	TRUE	TRUE	TRUE	1	TRUE	TRUE	1	1
FBgn0027779	179	148	129	138	308	286	FALSE	TRUE	TRUE	0	TRUE	TRUE	1	0
FBgn0027780	195	191	139	148	334	339	TRUE	TRUE	TRUE	1	TRUE	TRUE	1	1
FBgn0027783	297	285	276	244	573	529	TRUE	TRUE	TRUE	1	TRUE	TRUE	1	1
FBgn0027784	70	80	69	80	139	160	TRUE	TRUE	TRUE	1	TRUE	TRUE	1	1
FBgn0027785	27	29	28	18	55	47	TRUE	TRUE	TRUE	1	TRUE	FALSE	0	0
FBgn0027788	102	104	89	97	191	201	TRUE	TRUE	TRUE	1	TRUE	TRUE	1	1
FBgn0027790	92	95	91	86	183	181	TRUE	TRUE	TRUE	1	TRUE	TRUE	1	1
FBgn0027835	436	413	346	316	782	729	TRUE	TRUE	TRUE	1	TRUE	TRUE	1	1
FBgn0027836	214	175	143	154	357	329	FALSE	TRUE	TRUE	0	TRUE	TRUE	1	0
FBgn0027841	100	114	94	90	194	204	TRUE	TRUE	TRUE	1	TRUE	TRUE	1	1
FBgn0027843	138	135	120	135	258	270	TRUE	TRUE	TRUE	1	TRUE	TRUE	1	1
FBgn0027844	40	47	29	30	69	77	TRUE	TRUE	TRUE	1	TRUE	TRUE	1	1
FBgn0027865	295	327	263	272	558	599	TRUE	TRUE	TRUE	1	TRUE	TRUE	1	1
FBgn0027866	39	38	39	26	78	64	TRUE	TRUE	TRUE	1	TRUE	TRUE	1	1
FBgn0027868	92	73	61	65	153	138	TRUE	TRUE	TRUE	1	TRUE	TRUE	1	1
FBgn0027872	117	107	98	105	215	212	TRUE	TRUE	TRUE	1	TRUE	TRUE	1	1
FBgn0027873	92	81	72	77	164	158	TRUE	TRUE	TRUE	1	TRUE	TRUE	1	1
FBgn0027889	94	109	89	71	183	180	TRUE	TRUE	TRUE	1	TRUE	TRUE	1	1
FBgn0027929	128	122	96	104	224	226	TRUE	TRUE	TRUE	1	TRUE	TRUE	1	1
FBgn0027932	245	236	206	199	451	435	TRUE	TRUE	TRUE	1	TRUE	TRUE	1	1
FBgn0027934	42	32	25	29	67	61	TRUE	TRUE	TRUE	1	TRUE	TRUE	1	1
FBgn0027948	244	242	209	222	453	464	TRUE	TRUE	TRUE	1	TRUE	TRUE	1	1
FBgn0027949	85	97	55	84	140	181	TRUE	FALSE	FALSE	0	TRUE	FALSE	0	0
FBgn0027950	25	17	24	13	49	30	TRUE	FALSE	FALSE	0	TRUE	FALSE	0	0
FBgn0027951	23	27	29	33	52	60	TRUE	TRUE	TRUE	1	TRUE	TRUE	1	1
FBgn0028370	272	288	289	252	561	540	TRUE	TRUE	TRUE	1	TRUE	TRUE	1	1
FBgn0028371	923	925	778	748	1701	1673	TRUE	TRUE	TRUE	1	TRUE	TRUE	1	1
FBgn0028372	125	151	104	115	229	266	TRUE	TRUE	TRUE	1	TRUE	TRUE	1	1
FBgn0028374	66	75	73	75	139	150	TRUE	TRUE	TRUE	1	TRUE	TRUE	1	1
FBgn0028375	137	135	116	110	253	245	TRUE	TRUE	TRUE	1	TRUE	TRUE	1	1
FBgn0028379	24	28	31	34	55	62	TRUE	TRUE	TRUE	1	TRUE	TRUE	1	1
FBgn0028380	103	106	75	91	178	197	TRUE	TRUE	TRUE	1	TRUE	TRUE	1	1
FBgn0028381	127	117	71	100	198	217	TRUE	FALSE	TRUE	0	TRUE	TRUE	1	0
FBgn0028382	50	34	34	31	84	65	TRUE	TRUE	TRUE	1	TRUE	TRUE	1	1
FBgn0028387	353	309	253	264	606	573	FALSE	TRUE	TRUE	0	TRUE	TRUE	1	0
FBgn0028394	250	259	233	245	483	504	TRUE	TRUE	TRUE	1	TRUE	TRUE	1	1
FBgn0028396	57	66	38	59	95	125	TRUE	FALSE	FALSE	0	TRUE	FALSE	0	0
FBgn0028398	29	19	19	16	48	35	TRUE	TRUE	TRUE	1	FALSE	TRUE	0	0
FBgn0028399	145	159	113	122	258	281	TRUE	TRUE	TRUE	1	TRUE	TRUE	1	1
FBgn0028400	105	95	82	77	187	172	TRUE	TRUE	TRUE	1	TRUE	TRUE	1	1
FBgn0028402	37	45	33	38	70	83	TRUE	TRUE	TRUE	1	TRUE	TRUE	1	1
FBgn0028406	74	87	55	56	129	143	TRUE	TRUE	TRUE	1	TRUE	TRUE	1	1
FBgn0028407	92	119	103	97	195	216	FALSE	TRUE	TRUE	0	TRUE	TRUE	1	0
FBgn0028408	287	281	223	262	510	543	TRUE	FALSE	TRUE	0	TRUE	TRUE	1	0
FBgn0028410	27	41	20	18	47	59	TRUE	TRUE	TRUE	1	FALSE	TRUE	0	0
FBgn0028412	85	97	93	61	178	158	TRUE	FALSE	TRUE	0	TRUE	FALSE	0	0
FBgn0028416	14	34	10	22	24	56	FALSE	FALSE	FALSE	0	FALSE	FALSE	0	0
FBgn0028422	202	202	178	181	380	383	TRUE	TRUE	TRUE	1	TRUE	TRUE	1	1
FBgn0028424	28	44	25	19	53	63	FALSE	TRUE	TRUE	0	FALSE	TRUE	0	0
FBgn0028425	172	183	140	144	312	327	TRUE	TRUE	TRUE	1	TRUE	TRUE	1	1
FBgn0028426	139	159	126	125	265	284	TRUE	TRUE	TRUE	1	TRUE	TRUE	1	1
FBgn0028427	39	40	41	34	80	74	TRUE	TRUE	TRUE	1	TRUE	TRUE	1	1
FBgn0028429	145	191	105	130	250	321	FALSE	TRUE	FALSE	0	TRUE	TRUE	1	0
FBgn0028434	87	81	86	81	173	162	TRUE	TRUE	TRUE	1	TRUE	TRUE	1	1
FBgn0028467	70	85	70	59	140	144	TRUE	TRUE	TRUE	1	TRUE	TRUE	1	1
FBgn0028468	191	196	182	188	373	384	TRUE	TRUE	TRUE	1	TRUE	TRUE	1	1
FBgn0028471	143	126	103	119	246	245	TRUE	TRUE	TRUE	1	TRUE	TRUE	1	1
FBgn0028473	140	138	123	99	263	237	TRUE	TRUE	TRUE	1	TRUE	TRUE	1	1
FBgn0028475	162	186	153	133	315	319	TRUE	TRUE	TRUE	1	TRUE	TRUE	1	1
FBgn0028476	274	271	230	218	504	489	TRUE	TRUE	TRUE	1	TRUE	TRUE	1	1
FBgn0028479	350	309	211	168	561	477	TRUE	FALSE	FALSE	0	TRUE	TRUE	1	0
FBgn0028481	400	378	289	315	689	693	TRUE	TRUE	TRUE	1	TRUE	TRUE	1	1
FBgn0028482	288	312	219	240	507	552	TRUE	TRUE	TRUE	1	TRUE	TRUE	1	1
FBgn0028484	355	346	296	253	651	599	TRUE	FALSE	TRUE	0	TRUE	TRUE	1	0
FBgn0028487	209	219	181	185	390	404	TRUE	TRUE	TRUE	1	TRUE	TRUE	1	1
FBgn0028490	241	215	194	187	435	402	TRUE	TRUE	TRUE	1	TRUE	TRUE	1	1
FBgn0028494	89	76	65	73	154	149	TRUE	TRUE	TRUE	1	TRUE	TRUE	1	1
FBgn0028496	837	791	657	681	1494	1472	TRUE	TRUE	TRUE	1	TRUE	TRUE	1	1
FBgn0028497	233	191	166	178	399	369	FALSE	TRUE	TRUE	0	TRUE	TRUE	1	0
FBgn0028499	247	239	205	187	452	426	TRUE	TRUE	TRUE	1	TRUE	TRUE	1	1
FBgn0028500	103	122	104	72	207	194	TRUE	FALSE	TRUE	0	TRUE	TRUE	1	0
FBgn0028504	182	202	156	158	338	360	TRUE	TRUE	TRUE	1	TRUE	TRUE	1	1
FBgn0028506	121	97	103	96	224	193	TRUE	TRUE	TRUE	1	TRUE	TRUE	1	1
FBgn0028507	134	129	108	120	242	249	TRUE	TRUE	TRUE	1	TRUE	TRUE	1	1
FBgn0028509	384	433	314	317	698	750	FALSE	TRUE	TRUE	0	TRUE	TRUE	1	0
FBgn0028513	153	164	125	127	278	291	TRUE	TRUE	TRUE	1	TRUE	TRUE	1	1
FBgn0028514	67	87	65	85	132	172	TRUE	TRUE	FALSE	0	TRUE	TRUE	1	0
FBgn0028515	89	115	76	74	165	189	FALSE	TRUE	TRUE	0	TRUE	TRUE	1	0
FBgn0028516	259	279	203	207	462	486	TRUE	TRUE	TRUE	1	TRUE	TRUE	1	1
FBgn0028518	303	311	303	285	606	596	TRUE	TRUE	TRUE	1	TRUE	TRUE	1	1
FBgn0028520	64	57	61	67	125	124	TRUE	TRUE	TRUE	1	TRUE	TRUE	1	1
FBgn0028523	194	206	181	181	375	387	TRUE	TRUE	TRUE	1	TRUE	TRUE	1	1
FBgn0028525	189	178	147	149	336	327	TRUE	TRUE	TRUE	1	TRUE	TRUE	1	1
FBgn0028526	136	112	95	108	231	220	TRUE	TRUE	TRUE	1	TRUE	TRUE	1	1
FBgn0028527	283	311	219	236	502	547	TRUE	TRUE	TRUE	1	TRUE	TRUE	1	1
FBgn0028530	103	134	109	105	212	239	FALSE	TRUE	TRUE	0	TRUE	TRUE	1	0
FBgn0028531	101	115	92	84	193	199	TRUE	TRUE	TRUE	1	TRUE	TRUE	1	1
FBgn0028532	109	110	83	87	192	197	TRUE	TRUE	TRUE	1	TRUE	TRUE	1	1
FBgn0028533	106	101	91	71	197	172	TRUE	TRUE	TRUE	1	TRUE	TRUE	1	1
FBgn0028534	94	108	82	91	176	199	TRUE	TRUE	TRUE	1	TRUE	TRUE	1	1
FBgn0028538	202	212	160	186	362	398	TRUE	TRUE	TRUE	1	TRUE	TRUE	1	1
FBgn0028539	203	186	187	165	390	351	TRUE	TRUE	TRUE	1	TRUE	TRUE	1	1
FBgn0028540	127	119	85	123	212	242	TRUE	FALSE	TRUE	0	TRUE	TRUE	1	0
FBgn0028541	160	150	154	140	314	290	TRUE	TRUE	TRUE	1	TRUE	TRUE	1	1
FBgn0028542	147	128	122	122	269	250	TRUE	TRUE	TRUE	1	TRUE	TRUE	1	1
FBgn0028543	150	152	129	121	279	273	TRUE	TRUE	TRUE	1	TRUE	TRUE	1	1
FBgn0028544	157	152	120	102	277	254	TRUE	TRUE	TRUE	1	TRUE	TRUE	1	1
FBgn0028546	316	169	272	177	588	346	FALSE	FALSE	FALSE	0	FALSE	FALSE	0	0
FBgn0028552	79	77	58	60	137	137	TRUE	TRUE	TRUE	1	TRUE	TRUE	1	1
FBgn0028554	14	23	23	19	37	42	TRUE	TRUE	TRUE	1	FALSE	TRUE	0	0
FBgn0028560	82	74	58	63	140	137	TRUE	TRUE	TRUE	1	TRUE	TRUE	1	1
FBgn0028561	53	69	70	75	123	144	TRUE	TRUE	TRUE	1	TRUE	TRUE	1	1
FBgn0028562	63	43	49	40	112	83	FALSE	TRUE	FALSE	0	TRUE	TRUE	1	0
FBgn0028563	55	76	49	57	104	133	FALSE	TRUE	FALSE	0	TRUE	TRUE	1	0
FBgn0028567	71	78	73	69	144	147	TRUE	TRUE	TRUE	1	TRUE	TRUE	1	1
FBgn0028569	37	36	28	34	65	70	TRUE	TRUE	TRUE	1	TRUE	TRUE	1	1
FBgn0028570	82	72	62	68	144	140	TRUE	TRUE	TRUE	1	TRUE	TRUE	1	1
FBgn0028572	289	274	200	221	489	495	TRUE	TRUE	TRUE	1	TRUE	TRUE	1	1
FBgn0028573	264	265	288	202	552	467	TRUE	FALSE	FALSE	0	TRUE	TRUE	1	0
FBgn0028577	295	278	168	189	463	467	TRUE	TRUE	TRUE	1	TRUE	TRUE	1	1
FBgn0028579	158	148	105	122	263	270	TRUE	TRUE	TRUE	1	TRUE	TRUE	1	1
FBgn0028582	331	341	269	274	600	615	TRUE	TRUE	TRUE	1	TRUE	TRUE	1	1
FBgn0028622	191	180	127	151	318	331	TRUE	TRUE	TRUE	1	TRUE	TRUE	1	1
FBgn0028644	308	273	303	300	611	573	TRUE	TRUE	TRUE	1	TRUE	TRUE	1	1
FBgn0028645	181	211	179	162	360	373	TRUE	TRUE	TRUE	1	TRUE	TRUE	1	1
FBgn0028646	307	296	252	272	559	568	TRUE	TRUE	TRUE	1	TRUE	TRUE	1	1
FBgn0028647	164	202	118	175	282	377	FALSE	FALSE	FALSE	0	TRUE	TRUE	1	0
FBgn0028648	63	53	53	49	116	102	TRUE	TRUE	TRUE	1	TRUE	TRUE	1	1
FBgn0028658	128	131	95	96	223	227	TRUE	TRUE	TRUE	1	TRUE	TRUE	1	1
FBgn0028662	138	133	107	112	245	245	TRUE	TRUE	TRUE	1	TRUE	TRUE	1	1
FBgn0028663	102	86	80	91	182	177	TRUE	TRUE	TRUE	1	TRUE	TRUE	1	1
FBgn0028664	91	77	84	75	175	152	TRUE	TRUE	TRUE	1	TRUE	TRUE	1	1
FBgn0028667	94	92	66	65	160	157	TRUE	TRUE	TRUE	1	TRUE	TRUE	1	1
FBgn0028669	226	239	192	169	418	408	TRUE	TRUE	TRUE	1	TRUE	TRUE	1	1
FBgn0028670	189	187	141	184	330	371	TRUE	FALSE	TRUE	0	TRUE	TRUE	1	0
FBgn0028671	299	273	228	230	527	503	TRUE	TRUE	TRUE	1	TRUE	TRUE	1	1
FBgn0028675	885	875	753	773	1638	1648	TRUE	TRUE	TRUE	1	TRUE	TRUE	1	1
FBgn0028683	42	26	25	26	67	52	FALSE	TRUE	TRUE	0	FALSE	TRUE	0	0
FBgn0028684	81	81	60	59	141	140	TRUE	TRUE	TRUE	1	TRUE	TRUE	1	1
FBgn0028688	58	68	47	49	105	117	TRUE	TRUE	TRUE	1	TRUE	TRUE	1	1
FBgn0028689	102	88	98	85	200	173	TRUE	TRUE	TRUE	1	TRUE	TRUE	1	1
FBgn0028690	22	29	24	21	46	50	TRUE	TRUE	TRUE	1	TRUE	TRUE	1	1
FBgn0028691	101	115	81	92	182	207	TRUE	TRUE	TRUE	1	TRUE	TRUE	1	1
FBgn0028692	261	251	220	208	481	459	TRUE	TRUE	TRUE	1	TRUE	TRUE	1	1
FBgn0028694	45	37	39	39	84	76	TRUE	TRUE	TRUE	1	TRUE	TRUE	1	1
FBgn0028695	34	44	31	34	65	78	TRUE	TRUE	TRUE	1	TRUE	TRUE	1	1
FBgn0028699	284	278	247	232	531	510	TRUE	TRUE	TRUE	1	TRUE	TRUE	1	1
FBgn0028700	122	87	83	73	205	160	FALSE	TRUE	FALSE	0	TRUE	TRUE	1	0
FBgn0028703	463	409	368	397	831	806	FALSE	TRUE	TRUE	0	TRUE	TRUE	1	0
FBgn0028704	593	498	417	428	1010	926	FALSE	TRUE	FALSE	0	TRUE	TRUE	1	0
FBgn0028707	58	65	51	51	109	116	TRUE	TRUE	TRUE	1	TRUE	TRUE	1	1
FBgn0028708	32	34	33	30	65	64	TRUE	TRUE	TRUE	1	TRUE	TRUE	1	1
FBgn0028717	171	163	123	123	294	286	TRUE	TRUE	TRUE	1	TRUE	TRUE	1	1
FBgn0028734	249	241	230	200	479	441	TRUE	TRUE	TRUE	1	TRUE	TRUE	1	1
FBgn0028737	60	59	44	51	104	110	TRUE	TRUE	TRUE	1	TRUE	TRUE	1	1
FBgn0028740	178	161	149	131	327	292	TRUE	TRUE	TRUE	1	TRUE	TRUE	1	1
FBgn0028743	337	359	302	279	639	638	TRUE	TRUE	TRUE	1	TRUE	TRUE	1	1
FBgn0028744	174	182	147	137	321	319	TRUE	TRUE	TRUE	1	TRUE	TRUE	1	1
FBgn0028789	178	168	109	140	287	308	TRUE	FALSE	TRUE	0	TRUE	TRUE	1	0
FBgn0028833	48	45	33	26	81	71	TRUE	TRUE	TRUE	1	TRUE	TRUE	1	1
FBgn0028836	120	139	100	110	220	249	TRUE	TRUE	TRUE	1	TRUE	TRUE	1	1
FBgn0028837	67	52	53	56	120	108	TRUE	TRUE	TRUE	1	TRUE	TRUE	1	1
FBgn0028838	107	101	70	92	177	193	TRUE	FALSE	TRUE	0	TRUE	TRUE	1	0
FBgn0028841	129	117	107	115	236	232	TRUE	TRUE	TRUE	1	TRUE	TRUE	1	1
FBgn0028844	67	62	49	47	116	109	TRUE	TRUE	TRUE	1	TRUE	TRUE	1	1
FBgn0028847	74	89	69	86	143	175	TRUE	TRUE	FALSE	0	TRUE	TRUE	1	0
FBgn0028848	178	176	149	147	327	323	TRUE	TRUE	TRUE	1	TRUE	TRUE	1	1
FBgn0028850	80	86	72	66	152	152	TRUE	TRUE	TRUE	1	TRUE	TRUE	1	1
FBgn0028852	108	85	91	89	199	174	TRUE	TRUE	TRUE	1	TRUE	TRUE	1	1
FBgn0028853	79	91	77	56	156	147	TRUE	FALSE	TRUE	0	TRUE	TRUE	1	0
FBgn0028855	85	72	55	59	140	131	TRUE	TRUE	TRUE	1	TRUE	TRUE	1	1
FBgn0028856	101	91	96	100	197	191	TRUE	TRUE	TRUE	1	TRUE	TRUE	1	1
FBgn0028857	139	139	111	112	250	251	TRUE	TRUE	TRUE	1	TRUE	TRUE	1	1
FBgn0028858	118	112	131	89	249	201	TRUE	FALSE	FALSE	0	TRUE	TRUE	1	0
FBgn0028862	289	263	265	243	554	506	TRUE	TRUE	TRUE	1	TRUE	TRUE	1	1
FBgn0028863	601	605	497	516	1098	1121	TRUE	TRUE	TRUE	1	TRUE	TRUE	1	1
FBgn0028866	130	169	155	129	285	298	FALSE	TRUE	TRUE	0	TRUE	TRUE	1	0
FBgn0028867	96	134	104	110	200	244	FALSE	TRUE	FALSE	0	TRUE	TRUE	1	0
FBgn0028868	93	70	73	85	166	155	FALSE	TRUE	TRUE	0	TRUE	TRUE	1	0
FBgn0028870	34	44	45	43	79	87	TRUE	TRUE	TRUE	1	TRUE	TRUE	1	1
FBgn0028871	90	104	81	99	171	203	TRUE	TRUE	TRUE	1	TRUE	TRUE	1	1
FBgn0028872	200	170	165	150	365	320	TRUE	TRUE	FALSE	0	TRUE	TRUE	1	0
FBgn0028875	689	626	630	638	1319	1264	FALSE	TRUE	TRUE	0	TRUE	TRUE	1	0
FBgn0028878	222	205	158	184	380	389	TRUE	TRUE	TRUE	1	TRUE	TRUE	1	1
FBgn0028879	656	660	544	544	1200	1204	TRUE	TRUE	TRUE	1	TRUE	TRUE	1	1
FBgn0028880	95	100	79	72	174	172	TRUE	TRUE	TRUE	1	TRUE	TRUE	1	1
FBgn0028884	68	86	87	88	155	174	TRUE	TRUE	TRUE	1	TRUE	TRUE	1	1
FBgn0028886	181	203	164	194	345	397	TRUE	TRUE	FALSE	0	TRUE	TRUE	1	0
FBgn0028887	305	330	289	289	594	619	TRUE	TRUE	TRUE	1	TRUE	TRUE	1	1
FBgn0028888	459	483	398	416	857	899	TRUE	TRUE	TRUE	1	TRUE	TRUE	1	1
FBgn0028892	178	148	143	153	321	301	TRUE	TRUE	TRUE	1	TRUE	TRUE	1	1
FBgn0028893	92	105	81	84	173	189	TRUE	TRUE	TRUE	1	TRUE	TRUE	1	1
FBgn0028894	122	102	95	71	217	173	TRUE	FALSE	FALSE	0	TRUE	TRUE	1	0
FBgn0028895	101	106	100	78	201	184	TRUE	TRUE	TRUE	1	TRUE	TRUE	1	1
FBgn0028896	26	25	22	19	48	44	TRUE	TRUE	TRUE	1	TRUE	TRUE	1	1
FBgn0028897	81	78	73	72	154	150	TRUE	TRUE	TRUE	1	TRUE	TRUE	1	1
FBgn0028899	667	759	617	619	1284	1378	FALSE	TRUE	FALSE	0	TRUE	TRUE	1	0
FBgn0028900	57	57	52	39	109	96	TRUE	TRUE	TRUE	1	TRUE	TRUE	1	1
FBgn0028901	413	399	367	368	780	767	TRUE	TRUE	TRUE	1	TRUE	TRUE	1	1
FBgn0028902	181	197	171	183	352	380	TRUE	TRUE	TRUE	1	TRUE	TRUE	1	1
FBgn0028903	77	63	58	54	135	117	TRUE	TRUE	TRUE	1	TRUE	TRUE	1	1
FBgn0028909	30	25	21	25	51	50	TRUE	TRUE	TRUE	1	TRUE	TRUE	1	1
FBgn0028912	23	16	32	23	55	39	TRUE	TRUE	TRUE	1	TRUE	TRUE	1	1
FBgn0028913	30	50	23	45	53	95	FALSE	FALSE	FALSE	0	FALSE	FALSE	0	0
FBgn0028916	411	415	347	312	758	727	TRUE	TRUE	TRUE	1	TRUE	TRUE	1	1
FBgn0028919	44	61	61	45	105	106	TRUE	TRUE	TRUE	1	TRUE	TRUE	1	1
FBgn0028920	137	135	121	124	258	259	TRUE	TRUE	TRUE	1	TRUE	TRUE	1	1
FBgn0028926	55	59	38	32	93	91	TRUE	TRUE	TRUE	1	TRUE	TRUE	1	1
FBgn0028931	64	53	51	40	115	93	TRUE	TRUE	TRUE	1	TRUE	TRUE	1	1
FBgn0028932	30	45	26	38	56	83	TRUE	TRUE	FALSE	0	TRUE	TRUE	1	0
FBgn0028935	186	208	159	161	345	369	TRUE	TRUE	TRUE	1	TRUE	TRUE	1	1
FBgn0028936	132	136	116	111	248	247	TRUE	TRUE	TRUE	1	TRUE	TRUE	1	1
FBgn0028938	219	216	186	168	405	384	TRUE	TRUE	TRUE	1	TRUE	TRUE	1	1
FBgn0028939	195	181	184	190	379	371	TRUE	TRUE	TRUE	1	TRUE	TRUE	1	1
FBgn0028940	180	196	139	148	319	344	TRUE	TRUE	TRUE	1	TRUE	TRUE	1	1
FBgn0028941	98	81	76	90	174	171	TRUE	TRUE	TRUE	1	TRUE	TRUE	1	1
FBgn0028942	54	47	39	34	93	81	TRUE	TRUE	TRUE	1	TRUE	TRUE	1	1
FBgn0028943	63	57	32	44	95	101	TRUE	TRUE	TRUE	1	TRUE	TRUE	1	1
FBgn0028944	35	45	31	42	66	87	TRUE	TRUE	TRUE	1	TRUE	TRUE	1	1
FBgn0028945	72	93	70	57	142	150	TRUE	TRUE	TRUE	1	TRUE	TRUE	1	1
FBgn0028946	128	144	133	104	261	248	TRUE	FALSE	TRUE	0	TRUE	TRUE	1	0
FBgn0028947	101	117	97	98	198	215	TRUE	TRUE	TRUE	1	TRUE	TRUE	1	1
FBgn0028948	86	84	74	73	160	157	TRUE	TRUE	TRUE	1	TRUE	TRUE	1	1
FBgn0028949	92	102	90	53	182	155	TRUE	FALSE	TRUE	0	TRUE	FALSE	0	0
FBgn0028950	79	69	65	57	144	126	TRUE	TRUE	TRUE	1	TRUE	TRUE	1	1
FBgn0028952	145	159	116	132	261	291	TRUE	TRUE	TRUE	1	TRUE	TRUE	1	1
FBgn0028953	184	203	172	167	356	370	TRUE	TRUE	TRUE	1	TRUE	TRUE	1	1
FBgn0028956	263	212	250	193	513	405	FALSE	FALSE	FALSE	0	TRUE	TRUE	1	0
FBgn0028962	170	168	128	124	298	292	TRUE	TRUE	TRUE	1	TRUE	TRUE	1	1
FBgn0028963	156	164	141	136	297	300	TRUE	TRUE	TRUE	1	TRUE	TRUE	1	1
FBgn0028965	25	31	26	27	51	58	TRUE	TRUE	TRUE	1	TRUE	TRUE	1	1
FBgn0028968	56	55	47	47	103	102	TRUE	TRUE	TRUE	1	TRUE	TRUE	1	1
FBgn0028970	75	85	59	54	134	139	TRUE	TRUE	TRUE	1	TRUE	TRUE	1	1
FBgn0028978	39	35	45	52	84	87	TRUE	TRUE	TRUE	1	TRUE	TRUE	1	1
FBgn0028979	145	142	122	107	267	249	TRUE	TRUE	TRUE	1	TRUE	TRUE	1	1
FBgn0028980	116	118	99	94	215	212	TRUE	TRUE	TRUE	1	TRUE	TRUE	1	1
FBgn0028983	96	69	69	64	165	133	FALSE	TRUE	FALSE	0	TRUE	TRUE	1	0
FBgn0028984	65	60	46	47	111	107	TRUE	TRUE	TRUE	1	TRUE	TRUE	1	1
FBgn0028986	56	63	50	62	106	125	TRUE	TRUE	TRUE	1	TRUE	TRUE	1	1
FBgn0028987	87	121	98	89	185	210	FALSE	TRUE	TRUE	0	TRUE	TRUE	1	0
FBgn0028988	19	12	14	21	33	33	TRUE	TRUE	TRUE	1	FALSE	TRUE	0	0
FBgn0028990	78	79	47	57	125	136	TRUE	TRUE	TRUE	1	TRUE	TRUE	1	1
FBgn0028993	25	25	20	22	45	47	TRUE	TRUE	TRUE	1	TRUE	TRUE	1	1
FBgn0028996	81	74	66	68	147	142	TRUE	TRUE	TRUE	1	TRUE	TRUE	1	1
FBgn0028999	223	184	160	187	383	371	FALSE	TRUE	TRUE	0	TRUE	TRUE	1	0
FBgn0029002	137	92	114	94	251	186	FALSE	TRUE	FALSE	0	TRUE	TRUE	1	0
FBgn0029006	285	222	192	230	477	452	FALSE	FALSE	TRUE	0	TRUE	TRUE	1	0
FBgn0029082	464	417	377	359	841	776	TRUE	TRUE	TRUE	1	TRUE	TRUE	1	1
FBgn0029084	155	169	151	135	306	304	TRUE	TRUE	TRUE	1	TRUE	TRUE	1	1
FBgn0029088	95	107	53	70	148	177	TRUE	TRUE	TRUE	1	TRUE	TRUE	1	1
FBgn0029091	152	125	111	107	263	232	TRUE	TRUE	TRUE	1	TRUE	TRUE	1	1
FBgn0029092	163	167	132	142	295	309	TRUE	TRUE	TRUE	1	TRUE	TRUE	1	1
FBgn0029093	62	44	31	37	93	81	FALSE	TRUE	TRUE	0	TRUE	TRUE	1	0
FBgn0029094	93	67	56	66	149	133	FALSE	TRUE	TRUE	0	TRUE	TRUE	1	0
FBgn0029095	320	278	241	241	561	519	FALSE	TRUE	TRUE	0	TRUE	TRUE	1	0
FBgn0029105	221	215	200	202	421	417	TRUE	TRUE	TRUE	1	TRUE	TRUE	1	1
FBgn0029113	134	127	92	109	226	236	TRUE	TRUE	TRUE	1	TRUE	TRUE	1	1
FBgn0029114	508	454	392	410	900	864	FALSE	TRUE	TRUE	0	TRUE	TRUE	1	0
FBgn0029117	83	89	69	98	152	187	TRUE	FALSE	FALSE	0	TRUE	TRUE	1	0
FBgn0029118	165	154	139	132	304	286	TRUE	TRUE	TRUE	1	TRUE	TRUE	1	1
FBgn0029121	77	89	78	82	155	171	TRUE	TRUE	TRUE	1	TRUE	TRUE	1	1
FBgn0029123	158	160	137	117	295	277	TRUE	TRUE	TRUE	1	TRUE	TRUE	1	1
FBgn0029131	78	74	74	61	152	135	TRUE	TRUE	TRUE	1	TRUE	TRUE	1	1
FBgn0029134	51	31	42	49	93	80	FALSE	TRUE	TRUE	0	FALSE	TRUE	0	0
FBgn0029137	161	142	124	122	285	264	TRUE	TRUE	TRUE	1	TRUE	TRUE	1	1
FBgn0029147	163	175	126	129	289	304	TRUE	TRUE	TRUE	1	TRUE	TRUE	1	1
FBgn0029148	51	42	50	48	101	90	TRUE	TRUE	TRUE	1	TRUE	TRUE	1	1
FBgn0029152	89	93	77	61	166	154	TRUE	TRUE	TRUE	1	TRUE	TRUE	1	1
FBgn0029155	208	218	182	159	390	377	TRUE	TRUE	TRUE	1	TRUE	TRUE	1	1
FBgn0029157	256	274	190	202	446	476	TRUE	TRUE	TRUE	1	TRUE	TRUE	1	1
FBgn0029167	1149	1164	938	942	2087	2106	TRUE	TRUE	TRUE	1	TRUE	TRUE	1	1
FBgn0029170	75	76	75	65	150	141	TRUE	TRUE	TRUE	1	TRUE	TRUE	1	1
FBgn0029172	111	128	90	114	201	242	TRUE	TRUE	FALSE	0	TRUE	TRUE	1	0
FBgn0029174	180	167	135	108	315	275	TRUE	FALSE	TRUE	0	TRUE	TRUE	1	0
FBgn0029175	197	219	192	169	389	388	TRUE	TRUE	TRUE	1	TRUE	TRUE	1	1
FBgn0029176	82	80	64	64	146	144	TRUE	TRUE	TRUE	1	TRUE	TRUE	1	1
FBgn0029501	119	113	114	81	233	194	TRUE	FALSE	FALSE	0	TRUE	TRUE	1	0
FBgn0029503	117	103	77	78	194	181	TRUE	TRUE	TRUE	1	TRUE	TRUE	1	1
FBgn0029506	122	132	94	99	216	231	TRUE	TRUE	TRUE	1	TRUE	TRUE	1	1
FBgn0029507	61	43	38	42	99	85	FALSE	TRUE	TRUE	0	TRUE	TRUE	1	0
FBgn0029508	39	28	33	30	72	58	TRUE	TRUE	TRUE	1	TRUE	TRUE	1	1
FBgn0029512	48	52	38	52	86	104	TRUE	TRUE	TRUE	1	TRUE	TRUE	1	1
FBgn0029514	125	131	110	108	235	239	TRUE	TRUE	TRUE	1	TRUE	TRUE	1	1
FBgn0031208	76	63	58	71	134	134	TRUE	TRUE	TRUE	1	TRUE	TRUE	1	1
FBgn0031209	30	22	25	15	55	37	TRUE	TRUE	FALSE	0	TRUE	FALSE	0	0
FBgn0031213	31	36	25	28	56	64	TRUE	TRUE	TRUE	1	TRUE	TRUE	1	1
FBgn0031216	92	81	75	65	167	146	TRUE	TRUE	TRUE	1	TRUE	TRUE	1	1
FBgn0031219	76	100	68	73	144	173	FALSE	TRUE	TRUE	0	TRUE	TRUE	1	0
FBgn0031220	178	194	132	151	310	345	TRUE	TRUE	TRUE	1	TRUE	TRUE	1	1
FBgn0031224	33	31	28	24	61	55	TRUE	TRUE	TRUE	1	TRUE	TRUE	1	1
FBgn0031228	40	30	20	30	60	60	TRUE	TRUE	TRUE	1	TRUE	TRUE	1	1
FBgn0031229	30	26	15	40	45	66	TRUE	FALSE	FALSE	0	TRUE	FALSE	0	0
FBgn0031231	23	35	28	21	51	56	TRUE	TRUE	TRUE	1	FALSE	TRUE	0	0
FBgn0031235	39	39	33	34	72	73	TRUE	TRUE	TRUE	1	TRUE	TRUE	1	1
FBgn0031238	32	34	21	27	53	61	TRUE	TRUE	TRUE	1	TRUE	TRUE	1	1
FBgn0031239	326	339	274	260	600	599	TRUE	TRUE	TRUE	1	TRUE	TRUE	1	1
FBgn0031240	50	40	34	40	84	80	TRUE	TRUE	TRUE	1	TRUE	TRUE	1	1
FBgn0031245	62	71	65	68	127	139	TRUE	TRUE	TRUE	1	TRUE	TRUE	1	1
FBgn0031248	50	43	51	49	101	92	TRUE	TRUE	TRUE	1	TRUE	TRUE	1	1
FBgn0031251	167	152	153	142	320	294	TRUE	TRUE	TRUE	1	TRUE	TRUE	1	1
FBgn0031252	102	77	63	52	165	129	FALSE	TRUE	FALSE	0	TRUE	TRUE	1	0
FBgn0031253	30	30	17	27	47	57	TRUE	TRUE	TRUE	1	TRUE	FALSE	0	0
FBgn0031254	32	55	32	37	64	92	FALSE	TRUE	FALSE	0	FALSE	TRUE	0	0
FBgn0031255	77	63	48	54	125	117	TRUE	TRUE	TRUE	1	TRUE	TRUE	1	1
FBgn0031256	36	32	39	36	75	68	TRUE	TRUE	TRUE	1	TRUE	TRUE	1	1
FBgn0031257	169	133	132	118	301	251	FALSE	TRUE	FALSE	0	TRUE	TRUE	1	0
FBgn0031258	190	171	165	146	355	317	TRUE	TRUE	TRUE	1	TRUE	TRUE	1	1
FBgn0031260	110	129	121	105	231	234	TRUE	TRUE	TRUE	1	TRUE	TRUE	1	1
FBgn0031264	185	144	148	131	333	275	FALSE	TRUE	FALSE	0	TRUE	TRUE	1	0
FBgn0031265	99	90	65	82	164	172	TRUE	TRUE	TRUE	1	TRUE	TRUE	1	1
FBgn0031266	257	266	227	250	484	516	TRUE	TRUE	TRUE	1	TRUE	TRUE	1	1
FBgn0031267	56	66	54	52	110	118	TRUE	TRUE	TRUE	1	TRUE	TRUE	1	1
FBgn0031268	84	111	83	60	167	171	FALSE	FALSE	TRUE	0	TRUE	TRUE	1	0
FBgn0031270	138	122	106	131	244	253	TRUE	TRUE	TRUE	1	TRUE	TRUE	1	1
FBgn0031273	170	201	152	165	322	366	TRUE	TRUE	TRUE	1	TRUE	TRUE	1	1
FBgn0031275	668	635	506	546	1174	1181	TRUE	TRUE	TRUE	1	TRUE	TRUE	1	1
FBgn0031276	78	68	59	46	137	114	TRUE	TRUE	TRUE	1	TRUE	TRUE	1	1
FBgn0031277	45	50	31	43	76	93	TRUE	TRUE	TRUE	1	TRUE	TRUE	1	1
FBgn0031279	86	93	68	63	154	156	TRUE	TRUE	TRUE	1	TRUE	TRUE	1	1
FBgn0031281	141	121	104	84	245	205	TRUE	TRUE	FALSE	0	TRUE	TRUE	1	0
FBgn0031282	29	39	25	34	54	73	TRUE	TRUE	TRUE	1	TRUE	TRUE	1	1
FBgn0031284	125	155	90	99	215	254	FALSE	TRUE	FALSE	0	TRUE	TRUE	1	0
FBgn0031285	156	173	133	120	289	293	TRUE	TRUE	TRUE	1	TRUE	TRUE	1	1
FBgn0031286	90	104	70	80	160	184	TRUE	TRUE	TRUE	1	TRUE	TRUE	1	1
FBgn0031287	80	79	63	60	143	139	TRUE	TRUE	TRUE	1	TRUE	TRUE	1	1
FBgn0031288	120	129	93	117	213	246	TRUE	TRUE	TRUE	1	TRUE	TRUE	1	1
FBgn0031289	69	91	66	69	135	160	FALSE	TRUE	TRUE	0	TRUE	TRUE	1	0
FBgn0031292	549	574	419	488	968	1062	TRUE	FALSE	FALSE	0	TRUE	TRUE	1	0
FBgn0031294	790	855	702	662	1492	1517	TRUE	TRUE	TRUE	1	TRUE	TRUE	1	1
FBgn0031295	75	95	84	74	159	169	TRUE	TRUE	TRUE	1	TRUE	TRUE	1	1
FBgn0031296	92	87	91	99	183	186	TRUE	TRUE	TRUE	1	TRUE	TRUE	1	1
FBgn0031298	127	161	137	142	264	303	FALSE	TRUE	TRUE	0	TRUE	TRUE	1	0
FBgn0031299	127	115	75	121	202	236	TRUE	FALSE	TRUE	0	TRUE	FALSE	0	0
FBgn0031301	230	242	206	197	436	439	TRUE	TRUE	TRUE	1	TRUE	TRUE	1	1
FBgn0031302	138	111	111	106	249	217	FALSE	TRUE	TRUE	0	TRUE	TRUE	1	0
FBgn0031304	169	202	144	142	313	344	FALSE	TRUE	TRUE	0	TRUE	TRUE	1	0
FBgn0031305	129	128	92	103	221	231	TRUE	TRUE	TRUE	1	TRUE	TRUE	1	1
FBgn0031306	192	189	173	169	365	358	TRUE	TRUE	TRUE	1	TRUE	TRUE	1	1
FBgn0031307	209	188	144	152	353	340	TRUE	TRUE	TRUE	1	TRUE	TRUE	1	1
FBgn0031309	90	96	68	78	158	174	TRUE	TRUE	TRUE	1	TRUE	TRUE	1	1
FBgn0031310	53	79	48	57	101	136	FALSE	TRUE	FALSE	0	TRUE	TRUE	1	0
FBgn0031312	51	46	45	41	96	87	TRUE	TRUE	TRUE	1	TRUE	TRUE	1	1
FBgn0031313	150	149	124	155	274	304	TRUE	FALSE	TRUE	0	TRUE	TRUE	1	0
FBgn0031314	132	136	122	125	254	261	TRUE	TRUE	TRUE	1	TRUE	TRUE	1	1
FBgn0031315	43	40	40	28	83	68	TRUE	TRUE	TRUE	1	TRUE	TRUE	1	1
FBgn0031317	180	158	150	112	330	270	TRUE	FALSE	FALSE	0	TRUE	TRUE	1	0
FBgn0031318	219	192	173	173	392	365	TRUE	TRUE	TRUE	1	TRUE	TRUE	1	1
FBgn0031319	199	190	172	158	371	348	TRUE	TRUE	TRUE	1	TRUE	TRUE	1	1
FBgn0031320	108	87	84	59	192	146	TRUE	FALSE	FALSE	0	TRUE	TRUE	1	0
FBgn0031321	98	92	81	94	179	186	TRUE	TRUE	TRUE	1	TRUE	TRUE	1	1
FBgn0031322	215	182	194	185	409	367	TRUE	TRUE	TRUE	1	TRUE	TRUE	1	1
FBgn0031323	90	103	73	89	163	192	TRUE	TRUE	TRUE	1	TRUE	TRUE	1	1
FBgn0031324	76	58	54	62	130	120	TRUE	TRUE	TRUE	1	TRUE	TRUE	1	1
FBgn0031327	269	293	247	254	516	547	TRUE	TRUE	TRUE	1	TRUE	TRUE	1	1
FBgn0031331	107	130	110	110	217	240	TRUE	TRUE	TRUE	1	TRUE	TRUE	1	1
FBgn0031332	101	112	82	87	183	199	TRUE	TRUE	TRUE	1	TRUE	TRUE	1	1
FBgn0031333	80	56	54	47	134	103	FALSE	TRUE	FALSE	0	TRUE	TRUE	1	0
FBgn0031335	63	66	89	61	152	127	TRUE	FALSE	TRUE	0	TRUE	TRUE	1	0
FBgn0031337	103	119	73	95	176	214	TRUE	TRUE	FALSE	0	TRUE	TRUE	1	0
FBgn0031343	165	137	122	133	287	270	TRUE	TRUE	TRUE	1	TRUE	TRUE	1	1
FBgn0031344	92	107	64	65	156	172	TRUE	TRUE	TRUE	1	TRUE	TRUE	1	1
FBgn0031345	45	51	51	41	96	92	TRUE	TRUE	TRUE	1	TRUE	TRUE	1	1
FBgn0031347	213	167	153	148	366	315	FALSE	TRUE	FALSE	0	TRUE	TRUE	1	0
FBgn0031351	88	91	79	83	167	174	TRUE	TRUE	TRUE	1	TRUE	TRUE	1	1
FBgn0031356	144	138	140	139	284	277	TRUE	TRUE	TRUE	1	TRUE	TRUE	1	1
FBgn0031357	68	76	57	41	125	117	TRUE	TRUE	TRUE	1	TRUE	TRUE	1	1
FBgn0031359	244	232	181	211	425	443	TRUE	TRUE	TRUE	1	TRUE	TRUE	1	1
FBgn0031360	61	49	46	56	107	105	TRUE	TRUE	TRUE	1	TRUE	TRUE	1	1
FBgn0031361	85	96	82	67	167	163	TRUE	TRUE	TRUE	1	TRUE	TRUE	1	1
FBgn0031367	45	33	47	28	92	61	TRUE	FALSE	FALSE	0	TRUE	FALSE	0	0
FBgn0031372	116	102	95	98	211	200	TRUE	TRUE	TRUE	1	TRUE	TRUE	1	1
FBgn0031373	81	92	63	81	144	173	TRUE	TRUE	TRUE	1	TRUE	TRUE	1	1
FBgn0031374	1069	1055	891	917	1960	1972	TRUE	TRUE	TRUE	1	TRUE	TRUE	1	1
FBgn0031375	353	362	318	257	671	619	TRUE	FALSE	TRUE	0	TRUE	TRUE	1	0
FBgn0031377	227	234	160	180	387	414	TRUE	TRUE	TRUE	1	TRUE	TRUE	1	1
FBgn0031378	69	104	64	66	133	170	FALSE	TRUE	FALSE	0	FALSE	TRUE	0	0
FBgn0031379	216	184	156	177	372	361	TRUE	TRUE	TRUE	1	TRUE	TRUE	1	1
FBgn0031381	72	78	43	54	115	132	TRUE	TRUE	TRUE	1	TRUE	TRUE	1	1
FBgn0031384	382	369	322	318	704	687	TRUE	TRUE	TRUE	1	TRUE	TRUE	1	1
FBgn0031388	124	108	86	80	210	188	TRUE	TRUE	TRUE	1	TRUE	TRUE	1	1
FBgn0031389	94	71	68	66	162	137	FALSE	TRUE	TRUE	0	TRUE	TRUE	1	0
FBgn0031390	211	232	235	230	446	462	TRUE	TRUE	TRUE	1	TRUE	TRUE	1	1
FBgn0031391	155	122	116	113	271	235	FALSE	TRUE	TRUE	0	TRUE	TRUE	1	0
FBgn0031392	206	204	188	166	394	370	TRUE	TRUE	TRUE	1	TRUE	TRUE	1	1
FBgn0031393	54	45	35	41	89	86	TRUE	TRUE	TRUE	1	TRUE	TRUE	1	1
FBgn0031395	46	45	31	28	77	73	TRUE	TRUE	TRUE	1	TRUE	TRUE	1	1
FBgn0031397	150	155	126	123	276	278	TRUE	TRUE	TRUE	1	TRUE	TRUE	1	1
FBgn0031398	57	60	52	37	109	97	TRUE	TRUE	TRUE	1	TRUE	TRUE	1	1
FBgn0031399	184	152	150	123	334	275	FALSE	TRUE	FALSE	0	TRUE	TRUE	1	0
FBgn0031401	181	202	175	169	356	371	TRUE	TRUE	TRUE	1	TRUE	TRUE	1	1
FBgn0031403	52	29	28	40	80	69	FALSE	TRUE	TRUE	0	FALSE	TRUE	0	0
FBgn0031406	70	55	38	46	108	101	TRUE	TRUE	TRUE	1	TRUE	TRUE	1	1
FBgn0031407	83	94	43	58	126	152	TRUE	TRUE	TRUE	1	TRUE	TRUE	1	1
FBgn0031409	39	28	31	52	70	80	TRUE	FALSE	TRUE	0	TRUE	FALSE	0	0
FBgn0031410	77	101	89	56	166	157	FALSE	FALSE	TRUE	0	TRUE	FALSE	0	0
FBgn0031412	73	85	74	56	147	141	TRUE	TRUE	TRUE	1	TRUE	TRUE	1	1
FBgn0031413	209	215	208	189	417	404	TRUE	TRUE	TRUE	1	TRUE	TRUE	1	1
FBgn0031414	775	808	670	634	1445	1442	TRUE	TRUE	TRUE	1	TRUE	TRUE	1	1
FBgn0031417	93	95	74	95	167	190	TRUE	TRUE	TRUE	1	TRUE	TRUE	1	1
FBgn0031418	137	135	110	108	247	243	TRUE	TRUE	TRUE	1	TRUE	TRUE	1	1
FBgn0031420	278	232	226	196	504	428	FALSE	TRUE	FALSE	0	TRUE	TRUE	1	0
FBgn0031422	111	121	125	104	236	225	TRUE	TRUE	TRUE	1	TRUE	TRUE	1	1
FBgn0031423	63	60	47	51	110	111	TRUE	TRUE	TRUE	1	TRUE	TRUE	1	1
FBgn0031424	615	591	489	505	1104	1096	TRUE	TRUE	TRUE	1	TRUE	TRUE	1	1
FBgn0031426	107	121	95	95	202	216	TRUE	TRUE	TRUE	1	TRUE	TRUE	1	1
FBgn0031428	301	252	209	249	510	501	FALSE	FALSE	TRUE	0	TRUE	TRUE	1	0
FBgn0031431	119	117	89	103	208	220	TRUE	TRUE	TRUE	1	TRUE	TRUE	1	1
FBgn0031432	194	209	155	142	349	351	TRUE	TRUE	TRUE	1	TRUE	TRUE	1	1
FBgn0031434	69	62	51	49	120	111	TRUE	TRUE	TRUE	1	TRUE	TRUE	1	1
FBgn0031435	118	101	72	83	190	184	TRUE	TRUE	TRUE	1	TRUE	TRUE	1	1
FBgn0031437	36	28	31	25	67	53	TRUE	TRUE	TRUE	1	TRUE	TRUE	1	1
FBgn0031440	124	148	100	95	224	243	TRUE	TRUE	TRUE	1	TRUE	TRUE	1	1
FBgn0031441	81	52	66	47	147	99	FALSE	FALSE	FALSE	0	FALSE	TRUE	0	0
FBgn0031442	46	34	33	43	79	77	TRUE	TRUE	TRUE	1	TRUE	TRUE	1	1
FBgn0031443	134	140	112	100	246	240	TRUE	TRUE	TRUE	1	TRUE	TRUE	1	1
FBgn0031444	96	102	80	76	176	178	TRUE	TRUE	TRUE	1	TRUE	TRUE	1	1
FBgn0031446	104	97	106	87	210	184	TRUE	TRUE	TRUE	1	TRUE	TRUE	1	1
FBgn0031449	266	319	283	253	549	572	FALSE	TRUE	TRUE	0	TRUE	TRUE	1	0
FBgn0031450	202	160	163	139	365	299	FALSE	TRUE	FALSE	0	TRUE	TRUE	1	0
FBgn0031451	63	59	46	35	109	94	TRUE	TRUE	TRUE	1	TRUE	TRUE	1	1
FBgn0031452	19	32	25	30	44	62	FALSE	TRUE	FALSE	0	FALSE	TRUE	0	0
FBgn0031453	110	97	76	96	186	193	TRUE	TRUE	TRUE	1	TRUE	TRUE	1	1
FBgn0031456	251	222	186	199	437	421	TRUE	TRUE	TRUE	1	TRUE	TRUE	1	1
FBgn0031457	92	87	101	78	193	165	TRUE	FALSE	TRUE	0	TRUE	TRUE	1	0
FBgn0031461	162	179	119	115	281	294	TRUE	TRUE	TRUE	1	TRUE	TRUE	1	1
FBgn0031462	10	23	11	26	21	49	FALSE	FALSE	FALSE	0	FALSE	FALSE	0	0
FBgn0031463	117	119	97	114	214	233	TRUE	TRUE	TRUE	1	TRUE	TRUE	1	1
FBgn0031465	164	151	126	114	290	265	TRUE	TRUE	TRUE	1	TRUE	TRUE	1	1
FBgn0031466	28	26	47	36	75	62	TRUE	TRUE	TRUE	1	TRUE	TRUE	1	1
FBgn0031467	35	39	31	36	66	75	TRUE	TRUE	TRUE	1	TRUE	TRUE	1	1
FBgn0031468	55	42	42	58	97	100	TRUE	TRUE	TRUE	1	TRUE	TRUE	1	1
FBgn0031469	133	143	111	89	244	232	TRUE	TRUE	TRUE	1	TRUE	TRUE	1	1
FBgn0031470	68	71	56	55	124	126	TRUE	TRUE	TRUE	1	TRUE	TRUE	1	1
FBgn0031471	103	127	89	109	192	236	TRUE	TRUE	FALSE	0	TRUE	TRUE	1	0
FBgn0031472	93	79	65	60	158	139	TRUE	TRUE	TRUE	1	TRUE	TRUE	1	1
FBgn0031473	141	166	145	125	286	291	TRUE	TRUE	TRUE	1	TRUE	TRUE	1	1
FBgn0031474	174	136	133	119	307	255	FALSE	TRUE	FALSE	0	TRUE	TRUE	1	0
FBgn0031476	65	53	34	36	99	89	TRUE	TRUE	TRUE	1	TRUE	TRUE	1	1
FBgn0031478	112	119	88	109	200	228	TRUE	TRUE	TRUE	1	TRUE	TRUE	1	1
FBgn0031479	64	64	49	53	113	117	TRUE	TRUE	TRUE	1	TRUE	TRUE	1	1
FBgn0031483	106	99	81	63	187	162	TRUE	TRUE	TRUE	1	TRUE	TRUE	1	1
FBgn0031484	41	47	26	44	67	91	TRUE	FALSE	FALSE	0	TRUE	FALSE	0	0
FBgn0031485	41	41	30	34	71	75	TRUE	TRUE	TRUE	1	TRUE	TRUE	1	1
FBgn0031488	220	207	186	168	406	375	TRUE	TRUE	TRUE	1	TRUE	TRUE	1	1
FBgn0031491	33	32	27	24	60	56	TRUE	TRUE	TRUE	1	TRUE	TRUE	1	1
FBgn0031492	50	48	38	44	88	92	TRUE	TRUE	TRUE	1	TRUE	TRUE	1	1
FBgn0031493	129	109	130	109	259	218	TRUE	TRUE	FALSE	0	TRUE	TRUE	1	0
FBgn0031494	44	34	38	38	82	72	TRUE	TRUE	TRUE	1	TRUE	TRUE	1	1
FBgn0031496	104	103	89	90	193	193	TRUE	TRUE	TRUE	1	TRUE	TRUE	1	1
FBgn0031497	49	58	53	68	102	126	TRUE	TRUE	TRUE	1	TRUE	TRUE	1	1
FBgn0031498	22	28	21	25	43	53	TRUE	TRUE	TRUE	1	TRUE	TRUE	1	1
FBgn0031500	142	103	111	88	253	191	FALSE	TRUE	FALSE	0	TRUE	TRUE	1	0
FBgn0031501	41	42	21	18	62	60	TRUE	TRUE	TRUE	1	TRUE	TRUE	1	1
FBgn0031504	45	41	43	33	88	74	TRUE	TRUE	TRUE	1	TRUE	TRUE	1	1
FBgn0031505	80	79	55	75	135	154	TRUE	FALSE	TRUE	0	TRUE	TRUE	1	0
FBgn0031512	56	44	37	33	93	77	TRUE	TRUE	TRUE	1	TRUE	TRUE	1	1
FBgn0031513	190	187	176	175	366	362	TRUE	TRUE	TRUE	1	TRUE	TRUE	1	1
FBgn0031514	217	236	179	193	396	429	TRUE	TRUE	TRUE	1	TRUE	TRUE	1	1
FBgn0031515	225	206	183	197	408	403	TRUE	TRUE	TRUE	1	TRUE	TRUE	1	1
FBgn0031516	40	28	30	23	70	51	TRUE	TRUE	TRUE	1	TRUE	TRUE	1	1
FBgn0031517	69	63	53	49	122	112	TRUE	TRUE	TRUE	1	TRUE	TRUE	1	1
FBgn0031518	198	186	136	167	334	353	TRUE	FALSE	TRUE	0	TRUE	TRUE	1	0
FBgn0031519	107	120	109	108	216	228	TRUE	TRUE	TRUE	1	TRUE	TRUE	1	1
FBgn0031520	91	106	75	71	166	177	TRUE	TRUE	TRUE	1	TRUE	TRUE	1	1
FBgn0031522	31	26	27	35	58	61	TRUE	TRUE	TRUE	1	TRUE	TRUE	1	1
FBgn0031523	65	61	66	60	131	121	TRUE	TRUE	TRUE	1	TRUE	TRUE	1	1
FBgn0031528	153	165	117	131	270	296	TRUE	TRUE	TRUE	1	TRUE	TRUE	1	1
FBgn0031529	71	99	72	55	143	154	FALSE	TRUE	TRUE	0	TRUE	TRUE	1	0
FBgn0031530	230	239	174	195	404	434	TRUE	TRUE	TRUE	1	TRUE	TRUE	1	1
FBgn0031531	88	67	50	83	138	150	TRUE	FALSE	TRUE	0	TRUE	FALSE	0	0
FBgn0031533	136	120	103	127	239	247	TRUE	TRUE	TRUE	1	TRUE	TRUE	1	1
FBgn0031534	112	138	105	105	217	243	TRUE	TRUE	TRUE	1	TRUE	TRUE	1	1
FBgn0031535	75	103	81	57	156	160	FALSE	FALSE	TRUE	0	TRUE	TRUE	1	0
FBgn0031536	34	33	30	34	64	67	TRUE	TRUE	TRUE	1	TRUE	TRUE	1	1
FBgn0031538	41	49	60	50	101	99	TRUE	TRUE	TRUE	1	TRUE	TRUE	1	1
FBgn0031540	107	118	86	76	193	194	TRUE	TRUE	TRUE	1	TRUE	TRUE	1	1
FBgn0031542	99	103	86	80	185	183	TRUE	TRUE	TRUE	1	TRUE	TRUE	1	1
FBgn0031544	95	96	98	94	193	190	TRUE	TRUE	TRUE	1	TRUE	TRUE	1	1
FBgn0031545	149	144	131	132	280	276	TRUE	TRUE	TRUE	1	TRUE	TRUE	1	1
FBgn0031546	192	172	154	165	346	337	TRUE	TRUE	TRUE	1	TRUE	TRUE	1	1
FBgn0031547	125	110	86	94	211	204	TRUE	TRUE	TRUE	1	TRUE	TRUE	1	1
FBgn0031548	222	180	187	157	409	337	FALSE	TRUE	FALSE	0	TRUE	TRUE	1	0
FBgn0031549	226	209	188	176	414	385	TRUE	TRUE	TRUE	1	TRUE	TRUE	1	1
FBgn0031550	166	147	128	133	294	280	TRUE	TRUE	TRUE	1	TRUE	TRUE	1	1
FBgn0031558	28	40	27	19	55	59	TRUE	TRUE	TRUE	1	TRUE	TRUE	1	1
FBgn0031559	24	29	22	20	46	49	TRUE	TRUE	TRUE	1	TRUE	TRUE	1	1
FBgn0031560	29	33	23	32	52	65	TRUE	TRUE	TRUE	1	TRUE	TRUE	1	1
FBgn0031561	55	62	53	40	108	102	TRUE	TRUE	TRUE	1	TRUE	TRUE	1	1
FBgn0031562	75	58	45	42	120	100	TRUE	TRUE	TRUE	1	TRUE	TRUE	1	1
FBgn0031563	41	29	25	20	66	49	TRUE	TRUE	TRUE	1	TRUE	TRUE	1	1
FBgn0031564	40	39	43	38	83	77	TRUE	TRUE	TRUE	1	TRUE	TRUE	1	1
FBgn0031566	165	173	126	115	291	288	TRUE	TRUE	TRUE	1	TRUE	TRUE	1	1
FBgn0031568	325	310	216	257	541	567	TRUE	FALSE	TRUE	0	TRUE	TRUE	1	0
FBgn0031571	790	828	693	719	1483	1547	TRUE	TRUE	TRUE	1	TRUE	TRUE	1	1
FBgn0031573	242	237	201	187	443	424	TRUE	TRUE	TRUE	1	TRUE	TRUE	1	1
FBgn0031574	208	223	186	156	394	379	TRUE	TRUE	TRUE	1	TRUE	TRUE	1	1
FBgn0031575	254	244	211	195	465	439	TRUE	TRUE	TRUE	1	TRUE	TRUE	1	1
FBgn0031579	76	59	41	49	117	108	TRUE	TRUE	TRUE	1	TRUE	TRUE	1	1
FBgn0031580	74	52	50	47	124	99	FALSE	TRUE	TRUE	0	TRUE	TRUE	1	0
FBgn0031585	197	180	177	166	374	346	TRUE	TRUE	TRUE	1	TRUE	TRUE	1	1
FBgn0031589	416	412	353	345	769	757	TRUE	TRUE	TRUE	1	TRUE	TRUE	1	1
FBgn0031590	158	169	133	124	291	293	TRUE	TRUE	TRUE	1	TRUE	TRUE	1	1
FBgn0031592	196	192	148	165	344	357	TRUE	TRUE	TRUE	1	TRUE	TRUE	1	1
FBgn0031596	109	108	93	85	202	193	TRUE	TRUE	TRUE	1	TRUE	TRUE	1	1
FBgn0031597	83	84	72	77	155	161	TRUE	TRUE	TRUE	1	TRUE	TRUE	1	1
FBgn0031598	245	249	214	178	459	427	TRUE	FALSE	TRUE	0	TRUE	TRUE	1	0
FBgn0031600	48	45	41	30	89	75	TRUE	TRUE	TRUE	1	TRUE	TRUE	1	1
FBgn0031601	51	49	45	40	96	89	TRUE	TRUE	TRUE	1	TRUE	TRUE	1	1
FBgn0031602	453	395	320	353	773	748	FALSE	TRUE	TRUE	0	TRUE	TRUE	1	0
FBgn0031603	51	41	36	41	87	82	TRUE	TRUE	TRUE	1	TRUE	TRUE	1	1
FBgn0031604	102	112	85	92	187	204	TRUE	TRUE	TRUE	1	TRUE	TRUE	1	1
FBgn0031606	274	236	199	201	473	437	TRUE	TRUE	TRUE	1	TRUE	TRUE	1	1
FBgn0031607	85	105	78	93	163	198	TRUE	TRUE	FALSE	0	TRUE	TRUE	1	0
FBgn0031608	135	120	109	104	244	224	TRUE	TRUE	TRUE	1	TRUE	TRUE	1	1
FBgn0031609	132	141	111	117	243	258	TRUE	TRUE	TRUE	1	TRUE	TRUE	1	1
FBgn0031610	53	80	57	61	110	141	FALSE	TRUE	FALSE	0	FALSE	TRUE	0	0
FBgn0031611	94	92	50	58	144	150	TRUE	TRUE	TRUE	1	TRUE	TRUE	1	1
FBgn0031613	57	41	39	44	96	85	TRUE	TRUE	TRUE	1	TRUE	TRUE	1	1
FBgn0031617	210	169	158	124	368	293	FALSE	FALSE	FALSE	0	TRUE	TRUE	1	0
FBgn0031619	109	110	102	86	211	196	TRUE	TRUE	TRUE	1	TRUE	TRUE	1	1
FBgn0031620	221	247	195	209	416	456	TRUE	TRUE	TRUE	1	TRUE	TRUE	1	1
FBgn0031621	102	105	89	79	191	184	TRUE	TRUE	TRUE	1	TRUE	TRUE	1	1
FBgn0031622	94	92	73	74	167	166	TRUE	TRUE	TRUE	1	TRUE	TRUE	1	1
FBgn0031623	90	84	86	82	176	166	TRUE	TRUE	TRUE	1	TRUE	TRUE	1	1
FBgn0031626	149	184	149	119	298	303	FALSE	FALSE	TRUE	0	TRUE	TRUE	1	0
FBgn0031627	256	283	227	220	483	503	TRUE	TRUE	TRUE	1	TRUE	TRUE	1	1
FBgn0031628	160	152	126	119	286	271	TRUE	TRUE	TRUE	1	TRUE	TRUE	1	1
FBgn0031629	129	146	124	114	253	260	TRUE	TRUE	TRUE	1	TRUE	TRUE	1	1
FBgn0031630	138	145	116	107	254	252	TRUE	TRUE	TRUE	1	TRUE	TRUE	1	1
FBgn0031631	162	132	149	120	311	252	FALSE	FALSE	FALSE	0	TRUE	TRUE	1	0
FBgn0031632	204	186	185	157	389	343	TRUE	TRUE	FALSE	0	TRUE	TRUE	1	0
FBgn0031633	91	98	65	52	156	150	TRUE	TRUE	TRUE	1	TRUE	TRUE	1	1
FBgn0031634	309	300	237	256	546	556	TRUE	TRUE	TRUE	1	TRUE	TRUE	1	1
FBgn0031635	128	157	107	112	235	269	FALSE	TRUE	TRUE	0	TRUE	TRUE	1	0
FBgn0031636	111	108	96	94	207	202	TRUE	TRUE	TRUE	1	TRUE	TRUE	1	1
FBgn0031637	351	340	285	278	636	618	TRUE	TRUE	TRUE	1	TRUE	TRUE	1	1
FBgn0031638	80	90	72	82	152	172	TRUE	TRUE	TRUE	1	TRUE	TRUE	1	1
FBgn0031639	41	45	43	29	84	74	TRUE	TRUE	TRUE	1	TRUE	TRUE	1	1
FBgn0031640	147	157	109	129	256	286	TRUE	TRUE	TRUE	1	TRUE	TRUE	1	1
FBgn0031643	205	225	182	194	387	419	TRUE	TRUE	TRUE	1	TRUE	TRUE	1	1
FBgn0031644	135	153	115	110	250	263	TRUE	TRUE	TRUE	1	TRUE	TRUE	1	1
FBgn0031645	305	294	247	234	552	528	TRUE	TRUE	TRUE	1	TRUE	TRUE	1	1
FBgn0031646	143	136	117	135	260	271	TRUE	TRUE	TRUE	1	TRUE	TRUE	1	1
FBgn0031649	345	324	300	248	645	572	TRUE	FALSE	FALSE	0	TRUE	TRUE	1	0
FBgn0031650	56	57	56	56	112	113	TRUE	TRUE	TRUE	1	TRUE	TRUE	1	1
FBgn0031651	33	45	38	30	71	75	TRUE	TRUE	TRUE	1	TRUE	TRUE	1	1
FBgn0031652	28	38	18	27	46	65	TRUE	TRUE	FALSE	0	TRUE	TRUE	1	0
FBgn0031653	56	44	29	29	85	73	TRUE	TRUE	TRUE	1	TRUE	TRUE	1	1
FBgn0031654	75	78	48	54	123	132	TRUE	TRUE	TRUE	1	TRUE	TRUE	1	1
FBgn0031655	123	150	113	113	236	263	TRUE	TRUE	TRUE	1	TRUE	TRUE	1	1
FBgn0031657	25	33	21	16	46	49	TRUE	TRUE	TRUE	1	TRUE	TRUE	1	1
FBgn0031659	170	144	120	137	290	281	TRUE	TRUE	TRUE	1	TRUE	TRUE	1	1
FBgn0031660	83	72	59	66	142	138	TRUE	TRUE	TRUE	1	TRUE	TRUE	1	1
FBgn0031662	17	27	20	15	37	42	TRUE	TRUE	TRUE	1	FALSE	TRUE	0	0
FBgn0031663	44	58	38	35	82	93	TRUE	TRUE	TRUE	1	TRUE	TRUE	1	1
FBgn0031664	72	71	68	65	140	136	TRUE	TRUE	TRUE	1	TRUE	TRUE	1	1
FBgn0031670	101	98	74	62	175	160	TRUE	TRUE	TRUE	1	TRUE	TRUE	1	1
FBgn0031673	67	43	38	36	105	79	FALSE	TRUE	FALSE	0	FALSE	TRUE	0	0
FBgn0031675	77	86	79	75	156	161	TRUE	TRUE	TRUE	1	TRUE	TRUE	1	1
FBgn0031676	57	66	45	45	102	111	TRUE	TRUE	TRUE	1	TRUE	TRUE	1	1
FBgn0031678	120	115	116	104	236	219	TRUE	TRUE	TRUE	1	TRUE	TRUE	1	1
FBgn0031681	364	370	286	299	650	669	TRUE	TRUE	TRUE	1	TRUE	TRUE	1	1
FBgn0031682	156	180	148	143	304	323	TRUE	TRUE	TRUE	1	TRUE	TRUE	1	1
FBgn0031683	176	193	162	132	338	325	TRUE	FALSE	TRUE	0	TRUE	TRUE	1	0
FBgn0031684	64	53	52	53	116	106	TRUE	TRUE	TRUE	1	TRUE	TRUE	1	1
FBgn0031688	221	191	167	189	388	380	TRUE	TRUE	TRUE	1	TRUE	TRUE	1	1
FBgn0031689	178	159	170	156	348	315	TRUE	TRUE	TRUE	1	TRUE	TRUE	1	1
FBgn0031690	205	226	167	174	372	400	TRUE	TRUE	TRUE	1	TRUE	TRUE	1	1
FBgn0031692	93	110	68	69	161	179	TRUE	TRUE	TRUE	1	TRUE	TRUE	1	1
FBgn0031693	158	165	139	151	297	316	TRUE	TRUE	TRUE	1	TRUE	TRUE	1	1
FBgn0031694	178	193	141	192	319	385	TRUE	FALSE	FALSE	0	TRUE	TRUE	1	0
FBgn0031695	129	113	106	123	235	236	TRUE	TRUE	TRUE	1	TRUE	TRUE	1	1
FBgn0031696	233	230	167	197	400	427	TRUE	TRUE	TRUE	1	TRUE	TRUE	1	1
FBgn0031697	155	161	115	134	270	295	TRUE	TRUE	TRUE	1	TRUE	TRUE	1	1
FBgn0031698	294	293	228	231	522	524	TRUE	TRUE	TRUE	1	TRUE	TRUE	1	1
FBgn0031700	65	46	55	42	120	88	FALSE	TRUE	FALSE	0	TRUE	TRUE	1	0
FBgn0031701	70	58	52	57	122	115	TRUE	TRUE	TRUE	1	TRUE	TRUE	1	1
FBgn0031702	233	238	194	179	427	417	TRUE	TRUE	TRUE	1	TRUE	TRUE	1	1
FBgn0031703	265	230	229	186	494	416	TRUE	FALSE	FALSE	0	TRUE	TRUE	1	0
FBgn0031707	73	62	45	47	118	109	TRUE	TRUE	TRUE	1	TRUE	TRUE	1	1
FBgn0031708	45	49	32	35	77	84	TRUE	TRUE	TRUE	1	TRUE	TRUE	1	1
FBgn0031710	163	188	155	155	318	343	TRUE	TRUE	TRUE	1	TRUE	TRUE	1	1
FBgn0031711	90	72	86	67	176	139	TRUE	TRUE	FALSE	0	TRUE	TRUE	1	0
FBgn0031713	143	127	98	103	241	230	TRUE	TRUE	TRUE	1	TRUE	TRUE	1	1
FBgn0031715	59	52	47	43	106	95	TRUE	TRUE	TRUE	1	TRUE	TRUE	1	1
FBgn0031716	140	163	96	125	236	288	TRUE	FALSE	FALSE	0	TRUE	TRUE	1	0
FBgn0031717	169	148	128	150	297	298	TRUE	TRUE	TRUE	1	TRUE	TRUE	1	1
FBgn0031718	67	90	75	59	142	149	FALSE	TRUE	TRUE	0	TRUE	TRUE	1	0
FBgn0031719	54	80	72	65	126	145	FALSE	TRUE	TRUE	0	TRUE	TRUE	1	0
FBgn0031720	67	53	66	71	133	124	TRUE	TRUE	TRUE	1	TRUE	TRUE	1	1
FBgn0031721	59	60	50	49	109	109	TRUE	TRUE	TRUE	1	TRUE	TRUE	1	1
FBgn0031722	88	94	76	80	164	174	TRUE	TRUE	TRUE	1	TRUE	TRUE	1	1
FBgn0031723	99	98	83	104	182	202	TRUE	TRUE	TRUE	1	TRUE	TRUE	1	1
FBgn0031724	129	127	98	103	227	230	TRUE	TRUE	TRUE	1	TRUE	TRUE	1	1
FBgn0031725	296	314	253	253	549	567	TRUE	TRUE	TRUE	1	TRUE	TRUE	1	1
FBgn0031726	222	254	187	187	409	441	TRUE	TRUE	TRUE	1	TRUE	TRUE	1	1
FBgn0031728	166	159	125	142	291	301	TRUE	TRUE	TRUE	1	TRUE	TRUE	1	1
FBgn0031729	69	79	71	71	140	150	TRUE	TRUE	TRUE	1	TRUE	TRUE	1	1
FBgn0031730	210	228	187	183	397	411	TRUE	TRUE	TRUE	1	TRUE	TRUE	1	1
FBgn0031732	201	248	169	184	370	432	FALSE	TRUE	FALSE	0	TRUE	TRUE	1	0
FBgn0031733	142	135	113	116	255	251	TRUE	TRUE	TRUE	1	TRUE	TRUE	1	1
FBgn0031734	305	311	283	282	588	593	TRUE	TRUE	TRUE	1	TRUE	TRUE	1	1
FBgn0031735	134	115	91	115	225	230	TRUE	TRUE	TRUE	1	TRUE	TRUE	1	1
FBgn0031736	336	332	270	285	606	617	TRUE	TRUE	TRUE	1	TRUE	TRUE	1	1
FBgn0031737	172	173	113	136	285	309	TRUE	TRUE	TRUE	1	TRUE	TRUE	1	1
FBgn0031738	412	433	347	381	759	814	TRUE	TRUE	TRUE	1	TRUE	TRUE	1	1
FBgn0031739	139	123	110	108	249	231	TRUE	TRUE	TRUE	1	TRUE	TRUE	1	1
FBgn0031740	168	162	132	116	300	278	TRUE	TRUE	TRUE	1	TRUE	TRUE	1	1
FBgn0031741	266	236	175	206	441	442	TRUE	TRUE	TRUE	1	TRUE	TRUE	1	1
FBgn0031745	196	198	182	149	378	347	TRUE	FALSE	TRUE	0	TRUE	TRUE	1	0
FBgn0031746	35	34	32	31	67	65	TRUE	TRUE	TRUE	1	TRUE	TRUE	1	1
FBgn0031747	165	161	115	155	280	316	TRUE	FALSE	TRUE	0	TRUE	TRUE	1	0
FBgn0031749	80	80	53	55	133	135	TRUE	TRUE	TRUE	1	TRUE	TRUE	1	1
FBgn0031751	96	68	52	48	148	116	FALSE	TRUE	FALSE	0	TRUE	TRUE	1	0
FBgn0031752	326	354	269	293	595	647	TRUE	TRUE	TRUE	1	TRUE	TRUE	1	1
FBgn0031753	100	89	80	59	180	148	TRUE	FALSE	FALSE	0	TRUE	TRUE	1	0
FBgn0031756	275	252	185	187	460	439	TRUE	TRUE	TRUE	1	TRUE	TRUE	1	1
FBgn0031757	116	110	90	84	206	194	TRUE	TRUE	TRUE	1	TRUE	TRUE	1	1
FBgn0031759	320	397	264	238	584	635	FALSE	TRUE	TRUE	0	TRUE	TRUE	1	0
FBgn0031760	220	220	223	198	443	418	TRUE	TRUE	TRUE	1	TRUE	TRUE	1	1
FBgn0031762	365	400	334	315	699	715	TRUE	TRUE	TRUE	1	TRUE	TRUE	1	1
FBgn0031763	76	92	68	68	144	160	TRUE	TRUE	TRUE	1	TRUE	TRUE	1	1
FBgn0031764	163	149	105	111	268	260	TRUE	TRUE	TRUE	1	TRUE	TRUE	1	1
FBgn0031765	297	269	238	234	535	503	TRUE	TRUE	TRUE	1	TRUE	TRUE	1	1
FBgn0031766	76	48	43	45	119	93	FALSE	TRUE	FALSE	0	FALSE	TRUE	0	0
FBgn0031768	112	100	75	79	187	179	TRUE	TRUE	TRUE	1	TRUE	TRUE	1	1
FBgn0031769	164	222	152	182	316	404	FALSE	TRUE	FALSE	0	TRUE	TRUE	1	0
FBgn0031770	231	233	192	203	423	436	TRUE	TRUE	TRUE	1	TRUE	TRUE	1	1
FBgn0031771	107	105	89	84	196	189	TRUE	TRUE	TRUE	1	TRUE	TRUE	1	1
FBgn0031772	54	48	31	38	85	86	TRUE	TRUE	TRUE	1	TRUE	TRUE	1	1
FBgn0031773	90	103	76	78	166	181	TRUE	TRUE	TRUE	1	TRUE	TRUE	1	1
FBgn0031774	120	112	98	85	218	197	TRUE	TRUE	TRUE	1	TRUE	TRUE	1	1
FBgn0031775	73	95	56	53	129	148	TRUE	TRUE	TRUE	1	TRUE	TRUE	1	1
FBgn0031776	45	33	34	28	79	61	TRUE	TRUE	TRUE	1	TRUE	TRUE	1	1
FBgn0031777	55	48	45	41	100	89	TRUE	TRUE	TRUE	1	TRUE	TRUE	1	1
FBgn0031778	70	69	64	40	134	109	TRUE	FALSE	TRUE	0	TRUE	FALSE	0	0
FBgn0031779	182	176	134	158	316	334	TRUE	TRUE	TRUE	1	TRUE	TRUE	1	1
FBgn0031782	125	141	97	121	222	262	TRUE	TRUE	FALSE	0	TRUE	TRUE	1	0
FBgn0031784	112	113	99	85	211	198	TRUE	TRUE	TRUE	1	TRUE	TRUE	1	1
FBgn0031785	371	360	293	265	664	625	TRUE	TRUE	TRUE	1	TRUE	TRUE	1	1
FBgn0031786	83	94	52	73	135	167	TRUE	FALSE	FALSE	0	TRUE	TRUE	1	0
FBgn0031791	79	98	60	73	139	171	TRUE	TRUE	FALSE	0	TRUE	TRUE	1	0
FBgn0031792	100	93	67	68	167	161	TRUE	TRUE	TRUE	1	TRUE	TRUE	1	1
FBgn0031799	323	355	295	280	618	635	TRUE	TRUE	TRUE	1	TRUE	TRUE	1	1
FBgn0031800	181	213	131	179	312	392	TRUE	FALSE	FALSE	0	TRUE	TRUE	1	0
FBgn0031801	85	77	63	61	148	138	TRUE	TRUE	TRUE	1	TRUE	TRUE	1	1
FBgn0031802	206	203	153	156	359	359	TRUE	TRUE	TRUE	1	TRUE	TRUE	1	1
FBgn0031803	179	206	136	136	315	342	TRUE	TRUE	TRUE	1	TRUE	TRUE	1	1
FBgn0031804	113	130	99	99	212	229	TRUE	TRUE	TRUE	1	TRUE	TRUE	1	1
FBgn0031805	149	149	127	116	276	265	TRUE	TRUE	TRUE	1	TRUE	TRUE	1	1
FBgn0031808	126	126	106	112	232	238	TRUE	TRUE	TRUE	1	TRUE	TRUE	1	1
FBgn0031811	282	304	207	198	489	502	TRUE	TRUE	TRUE	1	TRUE	TRUE	1	1
FBgn0031813	327	298	251	247	578	545	TRUE	TRUE	TRUE	1	TRUE	TRUE	1	1
FBgn0031814	315	335	293	271	608	606	TRUE	TRUE	TRUE	1	TRUE	TRUE	1	1
FBgn0031815	182	211	184	156	366	367	TRUE	TRUE	TRUE	1	TRUE	TRUE	1	1
FBgn0031816	196	223	171	171	367	394	TRUE	TRUE	TRUE	1	TRUE	TRUE	1	1
FBgn0031817	91	82	58	60	149	142	TRUE	TRUE	TRUE	1	TRUE	TRUE	1	1
FBgn0031818	185	242	140	161	325	403	FALSE	TRUE	FALSE	0	TRUE	TRUE	1	0
FBgn0031820	366	348	308	290	674	638	TRUE	TRUE	TRUE	1	TRUE	TRUE	1	1
FBgn0031821	114	86	69	58	183	144	FALSE	TRUE	FALSE	0	TRUE	TRUE	1	0
FBgn0031822	57	58	47	55	104	113	TRUE	TRUE	TRUE	1	TRUE	TRUE	1	1
FBgn0031824	159	137	132	138	291	275	TRUE	TRUE	TRUE	1	TRUE	TRUE	1	1
FBgn0031826	123	131	100	113	223	244	TRUE	TRUE	TRUE	1	TRUE	TRUE	1	1
FBgn0031829	131	141	102	106	233	247	TRUE	TRUE	TRUE	1	TRUE	TRUE	1	1
FBgn0031830	56	62	48	52	104	114	TRUE	TRUE	TRUE	1	TRUE	TRUE	1	1
FBgn0031832	139	132	116	121	255	253	TRUE	TRUE	TRUE	1	TRUE	TRUE	1	1
FBgn0031834	107	138	92	97	199	235	FALSE	TRUE	FALSE	0	TRUE	TRUE	1	0
FBgn0031835	798	830	687	627	1485	1457	TRUE	TRUE	TRUE	1	TRUE	TRUE	1	1
FBgn0031836	234	234	213	203	447	437	TRUE	TRUE	TRUE	1	TRUE	TRUE	1	1
FBgn0031837	143	143	102	139	245	282	TRUE	FALSE	TRUE	0	TRUE	TRUE	1	0
FBgn0031844	37	29	25	19	62	48	TRUE	TRUE	TRUE	1	TRUE	TRUE	1	1
FBgn0031848	51	61	31	43	82	104	TRUE	TRUE	TRUE	1	TRUE	TRUE	1	1
FBgn0031849	108	120	82	94	190	214	TRUE	TRUE	TRUE	1	TRUE	TRUE	1	1
FBgn0031850	397	414	322	340	719	754	TRUE	TRUE	TRUE	1	TRUE	TRUE	1	1
FBgn0031853	252	215	181	185	433	400	FALSE	TRUE	TRUE	0	TRUE	TRUE	1	0
FBgn0031854	293	297	258	229	551	526	TRUE	TRUE	TRUE	1	TRUE	TRUE	1	1
FBgn0031855	147	140	133	141	280	281	TRUE	TRUE	TRUE	1	TRUE	TRUE	1	1
FBgn0031856	142	166	119	137	261	303	TRUE	TRUE	FALSE	0	TRUE	TRUE	1	0
FBgn0031857	1004	985	827	856	1831	1841	TRUE	TRUE	TRUE	1	TRUE	TRUE	1	1
FBgn0031858	364	407	308	307	672	714	TRUE	TRUE	TRUE	1	TRUE	TRUE	1	1
FBgn0031859	117	116	69	77	186	193	TRUE	TRUE	TRUE	1	TRUE	TRUE	1	1
FBgn0031860	115	124	97	99	212	223	TRUE	TRUE	TRUE	1	TRUE	TRUE	1	1
FBgn0031861	110	90	84	82	194	172	TRUE	TRUE	TRUE	1	TRUE	TRUE	1	1
FBgn0031865	226	249	219	188	445	437	TRUE	TRUE	TRUE	1	TRUE	TRUE	1	1
FBgn0031866	462	440	384	406	846	846	TRUE	TRUE	TRUE	1	TRUE	TRUE	1	1
FBgn0031868	187	161	121	132	308	293	TRUE	TRUE	TRUE	1	TRUE	TRUE	1	1
FBgn0031869	416	448	357	409	773	857	TRUE	FALSE	FALSE	0	TRUE	TRUE	1	0
FBgn0031871	139	174	130	111	269	285	FALSE	TRUE	TRUE	0	TRUE	TRUE	1	0
FBgn0031872	159	172	130	109	289	281	TRUE	TRUE	TRUE	1	TRUE	TRUE	1	1
FBgn0031874	207	192	148	172	355	364	TRUE	TRUE	TRUE	1	TRUE	TRUE	1	1
FBgn0031875	159	126	127	117	286	243	FALSE	TRUE	FALSE	0	TRUE	TRUE	1	0
FBgn0031876	55	61	43	49	98	110	TRUE	TRUE	TRUE	1	TRUE	TRUE	1	1
FBgn0031877	49	41	37	41	86	82	TRUE	TRUE	TRUE	1	TRUE	TRUE	1	1
FBgn0031878	147	183	108	128	255	311	FALSE	TRUE	FALSE	0	TRUE	TRUE	1	0
FBgn0031879	1076	1032	830	876	1906	1908	TRUE	TRUE	TRUE	1	TRUE	TRUE	1	1
FBgn0031881	65	77	55	79	120	156	TRUE	FALSE	FALSE	0	TRUE	TRUE	1	0
FBgn0031882	191	148	141	125	332	273	FALSE	TRUE	FALSE	0	TRUE	TRUE	1	0
FBgn0031883	166	172	123	113	289	285	TRUE	TRUE	TRUE	1	TRUE	TRUE	1	1
FBgn0031885	264	272	216	205	480	477	TRUE	TRUE	TRUE	1	TRUE	TRUE	1	1
FBgn0031886	106	129	97	88	203	217	TRUE	TRUE	TRUE	1	TRUE	TRUE	1	1
FBgn0031887	91	110	90	107	181	217	TRUE	TRUE	FALSE	0	TRUE	TRUE	1	0
FBgn0031888	243	241	234	226	477	467	TRUE	TRUE	TRUE	1	TRUE	TRUE	1	1
FBgn0031893	196	231	182	178	378	409	FALSE	TRUE	TRUE	0	TRUE	TRUE	1	0
FBgn0031894	221	226	182	174	403	400	TRUE	TRUE	TRUE	1	TRUE	TRUE	1	1
FBgn0031895	236	206	184	168	420	374	TRUE	TRUE	TRUE	1	TRUE	TRUE	1	1
FBgn0031896	171	195	170	152	341	347	TRUE	TRUE	TRUE	1	TRUE	TRUE	1	1
FBgn0031897	537	511	420	479	957	990	TRUE	FALSE	TRUE	0	TRUE	TRUE	1	0
FBgn0031900	206	187	193	161	399	348	TRUE	FALSE	FALSE	0	TRUE	TRUE	1	0
FBgn0031902	174	185	143	173	317	358	TRUE	TRUE	TRUE	1	TRUE	TRUE	1	1
FBgn0031903	228	219	162	158	390	377	TRUE	TRUE	TRUE	1	TRUE	TRUE	1	1
FBgn0031904	214	215	177	187	391	402	TRUE	TRUE	TRUE	1	TRUE	TRUE	1	1
FBgn0031905	234	199	181	171	415	370	TRUE	TRUE	TRUE	1	TRUE	TRUE	1	1
FBgn0031906	184	206	160	154	344	360	TRUE	TRUE	TRUE	1	TRUE	TRUE	1	1
FBgn0031907	187	204	175	166	362	370	TRUE	TRUE	TRUE	1	TRUE	TRUE	1	1
FBgn0031908	82	71	60	68	142	139	TRUE	TRUE	TRUE	1	TRUE	TRUE	1	1
FBgn0031909	119	106	81	99	200	205	TRUE	TRUE	TRUE	1	TRUE	TRUE	1	1
FBgn0031910	97	111	74	93	171	204	TRUE	TRUE	FALSE	0	TRUE	TRUE	1	0
FBgn0031913	176	164	144	160	320	324	TRUE	TRUE	TRUE	1	TRUE	TRUE	1	1
FBgn0031914	306	261	226	219	532	480	FALSE	TRUE	TRUE	0	TRUE	TRUE	1	0
FBgn0031918	103	100	86	92	189	192	TRUE	TRUE	TRUE	1	TRUE	TRUE	1	1
FBgn0031920	135	148	135	113	270	261	TRUE	TRUE	TRUE	1	TRUE	TRUE	1	1
FBgn0031925	224	252	230	184	454	436	TRUE	FALSE	TRUE	0	TRUE	TRUE	1	0
FBgn0031926	239	286	228	247	467	533	FALSE	TRUE	FALSE	0	TRUE	TRUE	1	0
FBgn0031929	103	116	81	95	184	211	TRUE	TRUE	TRUE	1	TRUE	TRUE	1	1
FBgn0031930	143	152	131	112	274	264	TRUE	TRUE	TRUE	1	TRUE	TRUE	1	1
FBgn0031935	225	197	196	182	421	379	TRUE	TRUE	TRUE	1	TRUE	TRUE	1	1
FBgn0031936	261	256	229	184	490	440	TRUE	FALSE	TRUE	0	TRUE	TRUE	1	0
FBgn0031937	213	234	177	189	390	423	TRUE	TRUE	TRUE	1	TRUE	TRUE	1	1
FBgn0031939	241	204	197	205	438	409	FALSE	TRUE	TRUE	0	TRUE	TRUE	1	0
FBgn0031940	87	77	50	68	137	145	TRUE	TRUE	TRUE	1	TRUE	TRUE	1	1
FBgn0031941	76	84	63	53	139	137	TRUE	TRUE	TRUE	1	TRUE	TRUE	1	1
FBgn0031942	98	85	65	71	163	156	TRUE	TRUE	TRUE	1	TRUE	TRUE	1	1
FBgn0031945	259	228	194	191	453	419	TRUE	TRUE	TRUE	1	TRUE	TRUE	1	1
FBgn0031946	79	90	76	66	155	156	TRUE	TRUE	TRUE	1	TRUE	TRUE	1	1
FBgn0031947	285	261	225	189	510	450	TRUE	FALSE	FALSE	0	TRUE	TRUE	1	0
FBgn0031948	255	239	213	202	468	441	TRUE	TRUE	TRUE	1	TRUE	TRUE	1	1
FBgn0031950	162	152	157	122	319	274	TRUE	FALSE	FALSE	0	TRUE	TRUE	1	0
FBgn0031951	78	91	83	86	161	177	TRUE	TRUE	TRUE	1	TRUE	TRUE	1	1
FBgn0031952	410	391	374	325	784	716	TRUE	FALSE	FALSE	0	TRUE	TRUE	1	0
FBgn0031954	64	66	48	60	112	126	TRUE	TRUE	TRUE	1	TRUE	TRUE	1	1
FBgn0031955	420	449	385	410	805	859	TRUE	TRUE	TRUE	1	TRUE	TRUE	1	1
FBgn0031957	33	41	14	29	47	70	TRUE	FALSE	FALSE	0	TRUE	FALSE	0	0
FBgn0031959	204	175	162	148	366	323	TRUE	TRUE	TRUE	1	TRUE	TRUE	1	1
FBgn0031961	227	202	195	195	422	397	TRUE	TRUE	TRUE	1	TRUE	TRUE	1	1
FBgn0031968	121	122	121	110	242	232	TRUE	TRUE	TRUE	1	TRUE	TRUE	1	1
FBgn0031969	266	220	180	170	446	390	FALSE	TRUE	FALSE	0	TRUE	TRUE	1	0
FBgn0031970	141	150	116	103	257	253	TRUE	TRUE	TRUE	1	TRUE	TRUE	1	1
FBgn0031971	67	75	58	49	125	124	TRUE	TRUE	TRUE	1	TRUE	TRUE	1	1
FBgn0031972	147	136	98	130	245	266	TRUE	FALSE	TRUE	0	TRUE	TRUE	1	0
FBgn0031973	137	122	128	91	265	213	TRUE	FALSE	FALSE	0	TRUE	TRUE	1	0
FBgn0031974	72	60	48	49	120	109	TRUE	TRUE	TRUE	1	TRUE	TRUE	1	1
FBgn0031975	304	248	264	270	568	518	FALSE	TRUE	TRUE	0	TRUE	TRUE	1	0
FBgn0031976	145	129	125	109	270	238	TRUE	TRUE	TRUE	1	TRUE	TRUE	1	1
FBgn0031977	36	27	23	19	59	46	TRUE	TRUE	TRUE	1	TRUE	TRUE	1	1
FBgn0031979	63	53	41	63	104	116	TRUE	FALSE	TRUE	0	TRUE	FALSE	0	0
FBgn0031980	30	54	31	30	61	84	FALSE	TRUE	FALSE	0	FALSE	TRUE	0	0
FBgn0031981	810	834	641	634	1451	1468	TRUE	TRUE	TRUE	1	TRUE	TRUE	1	1
FBgn0031985	454	489	390	398	844	887	TRUE	TRUE	TRUE	1	TRUE	TRUE	1	1
FBgn0031986	126	126	103	129	229	255	TRUE	TRUE	TRUE	1	TRUE	TRUE	1	1
FBgn0031987	46	47	52	37	98	84	TRUE	TRUE	TRUE	1	TRUE	TRUE	1	1
FBgn0031988	222	225	190	198	412	423	TRUE	TRUE	TRUE	1	TRUE	TRUE	1	1
FBgn0031990	572	596	481	515	1053	1111	TRUE	TRUE	TRUE	1	TRUE	TRUE	1	1
FBgn0031992	42	45	50	47	92	92	TRUE	TRUE	TRUE	1	TRUE	TRUE	1	1
FBgn0031995	242	216	202	159	444	375	TRUE	FALSE	FALSE	0	TRUE	TRUE	1	0
FBgn0031996	140	155	129	114	269	269	TRUE	TRUE	TRUE	1	TRUE	TRUE	1	1
FBgn0031997	89	99	83	91	172	190	TRUE	TRUE	TRUE	1	TRUE	TRUE	1	1
FBgn0031998	105	86	79	78	184	164	TRUE	TRUE	TRUE	1	TRUE	TRUE	1	1
FBgn0031999	205	187	149	160	354	347	TRUE	TRUE	TRUE	1	TRUE	TRUE	1	1
FBgn0032000	16	29	18	33	34	62	FALSE	FALSE	FALSE	0	FALSE	FALSE	0	0
FBgn0032001	85	78	63	60	148	138	TRUE	TRUE	TRUE	1	TRUE	TRUE	1	1
FBgn0032002	71	87	61	49	132	136	TRUE	TRUE	TRUE	1	TRUE	TRUE	1	1
FBgn0032003	28	44	43	43	71	87	FALSE	TRUE	TRUE	0	FALSE	TRUE	0	0
FBgn0032004	62	62	44	62	106	124	TRUE	FALSE	TRUE	0	TRUE	TRUE	1	0
FBgn0032005	157	195	147	145	304	340	FALSE	TRUE	TRUE	0	TRUE	TRUE	1	0
FBgn0032006	792	774	699	641	1491	1415	TRUE	TRUE	TRUE	1	TRUE	TRUE	1	1
FBgn0032008	46	58	42	44	88	102	TRUE	TRUE	TRUE	1	TRUE	TRUE	1	1
FBgn0032010	661	616	503	484	1164	1100	TRUE	TRUE	TRUE	1	TRUE	TRUE	1	1
FBgn0032013	163	134	139	126	302	260	TRUE	TRUE	FALSE	0	TRUE	TRUE	1	0
FBgn0032014	72	83	51	67	123	150	TRUE	TRUE	TRUE	1	TRUE	TRUE	1	1
FBgn0032015	91	73	69	62	160	135	TRUE	TRUE	TRUE	1	TRUE	TRUE	1	1
FBgn0032016	139	118	108	105	247	223	TRUE	TRUE	TRUE	1	TRUE	TRUE	1	1
FBgn0032017	123	102	108	88	231	190	TRUE	TRUE	FALSE	0	TRUE	TRUE	1	0
FBgn0032018	376	354	272	318	648	672	TRUE	FALSE	TRUE	0	TRUE	TRUE	1	0
FBgn0032020	52	50	50	48	102	98	TRUE	TRUE	TRUE	1	TRUE	TRUE	1	1
FBgn0032021	103	101	78	79	181	180	TRUE	TRUE	TRUE	1	TRUE	TRUE	1	1
FBgn0032022	181	179	157	138	338	317	TRUE	TRUE	TRUE	1	TRUE	TRUE	1	1
FBgn0032023	136	157	111	116	247	273	TRUE	TRUE	TRUE	1	TRUE	TRUE	1	1
FBgn0032025	193	176	131	146	324	322	TRUE	TRUE	TRUE	1	TRUE	TRUE	1	1
FBgn0032026	400	454	357	340	757	794	FALSE	TRUE	TRUE	0	TRUE	TRUE	1	0
FBgn0032029	186	152	144	114	330	266	FALSE	FALSE	FALSE	0	TRUE	TRUE	1	0
FBgn0032030	43	47	41	30	84	77	TRUE	TRUE	TRUE	1	TRUE	TRUE	1	1
FBgn0032031	80	63	68	60	148	123	TRUE	TRUE	TRUE	1	TRUE	TRUE	1	1
FBgn0032032	64	67	58	63	122	130	TRUE	TRUE	TRUE	1	TRUE	TRUE	1	1
FBgn0032033	26	18	21	11	47	29	TRUE	TRUE	FALSE	0	TRUE	FALSE	0	0
FBgn0032034	40	39	30	24	70	63	TRUE	TRUE	TRUE	1	TRUE	TRUE	1	1
FBgn0032036	215	248	209	176	424	424	TRUE	TRUE	TRUE	1	TRUE	TRUE	1	1
FBgn0032039	117	120	111	117	228	237	TRUE	TRUE	TRUE	1	TRUE	TRUE	1	1
FBgn0032040	96	99	88	73	184	172	TRUE	TRUE	TRUE	1	TRUE	TRUE	1	1
FBgn0032042	201	205	161	154	362	359	TRUE	TRUE	TRUE	1	TRUE	TRUE	1	1
FBgn0032047	103	113	102	88	205	201	TRUE	TRUE	TRUE	1	TRUE	TRUE	1	1
FBgn0032048	188	182	128	152	316	334	TRUE	TRUE	TRUE	1	TRUE	TRUE	1	1
FBgn0032049	147	160	152	111	299	271	TRUE	FALSE	TRUE	0	TRUE	TRUE	1	0
FBgn0032050	174	190	148	159	322	349	TRUE	TRUE	TRUE	1	TRUE	TRUE	1	1
FBgn0032051	156	124	132	101	288	225	FALSE	FALSE	FALSE	0	TRUE	TRUE	1	0
FBgn0032052	95	97	84	76	179	173	TRUE	TRUE	TRUE	1	TRUE	TRUE	1	1
FBgn0032053	34	28	21	23	55	51	TRUE	TRUE	TRUE	1	TRUE	TRUE	1	1
FBgn0032054	41	48	42	31	83	79	TRUE	TRUE	TRUE	1	TRUE	TRUE	1	1
FBgn0032055	203	188	154	190	357	378	TRUE	FALSE	TRUE	0	TRUE	TRUE	1	0
FBgn0032057	80	75	59	57	139	132	TRUE	TRUE	TRUE	1	TRUE	TRUE	1	1
FBgn0032058	103	123	92	94	195	217	TRUE	TRUE	TRUE	1	TRUE	TRUE	1	1
FBgn0032061	179	175	144	139	323	314	TRUE	TRUE	TRUE	1	TRUE	TRUE	1	1
FBgn0032065	78	85	67	68	145	153	TRUE	TRUE	TRUE	1	TRUE	TRUE	1	1
FBgn0032066	298	305	262	281	560	586	TRUE	TRUE	TRUE	1	TRUE	TRUE	1	1
FBgn0032067	305	308	296	254	601	562	TRUE	FALSE	TRUE	0	TRUE	TRUE	1	0
FBgn0032068	271	246	246	251	517	497	TRUE	TRUE	TRUE	1	TRUE	TRUE	1	1
FBgn0032069	347	284	291	263	638	547	FALSE	TRUE	FALSE	0	TRUE	TRUE	1	0
FBgn0032074	89	91	83	71	172	162	TRUE	TRUE	TRUE	1	TRUE	TRUE	1	1
FBgn0032075	50	48	38	40	88	88	TRUE	TRUE	TRUE	1	TRUE	TRUE	1	1
FBgn0032076	103	106	89	125	192	231	TRUE	FALSE	FALSE	0	TRUE	TRUE	1	0
FBgn0032077	82	86	65	88	147	174	TRUE	FALSE	TRUE	0	TRUE	TRUE	1	0
FBgn0032078	194	211	174	178	368	389	TRUE	TRUE	TRUE	1	TRUE	TRUE	1	1
FBgn0032079	162	190	156	157	318	347	TRUE	TRUE	TRUE	1	TRUE	TRUE	1	1
FBgn0032080	313	309	268	264	581	573	TRUE	TRUE	TRUE	1	TRUE	TRUE	1	1
FBgn0032082	171	157	113	164	284	321	TRUE	FALSE	TRUE	0	TRUE	TRUE	1	0
FBgn0032083	243	311	226	175	469	486	FALSE	FALSE	TRUE	0	TRUE	TRUE	1	0
FBgn0032084	226	252	224	197	450	449	TRUE	TRUE	TRUE	1	TRUE	TRUE	1	1
FBgn0032085	162	171	127	126	289	297	TRUE	TRUE	TRUE	1	TRUE	TRUE	1	1
FBgn0032087	83	78	60	54	143	132	TRUE	TRUE	TRUE	1	TRUE	TRUE	1	1
FBgn0032088	53	62	44	52	97	114	TRUE	TRUE	TRUE	1	TRUE	TRUE	1	1
FBgn0032090	56	52	38	48	94	100	TRUE	TRUE	TRUE	1	TRUE	TRUE	1	1
FBgn0032094	98	92	72	72	170	164	TRUE	TRUE	TRUE	1	TRUE	TRUE	1	1
FBgn0032095	310	317	269	288	579	605	TRUE	TRUE	TRUE	1	TRUE	TRUE	1	1
FBgn0032096	158	137	124	130	282	267	TRUE	TRUE	TRUE	1	TRUE	TRUE	1	1
FBgn0032100	82	118	87	76	169	194	FALSE	TRUE	TRUE	0	TRUE	TRUE	1	0
FBgn0032101	88	84	62	70	150	154	TRUE	TRUE	TRUE	1	TRUE	TRUE	1	1
FBgn0032104	70	70	65	47	135	117	TRUE	TRUE	TRUE	1	TRUE	TRUE	1	1
FBgn0032105	98	104	82	74	180	178	TRUE	TRUE	TRUE	1	TRUE	TRUE	1	1
FBgn0032109	240	219	190	170	430	389	TRUE	TRUE	TRUE	1	TRUE	TRUE	1	1
FBgn0032110	179	186	152	171	331	357	TRUE	TRUE	TRUE	1	TRUE	TRUE	1	1
FBgn0032111	19	24	16	18	35	42	TRUE	TRUE	TRUE	1	TRUE	TRUE	1	1
FBgn0032115	101	91	74	62	175	153	TRUE	TRUE	TRUE	1	TRUE	TRUE	1	1
FBgn0032116	290	270	237	217	527	487	TRUE	TRUE	TRUE	1	TRUE	TRUE	1	1
FBgn0032117	129	154	118	118	247	272	TRUE	TRUE	TRUE	1	TRUE	TRUE	1	1
FBgn0032119	110	116	97	84	207	200	TRUE	TRUE	TRUE	1	TRUE	TRUE	1	1
FBgn0032120	743	742	456	422	1199	1164	TRUE	TRUE	TRUE	1	TRUE	TRUE	1	1
FBgn0032122	207	195	116	92	323	287	TRUE	TRUE	TRUE	1	TRUE	TRUE	1	1
FBgn0032123	769	789	386	424	1155	1213	TRUE	TRUE	TRUE	1	TRUE	TRUE	1	1
FBgn0032124	239	322	158	131	397	453	FALSE	TRUE	FALSE	0	TRUE	TRUE	1	0
FBgn0032125	164	190	78	64	242	254	TRUE	TRUE	TRUE	1	TRUE	TRUE	1	1
FBgn0032126	141	149	77	69	218	218	TRUE	TRUE	TRUE	1	TRUE	TRUE	1	1
FBgn0032127	221	219	111	100	332	319	TRUE	TRUE	TRUE	1	TRUE	TRUE	1	1
FBgn0032129	1127	1149	537	527	1664	1676	TRUE	TRUE	TRUE	1	TRUE	TRUE	1	1
FBgn0032130	364	370	246	197	610	567	TRUE	FALSE	TRUE	0	TRUE	TRUE	1	0
FBgn0032131	277	235	171	163	448	398	FALSE	TRUE	FALSE	0	TRUE	TRUE	1	0
FBgn0032132	145	172	131	137	276	309	TRUE	TRUE	TRUE	1	TRUE	TRUE	1	1
FBgn0032135	224	226	206	179	430	405	TRUE	TRUE	TRUE	1	TRUE	TRUE	1	1
FBgn0032136	1043	1064	947	897	1990	1961	TRUE	TRUE	TRUE	1	TRUE	TRUE	1	1
FBgn0032138	194	172	156	151	350	323	TRUE	TRUE	TRUE	1	TRUE	TRUE	1	1
FBgn0032139	95	110	86	77	181	187	TRUE	TRUE	TRUE	1	TRUE	TRUE	1	1
FBgn0032140	103	92	62	84	165	176	TRUE	FALSE	TRUE	0	TRUE	TRUE	1	0
FBgn0032143	113	144	101	135	214	279	FALSE	FALSE	FALSE	0	TRUE	TRUE	1	0
FBgn0032144	121	110	75	101	196	211	TRUE	FALSE	TRUE	0	TRUE	TRUE	1	0
FBgn0032147	61	63	69	46	130	109	TRUE	FALSE	TRUE	0	TRUE	TRUE	1	0
FBgn0032149	26	28	20	19	46	47	TRUE	TRUE	TRUE	1	TRUE	TRUE	1	1
FBgn0032150	58	71	39	50	97	121	TRUE	TRUE	TRUE	1	TRUE	TRUE	1	1
FBgn0032151	516	513	428	406	944	919	TRUE	TRUE	TRUE	1	TRUE	TRUE	1	1
FBgn0032154	124	129	111	102	235	231	TRUE	TRUE	TRUE	1	TRUE	TRUE	1	1
FBgn0032156	256	267	217	228	473	495	TRUE	TRUE	TRUE	1	TRUE	TRUE	1	1
FBgn0032157	319	292	232	260	551	552	TRUE	TRUE	TRUE	1	TRUE	TRUE	1	1
FBgn0032160	113	103	106	117	219	220	TRUE	TRUE	TRUE	1	TRUE	TRUE	1	1
FBgn0032161	115	124	89	83	204	207	TRUE	TRUE	TRUE	1	TRUE	TRUE	1	1
FBgn0032162	81	85	59	48	140	133	TRUE	TRUE	TRUE	1	TRUE	TRUE	1	1
FBgn0032163	176	133	141	129	317	262	FALSE	TRUE	FALSE	0	TRUE	TRUE	1	0
FBgn0032166	70	103	86	77	156	180	FALSE	TRUE	TRUE	0	TRUE	TRUE	1	0
FBgn0032167	57	81	48	74	105	155	FALSE	FALSE	FALSE	0	TRUE	FALSE	0	0
FBgn0032168	90	69	64	77	154	146	TRUE	TRUE	TRUE	1	TRUE	TRUE	1	1
FBgn0032169	43	34	32	34	75	68	TRUE	TRUE	TRUE	1	TRUE	TRUE	1	1
FBgn0032170	80	92	50	65	130	157	TRUE	TRUE	TRUE	1	TRUE	TRUE	1	1
FBgn0032171	52	40	50	40	102	80	TRUE	TRUE	TRUE	1	TRUE	TRUE	1	1
FBgn0032172	169	161	116	109	285	270	TRUE	TRUE	TRUE	1	TRUE	TRUE	1	1
FBgn0032175	295	326	277	270	572	596	TRUE	TRUE	TRUE	1	TRUE	TRUE	1	1
FBgn0032176	282	251	204	206	486	457	TRUE	TRUE	TRUE	1	TRUE	TRUE	1	1
FBgn0032178	161	152	147	149	308	301	TRUE	TRUE	TRUE	1	TRUE	TRUE	1	1
FBgn0032181	122	91	107	103	229	194	FALSE	TRUE	FALSE	0	TRUE	TRUE	1	0
FBgn0032184	67	61	43	50	110	111	TRUE	TRUE	TRUE	1	TRUE	TRUE	1	1
FBgn0032187	622	576	506	503	1128	1079	TRUE	TRUE	TRUE	1	TRUE	TRUE	1	1
FBgn0032188	112	80	72	71	184	151	FALSE	TRUE	FALSE	0	TRUE	TRUE	1	0
FBgn0032189	145	159	138	127	283	286	TRUE	TRUE	TRUE	1	TRUE	TRUE	1	1
FBgn0032191	133	113	102	82	235	195	TRUE	TRUE	FALSE	0	TRUE	TRUE	1	0
FBgn0032192	135	133	147	121	282	254	TRUE	TRUE	TRUE	1	TRUE	TRUE	1	1
FBgn0032193	84	104	87	67	171	171	TRUE	TRUE	TRUE	1	TRUE	TRUE	1	1
FBgn0032194	180	145	130	136	310	281	FALSE	TRUE	TRUE	0	TRUE	TRUE	1	0
FBgn0032195	166	157	121	133	287	290	TRUE	TRUE	TRUE	1	TRUE	TRUE	1	1
FBgn0032196	122	107	106	135	228	242	TRUE	FALSE	TRUE	0	TRUE	TRUE	1	0
FBgn0032197	174	173	132	138	306	311	TRUE	TRUE	TRUE	1	TRUE	TRUE	1	1
FBgn0032198	90	83	69	65	159	148	TRUE	TRUE	TRUE	1	TRUE	TRUE	1	1
FBgn0032200	70	50	44	42	114	92	FALSE	TRUE	TRUE	0	TRUE	TRUE	1	0
FBgn0032202	76	110	68	75	144	185	FALSE	TRUE	FALSE	0	TRUE	TRUE	1	0
FBgn0032204	187	204	148	147	335	351	TRUE	TRUE	TRUE	1	TRUE	TRUE	1	1
FBgn0032205	63	87	69	72	132	159	FALSE	TRUE	TRUE	0	TRUE	TRUE	1	0
FBgn0032208	566	585	475	453	1041	1038	TRUE	TRUE	TRUE	1	TRUE	TRUE	1	1
FBgn0032209	134	105	109	93	243	198	FALSE	TRUE	FALSE	0	TRUE	TRUE	1	0
FBgn0032210	206	207	175	163	381	370	TRUE	TRUE	TRUE	1	TRUE	TRUE	1	1
FBgn0032211	173	181	157	123	330	304	TRUE	FALSE	TRUE	0	TRUE	TRUE	1	0
FBgn0032213	128	127	92	102	220	229	TRUE	TRUE	TRUE	1	TRUE	TRUE	1	1
FBgn0032214	66	71	57	66	123	137	TRUE	TRUE	TRUE	1	TRUE	TRUE	1	1
FBgn0032216	187	171	133	139	320	310	TRUE	TRUE	TRUE	1	TRUE	TRUE	1	1
FBgn0032217	220	204	207	170	427	374	TRUE	FALSE	FALSE	0	TRUE	TRUE	1	0
FBgn0032218	261	240	223	237	484	477	TRUE	TRUE	TRUE	1	TRUE	TRUE	1	1
FBgn0032219	138	150	109	133	247	283	TRUE	TRUE	TRUE	1	TRUE	TRUE	1	1
FBgn0032221	171	151	151	151	322	302	TRUE	TRUE	TRUE	1	TRUE	TRUE	1	1
FBgn0032222	106	90	81	85	187	175	TRUE	TRUE	TRUE	1	TRUE	TRUE	1	1
FBgn0032223	194	138	145	151	339	289	FALSE	TRUE	FALSE	0	TRUE	TRUE	1	0
FBgn0032224	157	180	139	127	296	307	TRUE	TRUE	TRUE	1	TRUE	TRUE	1	1
FBgn0032225	224	218	165	195	389	413	TRUE	TRUE	TRUE	1	TRUE	TRUE	1	1
FBgn0032228	154	158	152	138	306	296	TRUE	TRUE	TRUE	1	TRUE	TRUE	1	1
FBgn0032229	70	69	48	81	118	150	TRUE	FALSE	FALSE	0	TRUE	FALSE	0	0
FBgn0032230	110	98	85	69	195	167	TRUE	TRUE	TRUE	1	TRUE	TRUE	1	1
FBgn0032231	72	67	73	59	145	126	TRUE	TRUE	TRUE	1	TRUE	TRUE	1	1
FBgn0032233	181	221	162	157	343	378	FALSE	TRUE	TRUE	0	TRUE	TRUE	1	0
FBgn0032234	134	160	122	125	256	285	TRUE	TRUE	TRUE	1	TRUE	TRUE	1	1
FBgn0032235	114	114	112	88	226	202	TRUE	TRUE	TRUE	1	TRUE	TRUE	1	1
FBgn0032236	86	76	62	71	148	147	TRUE	TRUE	TRUE	1	TRUE	TRUE	1	1
FBgn0032242	225	218	159	185	384	403	TRUE	TRUE	TRUE	1	TRUE	TRUE	1	1
FBgn0032243	376	370	333	295	709	665	TRUE	TRUE	TRUE	1	TRUE	TRUE	1	1
FBgn0032244	128	117	106	114	234	231	TRUE	TRUE	TRUE	1	TRUE	TRUE	1	1
FBgn0032246	191	158	132	137	323	295	FALSE	TRUE	TRUE	0	TRUE	TRUE	1	0
FBgn0032247	82	66	54	40	136	106	TRUE	TRUE	FALSE	0	TRUE	TRUE	1	0
FBgn0032249	231	188	186	150	417	338	FALSE	FALSE	FALSE	0	TRUE	TRUE	1	0
FBgn0032250	68	73	50	56	118	129	TRUE	TRUE	TRUE	1	TRUE	TRUE	1	1
FBgn0032251	121	115	126	121	247	236	TRUE	TRUE	TRUE	1	TRUE	TRUE	1	1
FBgn0032252	360	368	289	292	649	660	TRUE	TRUE	TRUE	1	TRUE	TRUE	1	1
FBgn0032253	371	370	316	308	687	678	TRUE	TRUE	TRUE	1	TRUE	TRUE	1	1
FBgn0032256	234	255	200	194	434	449	TRUE	TRUE	TRUE	1	TRUE	TRUE	1	1
FBgn0032258	174	200	143	155	317	355	TRUE	TRUE	TRUE	1	TRUE	TRUE	1	1
FBgn0032259	104	99	82	85	186	184	TRUE	TRUE	TRUE	1	TRUE	TRUE	1	1
FBgn0032260	43	57	46	41	89	98	TRUE	TRUE	TRUE	1	TRUE	TRUE	1	1
FBgn0032261	47	48	30	24	77	72	TRUE	TRUE	TRUE	1	TRUE	TRUE	1	1
FBgn0032262	186	148	159	165	345	313	FALSE	TRUE	TRUE	0	TRUE	TRUE	1	0
FBgn0032264	208	212	171	175	379	387	TRUE	TRUE	TRUE	1	TRUE	TRUE	1	1
FBgn0032265	146	173	147	143	293	316	TRUE	TRUE	TRUE	1	TRUE	TRUE	1	1
FBgn0032266	234	269	194	203	428	472	TRUE	TRUE	TRUE	1	TRUE	TRUE	1	1
FBgn0032268	45	45	35	43	80	88	TRUE	TRUE	TRUE	1	TRUE	TRUE	1	1
FBgn0032269	215	210	191	193	406	403	TRUE	TRUE	TRUE	1	TRUE	TRUE	1	1
FBgn0032271	247	234	179	156	426	390	TRUE	TRUE	TRUE	1	TRUE	TRUE	1	1
FBgn0032276	154	144	115	149	269	293	TRUE	FALSE	TRUE	0	TRUE	TRUE	1	0
FBgn0032280	84	79	66	57	150	136	TRUE	TRUE	TRUE	1	TRUE	TRUE	1	1
FBgn0032281	73	42	49	49	122	91	FALSE	TRUE	FALSE	0	FALSE	TRUE	0	0
FBgn0032282	95	117	88	66	183	183	TRUE	FALSE	TRUE	0	TRUE	TRUE	1	0
FBgn0032283	78	92	75	62	153	154	TRUE	TRUE	TRUE	1	TRUE	TRUE	1	1
FBgn0032284	70	79	64	61	134	140	TRUE	TRUE	TRUE	1	TRUE	TRUE	1	1
FBgn0032285	58	36	31	24	89	60	FALSE	TRUE	FALSE	0	FALSE	TRUE	0	0
FBgn0032287	143	134	93	106	236	240	TRUE	TRUE	TRUE	1	TRUE	TRUE	1	1
FBgn0032289	235	274	195	195	430	469	FALSE	TRUE	TRUE	0	TRUE	TRUE	1	0
FBgn0032290	62	49	40	41	102	90	TRUE	TRUE	TRUE	1	TRUE	TRUE	1	1
FBgn0032291	46	50	42	31	88	81	TRUE	TRUE	TRUE	1	TRUE	TRUE	1	1
FBgn0032292	49	57	49	53	98	110	TRUE	TRUE	TRUE	1	TRUE	TRUE	1	1
FBgn0032293	36	44	28	25	64	69	TRUE	TRUE	TRUE	1	TRUE	TRUE	1	1
FBgn0032295	71	89	60	68	131	157	TRUE	TRUE	TRUE	1	TRUE	TRUE	1	1
FBgn0032296	153	160	129	118	282	278	TRUE	TRUE	TRUE	1	TRUE	TRUE	1	1
FBgn0032297	259	260	222	206	481	466	TRUE	TRUE	TRUE	1	TRUE	TRUE	1	1
FBgn0032298	90	71	62	67	152	138	TRUE	TRUE	TRUE	1	TRUE	TRUE	1	1
FBgn0032299	57	45	45	51	102	96	TRUE	TRUE	TRUE	1	TRUE	TRUE	1	1
FBgn0032303	104	102	99	82	203	184	TRUE	TRUE	TRUE	1	TRUE	TRUE	1	1
FBgn0032304	134	140	91	116	225	256	TRUE	FALSE	TRUE	0	TRUE	TRUE	1	0
FBgn0032305	392	352	317	312	709	664	TRUE	TRUE	TRUE	1	TRUE	TRUE	1	1
FBgn0032311	47	56	51	55	98	111	TRUE	TRUE	TRUE	1	TRUE	TRUE	1	1
FBgn0032312	64	82	66	70	130	152	TRUE	TRUE	TRUE	1	TRUE	TRUE	1	1
FBgn0032313	136	160	131	114	267	274	TRUE	TRUE	TRUE	1	TRUE	TRUE	1	1
FBgn0032314	221	204	190	140	411	344	TRUE	FALSE	FALSE	0	TRUE	TRUE	1	0
FBgn0032315	38	35	39	43	77	78	TRUE	TRUE	TRUE	1	TRUE	TRUE	1	1
FBgn0032318	117	109	111	107	228	216	TRUE	TRUE	TRUE	1	TRUE	TRUE	1	1
FBgn0032321	120	121	91	117	211	238	TRUE	FALSE	TRUE	0	TRUE	TRUE	1	0
FBgn0032322	66	71	56	51	122	122	TRUE	TRUE	TRUE	1	TRUE	TRUE	1	1
FBgn0032330	399	413	369	356	768	769	TRUE	TRUE	TRUE	1	TRUE	TRUE	1	1
FBgn0032331	176	181	169	160	345	341	TRUE	TRUE	TRUE	1	TRUE	TRUE	1	1
FBgn0032336	103	93	74	70	177	163	TRUE	TRUE	TRUE	1	TRUE	TRUE	1	1
FBgn0032337	133	103	117	86	250	189	FALSE	FALSE	FALSE	0	TRUE	TRUE	1	0
FBgn0032338	288	251	220	198	508	449	TRUE	TRUE	FALSE	0	TRUE	TRUE	1	0
FBgn0032339	288	260	224	236	512	496	TRUE	TRUE	TRUE	1	TRUE	TRUE	1	1
FBgn0032341	290	295	208	225	498	520	TRUE	TRUE	TRUE	1	TRUE	TRUE	1	1
FBgn0032343	120	131	112	103	232	234	TRUE	TRUE	TRUE	1	TRUE	TRUE	1	1
FBgn0032345	66	91	71	68	137	159	FALSE	TRUE	TRUE	0	TRUE	TRUE	1	0
FBgn0032346	65	82	41	56	106	138	TRUE	TRUE	FALSE	0	TRUE	TRUE	1	0
FBgn0032348	391	424	331	288	722	712	TRUE	FALSE	TRUE	0	TRUE	TRUE	1	0
FBgn0032350	157	183	160	138	317	321	TRUE	TRUE	TRUE	1	TRUE	TRUE	1	1
FBgn0032354	120	126	92	80	212	206	TRUE	TRUE	TRUE	1	TRUE	TRUE	1	1
FBgn0032358	25	31	28	36	53	67	TRUE	TRUE	TRUE	1	TRUE	TRUE	1	1
FBgn0032360	86	103	85	75	171	178	TRUE	TRUE	TRUE	1	TRUE	TRUE	1	1
FBgn0032361	222	208	172	154	394	362	TRUE	TRUE	TRUE	1	TRUE	TRUE	1	1
FBgn0032362	181	159	154	139	335	298	TRUE	TRUE	TRUE	1	TRUE	TRUE	1	1
FBgn0032363	484	487	390	414	874	901	TRUE	TRUE	TRUE	1	TRUE	TRUE	1	1
FBgn0032364	167	196	160	180	327	376	TRUE	TRUE	FALSE	0	TRUE	TRUE	1	0
FBgn0032368	108	97	104	107	212	204	TRUE	TRUE	TRUE	1	TRUE	TRUE	1	1
FBgn0032369	287	260	266	254	553	514	TRUE	TRUE	TRUE	1	TRUE	TRUE	1	1
FBgn0032370	53	57	45	51	98	108	TRUE	TRUE	TRUE	1	TRUE	TRUE	1	1
FBgn0032371	170	191	192	164	362	355	TRUE	TRUE	TRUE	1	TRUE	TRUE	1	1
FBgn0032372	120	116	105	99	225	215	TRUE	TRUE	TRUE	1	TRUE	TRUE	1	1
FBgn0032373	169	157	153	168	322	325	TRUE	TRUE	TRUE	1	TRUE	TRUE	1	1
FBgn0032374	46	41	47	33	93	74	TRUE	TRUE	TRUE	1	TRUE	TRUE	1	1
FBgn0032375	35	33	28	24	63	57	TRUE	TRUE	TRUE	1	TRUE	TRUE	1	1
FBgn0032376	21	17	16	18	37	35	TRUE	TRUE	TRUE	1	TRUE	TRUE	1	1
FBgn0032377	128	134	113	122	241	256	TRUE	TRUE	TRUE	1	TRUE	TRUE	1	1
FBgn0032378	193	165	154	183	347	348	TRUE	TRUE	TRUE	1	TRUE	TRUE	1	1
FBgn0032381	190	138	128	151	318	289	FALSE	TRUE	TRUE	0	TRUE	TRUE	1	0
FBgn0032382	246	245	202	179	448	424	TRUE	TRUE	TRUE	1	TRUE	TRUE	1	1
FBgn0032385	66	57	50	65	116	122	TRUE	TRUE	TRUE	1	TRUE	TRUE	1	1
FBgn0032387	237	232	207	186	444	418	TRUE	TRUE	TRUE	1	TRUE	TRUE	1	1
FBgn0032388	111	124	106	114	217	238	TRUE	TRUE	TRUE	1	TRUE	TRUE	1	1
FBgn0032393	58	39	29	31	87	70	FALSE	TRUE	TRUE	0	TRUE	TRUE	1	0
FBgn0032395	305	309	230	259	535	568	TRUE	TRUE	TRUE	1	TRUE	TRUE	1	1
FBgn0032397	105	92	84	59	189	151	TRUE	FALSE	FALSE	0	TRUE	TRUE	1	0
FBgn0032398	96	84	71	96	167	180	TRUE	FALSE	TRUE	0	TRUE	TRUE	1	0
FBgn0032399	349	283	218	252	567	535	FALSE	TRUE	TRUE	0	TRUE	TRUE	1	0
FBgn0032401	124	103	92	89	216	192	TRUE	TRUE	TRUE	1	TRUE	TRUE	1	1
FBgn0032402	134	125	102	121	236	246	TRUE	TRUE	TRUE	1	TRUE	TRUE	1	1
FBgn0032405	215	205	170	172	385	377	TRUE	TRUE	TRUE	1	TRUE	TRUE	1	1
FBgn0032406	112	124	113	103	225	227	TRUE	TRUE	TRUE	1	TRUE	TRUE	1	1
FBgn0032407	118	120	82	83	200	203	TRUE	TRUE	TRUE	1	TRUE	TRUE	1	1
FBgn0032408	69	75	82	73	151	148	TRUE	TRUE	TRUE	1	TRUE	TRUE	1	1
FBgn0032409	228	228	187	195	415	423	TRUE	TRUE	TRUE	1	TRUE	TRUE	1	1
FBgn0032414	360	397	295	297	655	694	TRUE	TRUE	TRUE	1	TRUE	TRUE	1	1
FBgn0032415	149	143	101	124	250	267	TRUE	TRUE	TRUE	1	TRUE	TRUE	1	1
FBgn0032416	153	160	142	143	295	303	TRUE	TRUE	TRUE	1	TRUE	TRUE	1	1
FBgn0032419	36	36	37	32	73	68	TRUE	TRUE	TRUE	1	TRUE	TRUE	1	1
FBgn0032420	105	136	96	113	201	249	FALSE	TRUE	FALSE	0	TRUE	TRUE	1	0
FBgn0032421	59	82	71	57	130	139	FALSE	TRUE	TRUE	0	TRUE	TRUE	1	0
FBgn0032422	146	127	103	128	249	255	TRUE	TRUE	TRUE	1	TRUE	TRUE	1	1
FBgn0032424	149	136	102	118	251	254	TRUE	TRUE	TRUE	1	TRUE	TRUE	1	1
FBgn0032428	135	124	108	106	243	230	TRUE	TRUE	TRUE	1	TRUE	TRUE	1	1
FBgn0032429	128	100	95	82	223	182	FALSE	TRUE	FALSE	0	TRUE	TRUE	1	0
FBgn0032430	192	140	143	117	335	257	FALSE	TRUE	FALSE	0	TRUE	TRUE	1	0
FBgn0032431	83	69	61	71	144	140	TRUE	TRUE	TRUE	1	TRUE	TRUE	1	1
FBgn0032433	271	260	245	238	516	498	TRUE	TRUE	TRUE	1	TRUE	TRUE	1	1
FBgn0032434	167	200	143	159	310	359	FALSE	TRUE	FALSE	0	TRUE	TRUE	1	0
FBgn0032435	267	290	256	204	523	494	TRUE	FALSE	TRUE	0	TRUE	TRUE	1	0
FBgn0032436	107	109	80	73	187	182	TRUE	TRUE	TRUE	1	TRUE	TRUE	1	1
FBgn0032437	134	117	119	135	253	252	TRUE	TRUE	TRUE	1	TRUE	TRUE	1	1
FBgn0032439	192	191	161	157	353	348	TRUE	TRUE	TRUE	1	TRUE	TRUE	1	1
FBgn0032442	223	237	238	228	461	465	TRUE	TRUE	TRUE	1	TRUE	TRUE	1	1
FBgn0032444	187	212	167	169	354	381	TRUE	TRUE	TRUE	1	TRUE	TRUE	1	1
FBgn0032445	39	30	33	22	72	52	TRUE	TRUE	FALSE	0	TRUE	TRUE	1	0
FBgn0032446	22	40	36	31	58	71	FALSE	TRUE	TRUE	0	FALSE	TRUE	0	0
FBgn0032447	243	242	226	187	469	429	TRUE	FALSE	TRUE	0	TRUE	TRUE	1	0
FBgn0032448	36	40	34	37	70	77	TRUE	TRUE	TRUE	1	TRUE	TRUE	1	1
FBgn0032449	155	190	105	106	260	296	FALSE	TRUE	TRUE	0	TRUE	TRUE	1	0
FBgn0032450	275	269	216	227	491	496	TRUE	TRUE	TRUE	1	TRUE	TRUE	1	1
FBgn0032451	119	98	68	68	187	166	TRUE	TRUE	TRUE	1	TRUE	TRUE	1	1
FBgn0032452	41	47	32	31	73	78	TRUE	TRUE	TRUE	1	TRUE	TRUE	1	1
FBgn0032454	252	213	183	191	435	404	FALSE	TRUE	TRUE	0	TRUE	TRUE	1	0
FBgn0032455	404	420	357	382	761	802	TRUE	TRUE	TRUE	1	TRUE	TRUE	1	1
FBgn0032456	649	646	574	566	1223	1212	TRUE	TRUE	TRUE	1	TRUE	TRUE	1	1
FBgn0032457	120	147	114	129	234	276	TRUE	TRUE	FALSE	0	TRUE	TRUE	1	0
FBgn0032462	22	32	17	28	39	60	TRUE	TRUE	FALSE	0	TRUE	FALSE	0	0
FBgn0032464	130	132	99	100	229	232	TRUE	TRUE	TRUE	1	TRUE	TRUE	1	1
FBgn0032465	96	110	92	88	188	198	TRUE	TRUE	TRUE	1	TRUE	TRUE	1	1
FBgn0032467	63	53	36	49	99	102	TRUE	TRUE	TRUE	1	TRUE	TRUE	1	1
FBgn0032470	154	149	132	126	286	275	TRUE	TRUE	TRUE	1	TRUE	TRUE	1	1
FBgn0032471	395	366	309	348	704	714	TRUE	TRUE	TRUE	1	TRUE	TRUE	1	1
FBgn0032472	52	51	45	50	97	101	TRUE	TRUE	TRUE	1	TRUE	TRUE	1	1
FBgn0032473	133	170	127	119	260	289	FALSE	TRUE	TRUE	0	TRUE	TRUE	1	0
FBgn0032474	70	40	48	56	118	96	FALSE	TRUE	TRUE	0	FALSE	TRUE	0	0
FBgn0032475	265	253	210	211	475	464	TRUE	TRUE	TRUE	1	TRUE	TRUE	1	1
FBgn0032476	48	38	37	36	85	74	TRUE	TRUE	TRUE	1	TRUE	TRUE	1	1
FBgn0032477	83	68	57	55	140	123	TRUE	TRUE	TRUE	1	TRUE	TRUE	1	1
FBgn0032479	262	278	214	245	476	523	TRUE	TRUE	TRUE	1	TRUE	TRUE	1	1
FBgn0032480	259	235	154	193	413	428	TRUE	FALSE	TRUE	0	TRUE	TRUE	1	0
FBgn0032481	128	173	86	111	214	284	FALSE	FALSE	FALSE	0	TRUE	TRUE	1	0
FBgn0032482	189	179	131	148	320	327	TRUE	TRUE	TRUE	1	TRUE	TRUE	1	1
FBgn0032483	28	35	38	42	66	77	TRUE	TRUE	TRUE	1	TRUE	TRUE	1	1
FBgn0032484	181	157	138	122	319	279	TRUE	TRUE	TRUE	1	TRUE	TRUE	1	1
FBgn0032485	237	221	178	219	415	440	TRUE	FALSE	TRUE	0	TRUE	TRUE	1	0
FBgn0032486	105	89	55	78	160	167	TRUE	FALSE	TRUE	0	TRUE	TRUE	1	0
FBgn0032488	48	49	24	37	72	86	TRUE	TRUE	TRUE	1	TRUE	FALSE	0	0
FBgn0032489	52	43	38	51	90	94	TRUE	TRUE	TRUE	1	TRUE	TRUE	1	1
FBgn0032490	96	96	75	73	171	169	TRUE	TRUE	TRUE	1	TRUE	TRUE	1	1
FBgn0032491	78	80	54	72	132	152	TRUE	TRUE	TRUE	1	TRUE	TRUE	1	1
FBgn0032492	76	80	65	71	141	151	TRUE	TRUE	TRUE	1	TRUE	TRUE	1	1
FBgn0032493	81	99	80	87	161	186	TRUE	TRUE	TRUE	1	TRUE	TRUE	1	1
FBgn0032494	124	117	87	99	211	216	TRUE	TRUE	TRUE	1	TRUE	TRUE	1	1
FBgn0032495	111	105	84	80	195	185	TRUE	TRUE	TRUE	1	TRUE	TRUE	1	1
FBgn0032499	133	120	110	99	243	219	TRUE	TRUE	TRUE	1	TRUE	TRUE	1	1
FBgn0032503	59	47	27	43	86	90	TRUE	FALSE	TRUE	0	TRUE	FALSE	0	0
FBgn0032505	97	100	86	78	183	178	TRUE	TRUE	TRUE	1	TRUE	TRUE	1	1
FBgn0032506	420	390	320	306	740	696	TRUE	TRUE	TRUE	1	TRUE	TRUE	1	1
FBgn0032507	107	130	105	99	212	229	TRUE	TRUE	TRUE	1	TRUE	TRUE	1	1
FBgn0032509	54	51	46	32	100	83	TRUE	TRUE	TRUE	1	TRUE	TRUE	1	1
FBgn0032511	15	21	20	11	35	32	TRUE	TRUE	TRUE	1	TRUE	FALSE	0	0
FBgn0032512	160	178	82	107	242	285	TRUE	FALSE	FALSE	0	TRUE	TRUE	1	0
FBgn0032513	110	66	64	61	174	127	FALSE	TRUE	FALSE	0	FALSE	TRUE	0	0
FBgn0032514	99	129	56	61	155	190	FALSE	TRUE	FALSE	0	TRUE	TRUE	1	0
FBgn0032515	82	87	43	50	125	137	TRUE	TRUE	TRUE	1	TRUE	TRUE	1	1
FBgn0032516	55	49	16	22	71	71	TRUE	TRUE	TRUE	1	TRUE	TRUE	1	1
FBgn0032517	443	373	202	187	645	560	FALSE	TRUE	FALSE	0	TRUE	TRUE	1	0
FBgn0032518	98	80	28	25	126	105	TRUE	TRUE	TRUE	1	TRUE	TRUE	1	1
FBgn0032519	109	103	51	43	160	146	TRUE	TRUE	TRUE	1	TRUE	TRUE	1	1
FBgn0032520	171	160	70	72	241	232	TRUE	TRUE	TRUE	1	TRUE	TRUE	1	1
FBgn0032521	517	537	178	188	695	725	TRUE	TRUE	TRUE	1	TRUE	TRUE	1	1
FBgn0032522	206	194	72	63	278	257	TRUE	TRUE	TRUE	1	TRUE	TRUE	1	1
FBgn0032523	202	206	82	64	284	270	TRUE	TRUE	TRUE	1	TRUE	TRUE	1	1
FBgn0032524	149	116	98	95	247	211	FALSE	TRUE	TRUE	0	TRUE	TRUE	1	0
FBgn0032525	163	184	142	136	305	320	TRUE	TRUE	TRUE	1	TRUE	TRUE	1	1
FBgn0032530	30	39	16	23	46	62	TRUE	TRUE	TRUE	1	TRUE	TRUE	1	1
FBgn0032535	213	248	182	182	395	430	TRUE	TRUE	TRUE	1	TRUE	TRUE	1	1
FBgn0032536	440	413	345	324	785	737	TRUE	TRUE	TRUE	1	TRUE	TRUE	1	1
FBgn0032538	96	133	62	94	158	227	FALSE	FALSE	FALSE	0	TRUE	FALSE	0	0
FBgn0032549	112	127	90	106	202	233	TRUE	TRUE	TRUE	1	TRUE	TRUE	1	1
FBgn0032551	136	148	106	123	242	271	TRUE	TRUE	TRUE	1	TRUE	TRUE	1	1
FBgn0032553	149	130	133	119	282	249	TRUE	TRUE	TRUE	1	TRUE	TRUE	1	1
FBgn0032554	103	143	90	113	193	256	FALSE	TRUE	FALSE	0	TRUE	TRUE	1	0
FBgn0032577	38	49	23	42	61	91	TRUE	FALSE	FALSE	0	TRUE	FALSE	0	0
FBgn0032582	33	27	39	33	72	60	TRUE	TRUE	TRUE	1	TRUE	TRUE	1	1
FBgn0032585	131	154	97	125	228	279	TRUE	FALSE	FALSE	0	TRUE	TRUE	1	0
FBgn0032586	284	304	262	229	546	533	TRUE	TRUE	TRUE	1	TRUE	TRUE	1	1
FBgn0032587	304	288	236	250	540	538	TRUE	TRUE	TRUE	1	TRUE	TRUE	1	1
FBgn0032588	79	59	54	62	133	121	TRUE	TRUE	TRUE	1	TRUE	TRUE	1	1
FBgn0032590	250	254	213	201	463	455	TRUE	TRUE	TRUE	1	TRUE	TRUE	1	1
FBgn0032593	372	377	312	338	684	715	TRUE	TRUE	TRUE	1	TRUE	TRUE	1	1
FBgn0032596	49	80	51	43	100	123	FALSE	TRUE	TRUE	0	FALSE	TRUE	0	0
FBgn0032598	80	77	71	65	151	142	TRUE	TRUE	TRUE	1	TRUE	TRUE	1	1
FBgn0032600	436	461	383	388	819	849	TRUE	TRUE	TRUE	1	TRUE	TRUE	1	1
FBgn0032601	167	155	145	131	312	286	TRUE	TRUE	TRUE	1	TRUE	TRUE	1	1
FBgn0032602	216	193	179	206	395	399	TRUE	TRUE	TRUE	1	TRUE	TRUE	1	1
FBgn0032603	161	192	132	166	293	358	TRUE	FALSE	FALSE	0	TRUE	TRUE	1	0
FBgn0032609	188	174	111	135	299	309	TRUE	TRUE	TRUE	1	TRUE	TRUE	1	1
FBgn0032612	87	104	92	72	179	176	TRUE	TRUE	TRUE	1	TRUE	TRUE	1	1
FBgn0032613	181	151	123	117	304	268	TRUE	TRUE	TRUE	1	TRUE	TRUE	1	1
FBgn0032614	240	237	199	222	439	459	TRUE	TRUE	TRUE	1	TRUE	TRUE	1	1
FBgn0032615	109	107	85	83	194	190	TRUE	TRUE	TRUE	1	TRUE	TRUE	1	1
FBgn0032620	33	32	36	22	69	54	TRUE	FALSE	TRUE	0	TRUE	FALSE	0	0
FBgn0032624	77	67	79	83	156	150	TRUE	TRUE	TRUE	1	TRUE	TRUE	1	1
FBgn0032625	53	35	51	33	104	68	FALSE	FALSE	FALSE	0	FALSE	FALSE	0	0
FBgn0032626	45	41	41	33	86	74	TRUE	TRUE	TRUE	1	TRUE	TRUE	1	1
FBgn0032629	134	113	157	144	291	257	TRUE	TRUE	TRUE	1	TRUE	TRUE	1	1
FBgn0032631	37	48	53	48	90	96	TRUE	TRUE	TRUE	1	TRUE	TRUE	1	1
FBgn0032632	60	63	46	44	106	107	TRUE	TRUE	TRUE	1	TRUE	TRUE	1	1
FBgn0032633	454	459	379	408	833	867	TRUE	TRUE	TRUE	1	TRUE	TRUE	1	1
FBgn0032634	32	33	25	29	57	62	TRUE	TRUE	TRUE	1	TRUE	TRUE	1	1
FBgn0032635	24	37	28	27	52	64	TRUE	TRUE	TRUE	1	FALSE	TRUE	0	0
FBgn0032636	90	73	70	83	160	156	TRUE	TRUE	TRUE	1	TRUE	TRUE	1	1
FBgn0032637	116	131	104	90	220	221	TRUE	TRUE	TRUE	1	TRUE	TRUE	1	1
FBgn0032638	60	62	48	52	108	114	TRUE	TRUE	TRUE	1	TRUE	TRUE	1	1
FBgn0032639	95	81	82	58	177	139	TRUE	FALSE	FALSE	0	TRUE	TRUE	1	0
FBgn0032640	114	88	76	89	190	177	FALSE	TRUE	TRUE	0	TRUE	TRUE	1	0
FBgn0032642	52	45	37	36	89	81	TRUE	TRUE	TRUE	1	TRUE	TRUE	1	1
FBgn0032643	125	103	108	98	233	201	TRUE	TRUE	TRUE	1	TRUE	TRUE	1	1
FBgn0032644	99	110	107	79	206	189	TRUE	FALSE	TRUE	0	TRUE	TRUE	1	0
FBgn0032645	74	79	70	61	144	140	TRUE	TRUE	TRUE	1	TRUE	TRUE	1	1
FBgn0032646	137	120	108	86	245	206	TRUE	TRUE	FALSE	0	TRUE	TRUE	1	0
FBgn0032647	271	280	210	226	481	506	TRUE	TRUE	TRUE	1	TRUE	TRUE	1	1
FBgn0032648	152	164	159	154	311	318	TRUE	TRUE	TRUE	1	TRUE	TRUE	1	1
FBgn0032649	242	224	197	174	439	398	TRUE	TRUE	TRUE	1	TRUE	TRUE	1	1
FBgn0032650	65	61	49	52	114	113	TRUE	TRUE	TRUE	1	TRUE	TRUE	1	1
FBgn0032651	142	107	114	90	256	197	FALSE	TRUE	FALSE	0	TRUE	TRUE	1	0
FBgn0032652	30	32	26	23	56	55	TRUE	TRUE	TRUE	1	TRUE	TRUE	1	1
FBgn0032654	23	12	27	24	50	36	FALSE	TRUE	TRUE	0	FALSE	TRUE	0	0
FBgn0032656	159	170	155	147	314	317	TRUE	TRUE	TRUE	1	TRUE	TRUE	1	1
FBgn0032658	179	194	167	161	346	355	TRUE	TRUE	TRUE	1	TRUE	TRUE	1	1
FBgn0032660	83	73	78	64	161	137	TRUE	TRUE	TRUE	1	TRUE	TRUE	1	1
FBgn0032663	87	106	77	87	164	193	TRUE	TRUE	TRUE	1	TRUE	TRUE	1	1
FBgn0032664	88	93	79	79	167	172	TRUE	TRUE	TRUE	1	TRUE	TRUE	1	1
FBgn0032665	70	78	63	52	133	130	TRUE	TRUE	TRUE	1	TRUE	TRUE	1	1
FBgn0032666	193	199	171	146	364	345	TRUE	TRUE	TRUE	1	TRUE	TRUE	1	1
FBgn0032668	135	159	136	100	271	259	TRUE	FALSE	TRUE	0	TRUE	TRUE	1	0
FBgn0032669	65	58	49	50	114	108	TRUE	TRUE	TRUE	1	TRUE	TRUE	1	1
FBgn0032670	59	52	49	41	108	93	TRUE	TRUE	TRUE	1	TRUE	TRUE	1	1
FBgn0032671	100	98	85	90	185	188	TRUE	TRUE	TRUE	1	TRUE	TRUE	1	1
FBgn0032677	112	107	80	81	192	188	TRUE	TRUE	TRUE	1	TRUE	TRUE	1	1
FBgn0032680	50	51	48	55	98	106	TRUE	TRUE	TRUE	1	TRUE	TRUE	1	1
FBgn0032681	247	216	207	186	454	402	TRUE	TRUE	FALSE	0	TRUE	TRUE	1	0
FBgn0032682	164	131	122	103	286	234	FALSE	TRUE	FALSE	0	TRUE	TRUE	1	0
FBgn0032683	607	649	468	474	1075	1123	TRUE	TRUE	TRUE	1	TRUE	TRUE	1	1
FBgn0032684	121	101	100	78	221	179	TRUE	TRUE	FALSE	0	TRUE	TRUE	1	0
FBgn0032685	299	279	263	264	562	543	TRUE	TRUE	TRUE	1	TRUE	TRUE	1	1
FBgn0032688	345	326	252	265	597	591	TRUE	TRUE	TRUE	1	TRUE	TRUE	1	1
FBgn0032689	335	285	261	248	596	533	FALSE	TRUE	FALSE	0	TRUE	TRUE	1	0
FBgn0032690	217	167	162	138	379	305	FALSE	TRUE	FALSE	0	TRUE	TRUE	1	0
FBgn0032691	137	143	118	107	255	250	TRUE	TRUE	TRUE	1	TRUE	TRUE	1	1
FBgn0032692	147	145	134	135	281	280	TRUE	TRUE	TRUE	1	TRUE	TRUE	1	1
FBgn0032693	172	156	149	156	321	312	TRUE	TRUE	TRUE	1	TRUE	TRUE	1	1
FBgn0032694	181	191	143	157	324	348	TRUE	TRUE	TRUE	1	TRUE	TRUE	1	1
FBgn0032698	54	52	55	36	109	88	TRUE	FALSE	TRUE	0	TRUE	FALSE	0	0
FBgn0032699	140	126	115	117	255	243	TRUE	TRUE	TRUE	1	TRUE	TRUE	1	1
FBgn0032700	57	56	45	58	102	114	TRUE	TRUE	TRUE	1	TRUE	TRUE	1	1
FBgn0032701	28	26	35	29	63	55	TRUE	TRUE	TRUE	1	TRUE	TRUE	1	1
FBgn0032702	147	148	135	120	282	268	TRUE	TRUE	TRUE	1	TRUE	TRUE	1	1
FBgn0032703	47	37	26	43	73	80	TRUE	FALSE	TRUE	0	TRUE	FALSE	0	0
FBgn0032704	79	87	84	67	163	154	TRUE	TRUE	TRUE	1	TRUE	TRUE	1	1
FBgn0032705	69	73	59	61	128	134	TRUE	TRUE	TRUE	1	TRUE	TRUE	1	1
FBgn0032706	173	159	125	129	298	288	TRUE	TRUE	TRUE	1	TRUE	TRUE	1	1
FBgn0032707	178	184	118	139	296	323	TRUE	TRUE	TRUE	1	TRUE	TRUE	1	1
FBgn0032713	186	203	166	165	352	368	TRUE	TRUE	TRUE	1	TRUE	TRUE	1	1
FBgn0032715	97	114	71	100	168	214	TRUE	FALSE	FALSE	0	TRUE	TRUE	1	0
FBgn0032717	231	212	198	206	429	418	TRUE	TRUE	TRUE	1	TRUE	TRUE	1	1
FBgn0032719	126	112	101	97	227	209	TRUE	TRUE	TRUE	1	TRUE	TRUE	1	1
FBgn0032720	24	28	19	14	43	42	TRUE	TRUE	TRUE	1	TRUE	TRUE	1	1
FBgn0032721	116	92	109	98	225	190	TRUE	TRUE	FALSE	0	TRUE	TRUE	1	0
FBgn0032723	335	393	304	364	639	757	FALSE	FALSE	FALSE	0	TRUE	TRUE	1	0
FBgn0032724	69	66	66	45	135	111	TRUE	FALSE	TRUE	0	TRUE	TRUE	1	0
FBgn0032725	40	39	48	49	88	88	TRUE	TRUE	TRUE	1	TRUE	TRUE	1	1
FBgn0032726	63	74	66	42	129	116	TRUE	FALSE	TRUE	0	TRUE	FALSE	0	0
FBgn0032727	99	108	87	88	186	196	TRUE	TRUE	TRUE	1	TRUE	TRUE	1	1
FBgn0032728	160	149	122	107	282	256	TRUE	TRUE	TRUE	1	TRUE	TRUE	1	1
FBgn0032729	118	111	104	90	222	201	TRUE	TRUE	TRUE	1	TRUE	TRUE	1	1
FBgn0032730	107	134	89	89	196	223	FALSE	TRUE	TRUE	0	TRUE	TRUE	1	0
FBgn0032731	50	73	47	49	97	122	FALSE	TRUE	TRUE	0	TRUE	TRUE	1	0
FBgn0032732	29	23	20	15	49	38	TRUE	TRUE	TRUE	1	TRUE	TRUE	1	1
FBgn0032733	144	105	87	86	231	191	FALSE	TRUE	FALSE	0	TRUE	TRUE	1	0
FBgn0032734	87	102	92	88	179	190	TRUE	TRUE	TRUE	1	TRUE	TRUE	1	1
FBgn0032740	36	26	25	23	61	49	TRUE	TRUE	TRUE	1	TRUE	TRUE	1	1
FBgn0032741	100	74	59	64	159	138	FALSE	TRUE	TRUE	0	TRUE	TRUE	1	0
FBgn0032744	76	73	56	70	132	143	TRUE	TRUE	TRUE	1	TRUE	TRUE	1	1
FBgn0032746	40	46	36	32	76	78	TRUE	TRUE	TRUE	1	TRUE	TRUE	1	1
FBgn0032748	186	201	175	158	361	359	TRUE	TRUE	TRUE	1	TRUE	TRUE	1	1
FBgn0032749	185	167	148	131	333	298	TRUE	TRUE	TRUE	1	TRUE	TRUE	1	1
FBgn0032750	52	66	32	60	84	126	TRUE	FALSE	FALSE	0	TRUE	FALSE	0	0
FBgn0032752	173	156	132	144	305	300	TRUE	TRUE	TRUE	1	TRUE	TRUE	1	1
FBgn0032753	160	169	135	131	295	300	TRUE	TRUE	TRUE	1	TRUE	TRUE	1	1
FBgn0032754	72	94	83	74	155	168	TRUE	TRUE	TRUE	1	TRUE	TRUE	1	1
FBgn0032763	158	144	109	140	267	284	TRUE	FALSE	TRUE	0	TRUE	TRUE	1	0
FBgn0032768	142	138	112	101	254	239	TRUE	TRUE	TRUE	1	TRUE	TRUE	1	1
FBgn0032769	110	105	91	93	201	198	TRUE	TRUE	TRUE	1	TRUE	TRUE	1	1
FBgn0032770	65	56	46	54	111	110	TRUE	TRUE	TRUE	1	TRUE	TRUE	1	1
FBgn0032771	156	194	130	123	286	317	FALSE	TRUE	TRUE	0	TRUE	TRUE	1	0
FBgn0032772	73	75	74	75	147	150	TRUE	TRUE	TRUE	1	TRUE	TRUE	1	1
FBgn0032773	278	215	210	181	488	396	FALSE	TRUE	FALSE	0	TRUE	TRUE	1	0
FBgn0032774	112	112	105	106	217	218	TRUE	TRUE	TRUE	1	TRUE	TRUE	1	1
FBgn0032775	270	296	232	255	502	551	TRUE	TRUE	TRUE	1	TRUE	TRUE	1	1
FBgn0032779	228	196	181	142	409	338	TRUE	FALSE	FALSE	0	TRUE	TRUE	1	0
FBgn0032780	62	69	65	75	127	144	TRUE	TRUE	TRUE	1	TRUE	TRUE	1	1
FBgn0032781	112	136	112	103	224	239	TRUE	TRUE	TRUE	1	TRUE	TRUE	1	1
FBgn0032782	122	105	99	117	221	222	TRUE	TRUE	TRUE	1	TRUE	TRUE	1	1
FBgn0032783	182	205	138	161	320	366	TRUE	TRUE	FALSE	0	TRUE	TRUE	1	0
FBgn0032785	190	175	151	179	341	354	TRUE	TRUE	TRUE	1	TRUE	TRUE	1	1
FBgn0032787	131	131	111	108	242	239	TRUE	TRUE	TRUE	1	TRUE	TRUE	1	1
FBgn0032788	130	150	91	114	221	264	TRUE	TRUE	FALSE	0	TRUE	TRUE	1	0
FBgn0032789	59	72	72	58	131	130	TRUE	TRUE	TRUE	1	TRUE	TRUE	1	1
FBgn0032790	55	39	45	41	100	80	TRUE	TRUE	TRUE	1	TRUE	TRUE	1	1
FBgn0032791	73	53	43	56	116	109	FALSE	TRUE	TRUE	0	TRUE	TRUE	1	0
FBgn0032796	161	188	138	125	299	313	TRUE	TRUE	TRUE	1	TRUE	TRUE	1	1
FBgn0032797	358	342	284	286	642	628	TRUE	TRUE	TRUE	1	TRUE	TRUE	1	1
FBgn0032798	236	221	207	223	443	444	TRUE	TRUE	TRUE	1	TRUE	TRUE	1	1
FBgn0032799	24	23	26	23	50	46	TRUE	TRUE	TRUE	1	TRUE	TRUE	1	1
FBgn0032800	147	123	114	119	261	242	TRUE	TRUE	TRUE	1	TRUE	TRUE	1	1
FBgn0032801	122	102	102	105	224	207	TRUE	TRUE	TRUE	1	TRUE	TRUE	1	1
FBgn0032803	52	35	40	31	92	66	FALSE	TRUE	FALSE	0	TRUE	TRUE	1	0
FBgn0032804	85	82	52	55	137	137	TRUE	TRUE	TRUE	1	TRUE	TRUE	1	1
FBgn0032805	76	60	38	40	114	100	TRUE	TRUE	TRUE	1	TRUE	TRUE	1	1
FBgn0032809	121	89	78	89	199	178	FALSE	TRUE	TRUE	0	TRUE	TRUE	1	0
FBgn0032810	78	87	59	77	137	164	TRUE	TRUE	TRUE	1	TRUE	TRUE	1	1
FBgn0032811	23	32	27	29	50	61	TRUE	TRUE	TRUE	1	TRUE	TRUE	1	1
FBgn0032812	93	79	72	85	165	164	TRUE	TRUE	TRUE	1	TRUE	TRUE	1	1
FBgn0032813	122	109	74	75	196	184	TRUE	TRUE	TRUE	1	TRUE	TRUE	1	1
FBgn0032814	141	153	119	110	260	263	TRUE	TRUE	TRUE	1	TRUE	TRUE	1	1
FBgn0032815	230	181	213	162	443	343	FALSE	FALSE	FALSE	0	TRUE	TRUE	1	0
FBgn0032816	46	64	40	54	86	118	TRUE	TRUE	FALSE	0	TRUE	TRUE	1	0
FBgn0032817	657	683	593	551	1250	1234	TRUE	TRUE	TRUE	1	TRUE	TRUE	1	1
FBgn0032818	66	45	67	37	133	82	FALSE	FALSE	FALSE	0	TRUE	FALSE	0	0
FBgn0032819	151	169	126	137	277	306	TRUE	TRUE	TRUE	1	TRUE	TRUE	1	1
FBgn0032820	108	102	84	79	192	181	TRUE	TRUE	TRUE	1	TRUE	TRUE	1	1
FBgn0032821	298	270	284	241	582	511	TRUE	FALSE	FALSE	0	TRUE	TRUE	1	0
FBgn0032822	58	51	31	46	89	97	TRUE	TRUE	TRUE	1	TRUE	TRUE	1	1
FBgn0032824	111	94	70	82	181	176	TRUE	TRUE	TRUE	1	TRUE	TRUE	1	1
FBgn0032827	163	159	152	140	315	299	TRUE	TRUE	TRUE	1	TRUE	TRUE	1	1
FBgn0032833	83	59	76	66	159	125	FALSE	TRUE	FALSE	0	TRUE	TRUE	1	0
FBgn0032834	39	44	28	29	67	73	TRUE	TRUE	TRUE	1	TRUE	TRUE	1	1
FBgn0032835	96	89	90	76	186	165	TRUE	TRUE	TRUE	1	TRUE	TRUE	1	1
FBgn0032836	71	64	69	46	140	110	TRUE	FALSE	FALSE	0	TRUE	TRUE	1	0
FBgn0032839	49	49	58	58	107	107	TRUE	TRUE	TRUE	1	TRUE	TRUE	1	1
FBgn0032840	243	205	191	195	434	400	FALSE	TRUE	TRUE	0	TRUE	TRUE	1	0
FBgn0032843	147	153	155	149	302	302	TRUE	TRUE	TRUE	1	TRUE	TRUE	1	1
FBgn0032845	75	75	58	47	133	122	TRUE	TRUE	TRUE	1	TRUE	TRUE	1	1
FBgn0032846	102	79	65	92	167	171	TRUE	FALSE	TRUE	0	TRUE	TRUE	1	0
FBgn0032848	105	68	73	68	178	136	FALSE	TRUE	FALSE	0	FALSE	TRUE	0	0
FBgn0032849	53	54	64	48	117	102	TRUE	TRUE	TRUE	1	TRUE	TRUE	1	1
FBgn0032850	217	248	208	179	425	427	TRUE	TRUE	TRUE	1	TRUE	TRUE	1	1
FBgn0032851	22	28	29	35	51	63	TRUE	TRUE	TRUE	1	TRUE	TRUE	1	1
FBgn0032853	85	103	102	89	187	192	TRUE	TRUE	TRUE	1	TRUE	TRUE	1	1
FBgn0032856	182	134	147	141	329	275	FALSE	TRUE	FALSE	0	TRUE	TRUE	1	0
FBgn0032857	158	136	138	122	296	258	TRUE	TRUE	TRUE	1	TRUE	TRUE	1	1
FBgn0032858	112	104	77	67	189	171	TRUE	TRUE	TRUE	1	TRUE	TRUE	1	1
FBgn0032859	81	88	76	65	157	153	TRUE	TRUE	TRUE	1	TRUE	TRUE	1	1
FBgn0032860	65	69	78	67	143	136	TRUE	TRUE	TRUE	1	TRUE	TRUE	1	1
FBgn0032863	126	109	99	83	225	192	TRUE	TRUE	TRUE	1	TRUE	TRUE	1	1
FBgn0032864	123	116	101	86	224	202	TRUE	TRUE	TRUE	1	TRUE	TRUE	1	1
FBgn0032867	107	76	80	80	187	156	FALSE	TRUE	TRUE	0	TRUE	TRUE	1	0
FBgn0032868	14	35	19	22	33	57	FALSE	TRUE	FALSE	0	FALSE	TRUE	0	0
FBgn0032869	59	73	58	51	117	124	TRUE	TRUE	TRUE	1	TRUE	TRUE	1	1
FBgn0032870	55	52	25	38	80	90	TRUE	TRUE	TRUE	1	TRUE	FALSE	0	0
FBgn0032873	68	82	83	73	151	155	TRUE	TRUE	TRUE	1	TRUE	TRUE	1	1
FBgn0032876	138	139	124	126	262	265	TRUE	TRUE	TRUE	1	TRUE	TRUE	1	1
FBgn0032877	50	39	45	40	95	79	TRUE	TRUE	TRUE	1	TRUE	TRUE	1	1
FBgn0032878	101	74	69	81	170	155	FALSE	TRUE	TRUE	0	TRUE	TRUE	1	0
FBgn0032879	190	165	129	128	319	293	TRUE	TRUE	TRUE	1	TRUE	TRUE	1	1
FBgn0032880	62	53	57	54	119	107	TRUE	TRUE	TRUE	1	TRUE	TRUE	1	1
FBgn0032881	40	58	39	53	79	111	FALSE	TRUE	FALSE	0	TRUE	TRUE	1	0
FBgn0032882	81	93	64	80	145	173	TRUE	TRUE	TRUE	1	TRUE	TRUE	1	1
FBgn0032883	141	147	125	102	266	249	TRUE	TRUE	TRUE	1	TRUE	TRUE	1	1
FBgn0032884	67	66	47	53	114	119	TRUE	TRUE	TRUE	1	TRUE	TRUE	1	1
FBgn0032886	124	117	104	119	228	236	TRUE	TRUE	TRUE	1	TRUE	TRUE	1	1
FBgn0032888	69	65	67	74	136	139	TRUE	TRUE	TRUE	1	TRUE	TRUE	1	1
FBgn0032889	195	184	191	141	386	325	TRUE	FALSE	FALSE	0	TRUE	TRUE	1	0
FBgn0032891	135	115	112	98	247	213	TRUE	TRUE	TRUE	1	TRUE	TRUE	1	1
FBgn0032894	78	66	67	50	145	116	TRUE	TRUE	FALSE	0	TRUE	TRUE	1	0
FBgn0032895	92	94	89	72	181	166	TRUE	TRUE	TRUE	1	TRUE	TRUE	1	1
FBgn0032896	67	60	47	58	114	118	TRUE	TRUE	TRUE	1	TRUE	TRUE	1	1
FBgn0032897	111	108	93	97	204	205	TRUE	TRUE	TRUE	1	TRUE	TRUE	1	1
FBgn0032898	75	92	74	71	149	163	TRUE	TRUE	TRUE	1	TRUE	TRUE	1	1
FBgn0032899	90	95	52	62	142	157	TRUE	TRUE	TRUE	1	TRUE	TRUE	1	1
FBgn0032900	64	62	55	48	119	110	TRUE	TRUE	TRUE	1	TRUE	TRUE	1	1
FBgn0032901	73	72	61	56	134	128	TRUE	TRUE	TRUE	1	TRUE	TRUE	1	1
FBgn0032906	88	107	97	91	185	198	TRUE	TRUE	TRUE	1	TRUE	TRUE	1	1
FBgn0032907	90	54	54	78	144	132	FALSE	FALSE	TRUE	0	FALSE	TRUE	0	0
FBgn0032908	189	174	167	170	356	344	TRUE	TRUE	TRUE	1	TRUE	TRUE	1	1
FBgn0032910	182	156	157	140	339	296	TRUE	TRUE	FALSE	0	TRUE	TRUE	1	0
FBgn0032911	134	108	98	96	232	204	TRUE	TRUE	TRUE	1	TRUE	TRUE	1	1
FBgn0032913	60	66	59	67	119	133	TRUE	TRUE	TRUE	1	TRUE	TRUE	1	1
FBgn0032919	32	36	29	19	61	55	TRUE	TRUE	TRUE	1	TRUE	FALSE	0	0
FBgn0032923	25	29	20	26	45	55	TRUE	TRUE	TRUE	1	TRUE	TRUE	1	1
FBgn0032924	34	38	20	20	54	58	TRUE	TRUE	TRUE	1	TRUE	TRUE	1	1
FBgn0032929	102	95	92	88	194	183	TRUE	TRUE	TRUE	1	TRUE	TRUE	1	1
FBgn0032934	76	65	63	40	139	105	TRUE	FALSE	FALSE	0	TRUE	FALSE	0	0
FBgn0032935	68	85	71	76	139	161	TRUE	TRUE	TRUE	1	TRUE	TRUE	1	1
FBgn0032938	145	183	138	129	283	312	FALSE	TRUE	TRUE	0	TRUE	TRUE	1	0
FBgn0032940	255	231	241	205	496	436	TRUE	FALSE	FALSE	0	TRUE	TRUE	1	0
FBgn0032943	106	116	87	91	193	207	TRUE	TRUE	TRUE	1	TRUE	TRUE	1	1
FBgn0032945	119	139	98	113	217	252	TRUE	TRUE	TRUE	1	TRUE	TRUE	1	1
FBgn0032946	234	295	210	223	444	518	FALSE	TRUE	FALSE	0	TRUE	TRUE	1	0
FBgn0032949	32	19	26	40	58	59	FALSE	TRUE	TRUE	0	FALSE	FALSE	0	0
FBgn0032955	174	213	177	183	351	396	FALSE	TRUE	TRUE	0	TRUE	TRUE	1	0
FBgn0032956	137	105	123	94	260	199	FALSE	FALSE	FALSE	0	TRUE	TRUE	1	0
FBgn0032957	213	223	195	197	408	420	TRUE	TRUE	TRUE	1	TRUE	TRUE	1	1
FBgn0032961	89	106	69	69	158	175	TRUE	TRUE	TRUE	1	TRUE	TRUE	1	1
FBgn0032964	43	55	25	46	68	101	TRUE	FALSE	FALSE	0	TRUE	FALSE	0	0
FBgn0032965	74	65	64	48	138	113	TRUE	TRUE	TRUE	1	TRUE	TRUE	1	1
FBgn0032966	54	43	32	51	86	94	TRUE	FALSE	TRUE	0	TRUE	FALSE	0	0
FBgn0032967	30	46	34	25	64	71	FALSE	TRUE	TRUE	0	FALSE	TRUE	0	0
FBgn0032968	62	44	46	62	108	106	FALSE	TRUE	TRUE	0	TRUE	TRUE	1	0
FBgn0032969	270	289	234	247	504	536	TRUE	TRUE	TRUE	1	TRUE	TRUE	1	1
FBgn0032971	31	35	36	32	67	67	TRUE	TRUE	TRUE	1	TRUE	TRUE	1	1
FBgn0032973	59	59	56	46	115	105	TRUE	TRUE	TRUE	1	TRUE	TRUE	1	1
FBgn0032974	95	85	66	70	161	155	TRUE	TRUE	TRUE	1	TRUE	TRUE	1	1
FBgn0032979	89	102	73	64	162	166	TRUE	TRUE	TRUE	1	TRUE	TRUE	1	1
FBgn0032981	35	43	35	28	70	71	TRUE	TRUE	TRUE	1	TRUE	TRUE	1	1
FBgn0032986	348	362	273	315	621	677	TRUE	FALSE	TRUE	0	TRUE	TRUE	1	0
FBgn0032987	17	21	15	18	32	39	TRUE	TRUE	TRUE	1	TRUE	TRUE	1	1
FBgn0032988	53	52	38	42	91	94	TRUE	TRUE	TRUE	1	TRUE	TRUE	1	1
FBgn0032997	47	53	45	52	92	105	TRUE	TRUE	TRUE	1	TRUE	TRUE	1	1
FBgn0033000	47	49	42	54	89	103	TRUE	TRUE	TRUE	1	TRUE	TRUE	1	1
FBgn0033005	60	71	65	69	125	140	TRUE	TRUE	TRUE	1	TRUE	TRUE	1	1
FBgn0033010	210	213	191	170	401	383	TRUE	TRUE	TRUE	1	TRUE	TRUE	1	1
FBgn0033015	121	142	110	111	231	253	TRUE	TRUE	TRUE	1	TRUE	TRUE	1	1
FBgn0033017	26	24	19	31	45	55	TRUE	TRUE	TRUE	1	TRUE	FALSE	0	0
FBgn0033019	28	20	16	16	44	36	TRUE	TRUE	TRUE	1	TRUE	TRUE	1	1
FBgn0033021	63	52	47	59	110	111	TRUE	TRUE	TRUE	1	TRUE	TRUE	1	1
FBgn0033027	52	50	39	35	91	85	TRUE	TRUE	TRUE	1	TRUE	TRUE	1	1
FBgn0033028	124	112	108	95	232	207	TRUE	TRUE	TRUE	1	TRUE	TRUE	1	1
FBgn0033029	91	96	89	59	180	155	TRUE	FALSE	TRUE	0	TRUE	FALSE	0	0
FBgn0033031	46	63	45	59	91	122	TRUE	TRUE	FALSE	0	TRUE	TRUE	1	0
FBgn0033032	30	32	21	20	51	52	TRUE	TRUE	TRUE	1	TRUE	TRUE	1	1
FBgn0033033	184	216	171	178	355	394	TRUE	TRUE	TRUE	1	TRUE	TRUE	1	1
FBgn0033038	55	43	24	41	79	84	TRUE	FALSE	TRUE	0	TRUE	FALSE	0	0
FBgn0033041	26	39	25	25	51	64	TRUE	TRUE	TRUE	1	TRUE	TRUE	1	1
FBgn0033042	100	99	81	84	181	183	TRUE	TRUE	TRUE	1	TRUE	TRUE	1	1
FBgn0033043	24	27	25	27	49	54	TRUE	TRUE	TRUE	1	TRUE	TRUE	1	1
FBgn0033048	88	84	75	81	163	165	TRUE	TRUE	TRUE	1	TRUE	TRUE	1	1
FBgn0033050	62	53	43	42	105	95	TRUE	TRUE	TRUE	1	TRUE	TRUE	1	1
FBgn0033051	117	130	94	97	211	227	TRUE	TRUE	TRUE	1	TRUE	TRUE	1	1
FBgn0033052	145	155	116	131	261	286	TRUE	TRUE	TRUE	1	TRUE	TRUE	1	1
FBgn0033054	104	85	81	87	185	172	TRUE	TRUE	TRUE	1	TRUE	TRUE	1	1
FBgn0033055	30	26	28	47	58	73	TRUE	FALSE	TRUE	0	TRUE	FALSE	0	0
FBgn0033056	138	130	106	136	244	266	TRUE	FALSE	TRUE	0	TRUE	TRUE	1	0
FBgn0033058	97	120	84	85	181	205	TRUE	TRUE	TRUE	1	TRUE	TRUE	1	1
FBgn0033060	45	36	37	30	82	66	TRUE	TRUE	TRUE	1	TRUE	TRUE	1	1
FBgn0033061	62	54	62	55	124	109	TRUE	TRUE	TRUE	1	TRUE	TRUE	1	1
FBgn0033062	173	135	121	141	294	276	FALSE	TRUE	TRUE	0	TRUE	TRUE	1	0
FBgn0033063	70	73	50	49	120	122	TRUE	TRUE	TRUE	1	TRUE	TRUE	1	1
FBgn0033065	88	97	78	101	166	198	TRUE	FALSE	TRUE	0	TRUE	TRUE	1	0
FBgn0033067	73	42	63	49	136	91	FALSE	TRUE	FALSE	0	FALSE	TRUE	0	0
FBgn0033069	43	44	33	38	76	82	TRUE	TRUE	TRUE	1	TRUE	TRUE	1	1
FBgn0033072	62	46	45	57	107	103	TRUE	TRUE	TRUE	1	TRUE	TRUE	1	1
FBgn0033076	65	45	60	49	125	94	FALSE	TRUE	FALSE	0	TRUE	TRUE	1	0
FBgn0033079	25	21	27	30	52	51	TRUE	TRUE	TRUE	1	TRUE	TRUE	1	1
FBgn0033081	60	55	48	64	108	119	TRUE	TRUE	TRUE	1	TRUE	TRUE	1	1
FBgn0033085	38	69	37	47	75	116	FALSE	TRUE	FALSE	0	FALSE	TRUE	0	0
FBgn0033086	50	66	41	48	91	114	TRUE	TRUE	TRUE	1	TRUE	TRUE	1	1
FBgn0033087	94	91	64	64	158	155	TRUE	TRUE	TRUE	1	TRUE	TRUE	1	1
FBgn0033088	20	30	18	15	38	45	TRUE	TRUE	TRUE	1	TRUE	TRUE	1	1
FBgn0033090	43	45	34	26	77	71	TRUE	TRUE	TRUE	1	TRUE	TRUE	1	1
FBgn0033092	87	68	60	68	147	136	TRUE	TRUE	TRUE	1	TRUE	TRUE	1	1
FBgn0033093	22	29	25	17	47	46	TRUE	TRUE	TRUE	1	TRUE	TRUE	1	1
FBgn0033096	41	47	36	44	77	91	TRUE	TRUE	TRUE	1	TRUE	TRUE	1	1
FBgn0033097	59	44	34	51	93	95	TRUE	FALSE	TRUE	0	TRUE	TRUE	1	0
FBgn0033100	35	45	41	34	76	79	TRUE	TRUE	TRUE	1	TRUE	TRUE	1	1
FBgn0033101	84	91	48	84	132	175	TRUE	FALSE	FALSE	0	TRUE	FALSE	0	0
FBgn0033104	28	33	21	26	49	59	TRUE	TRUE	TRUE	1	TRUE	TRUE	1	1
FBgn0033108	209	178	183	215	392	393	TRUE	TRUE	TRUE	1	TRUE	TRUE	1	1
FBgn0033110	81	88	86	66	167	154	TRUE	TRUE	TRUE	1	TRUE	TRUE	1	1
FBgn0033113	115	118	115	98	230	216	TRUE	TRUE	TRUE	1	TRUE	TRUE	1	1
FBgn0033115	95	110	120	103	215	213	TRUE	TRUE	TRUE	1	TRUE	TRUE	1	1
FBgn0033117	72	54	64	59	136	113	TRUE	TRUE	TRUE	1	TRUE	TRUE	1	1
FBgn0033121	47	35	32	34	79	69	TRUE	TRUE	TRUE	1	TRUE	TRUE	1	1
FBgn0033122	85	118	86	83	171	201	FALSE	TRUE	TRUE	0	TRUE	TRUE	1	0
FBgn0033124	69	38	42	44	111	82	FALSE	TRUE	FALSE	0	FALSE	TRUE	0	0
FBgn0033127	83	89	72	67	155	156	TRUE	TRUE	TRUE	1	TRUE	TRUE	1	1
FBgn0033128	82	84	79	65	161	149	TRUE	TRUE	TRUE	1	TRUE	TRUE	1	1
FBgn0033129	62	57	71	57	133	114	TRUE	TRUE	TRUE	1	TRUE	TRUE	1	1
FBgn0033130	63	55	46	45	109	100	TRUE	TRUE	TRUE	1	TRUE	TRUE	1	1
FBgn0033131	59	51	56	50	115	101	TRUE	TRUE	TRUE	1	TRUE	TRUE	1	1
FBgn0033132	108	102	97	96	205	198	TRUE	TRUE	TRUE	1	TRUE	TRUE	1	1
FBgn0033133	69	73	46	59	115	132	TRUE	TRUE	TRUE	1	TRUE	TRUE	1	1
FBgn0033134	52	63	39	47	91	110	TRUE	TRUE	TRUE	1	TRUE	TRUE	1	1
FBgn0033135	96	59	59	60	155	119	FALSE	TRUE	FALSE	0	FALSE	TRUE	0	0
FBgn0033137	52	54	44	40	96	94	TRUE	TRUE	TRUE	1	TRUE	TRUE	1	1
FBgn0033138	52	49	43	45	95	94	TRUE	TRUE	TRUE	1	TRUE	TRUE	1	1
FBgn0033139	133	98	97	105	230	203	FALSE	TRUE	TRUE	0	TRUE	TRUE	1	0
FBgn0033140	56	54	53	36	109	90	TRUE	FALSE	TRUE	0	TRUE	TRUE	1	0
FBgn0033141	184	202	182	154	366	356	TRUE	TRUE	TRUE	1	TRUE	TRUE	1	1
FBgn0033145	20	15	15	20	35	35	TRUE	TRUE	TRUE	1	TRUE	TRUE	1	1
FBgn0033149	48	71	57	47	105	118	FALSE	TRUE	TRUE	0	TRUE	TRUE	1	0
FBgn0033153	37	37	27	34	64	71	TRUE	TRUE	TRUE	1	TRUE	TRUE	1	1
FBgn0033154	118	107	87	90	205	197	TRUE	TRUE	TRUE	1	TRUE	TRUE	1	1
FBgn0033155	280	232	186	184	466	416	FALSE	TRUE	FALSE	0	TRUE	TRUE	1	0
FBgn0033158	116	113	78	93	194	206	TRUE	TRUE	TRUE	1	TRUE	TRUE	1	1
FBgn0033159	1890	2034	1571	1597	3461	3631	FALSE	TRUE	FALSE	0	TRUE	TRUE	1	0
FBgn0033160	155	156	119	113	274	269	TRUE	TRUE	TRUE	1	TRUE	TRUE	1	1
FBgn0033164	57	53	37	39	94	92	TRUE	TRUE	TRUE	1	TRUE	TRUE	1	1
FBgn0033165	36	37	41	31	77	68	TRUE	TRUE	TRUE	1	TRUE	TRUE	1	1
FBgn0033166	280	267	233	222	513	489	TRUE	TRUE	TRUE	1	TRUE	TRUE	1	1
FBgn0033167	42	27	36	37	78	64	FALSE	TRUE	TRUE	0	FALSE	TRUE	0	0
FBgn0033168	53	67	50	55	103	122	TRUE	TRUE	TRUE	1	TRUE	TRUE	1	1
FBgn0033169	48	56	38	42	86	98	TRUE	TRUE	TRUE	1	TRUE	TRUE	1	1
FBgn0033170	36	20	34	35	70	55	FALSE	TRUE	TRUE	0	FALSE	TRUE	0	0
FBgn0033174	84	87	62	59	146	146	TRUE	TRUE	TRUE	1	TRUE	TRUE	1	1
FBgn0033177	145	135	119	126	264	261	TRUE	TRUE	TRUE	1	TRUE	TRUE	1	1
FBgn0033178	39	44	24	30	63	74	TRUE	TRUE	TRUE	1	TRUE	TRUE	1	1
FBgn0033179	73	88	79	73	152	161	TRUE	TRUE	TRUE	1	TRUE	TRUE	1	1
FBgn0033183	70	56	33	43	103	99	TRUE	TRUE	TRUE	1	TRUE	TRUE	1	1
FBgn0033184	113	129	101	97	214	226	TRUE	TRUE	TRUE	1	TRUE	TRUE	1	1
FBgn0033185	142	147	128	110	270	257	TRUE	TRUE	TRUE	1	TRUE	TRUE	1	1
FBgn0033186	63	91	51	53	114	144	FALSE	TRUE	FALSE	0	TRUE	TRUE	1	0
FBgn0033187	67	72	55	55	122	127	TRUE	TRUE	TRUE	1	TRUE	TRUE	1	1
FBgn0033188	107	129	76	101	183	230	TRUE	FALSE	FALSE	0	TRUE	TRUE	1	0
FBgn0033190	36	25	22	20	58	45	TRUE	TRUE	TRUE	1	TRUE	TRUE	1	1
FBgn0033191	19	24	15	24	34	48	TRUE	TRUE	TRUE	1	TRUE	FALSE	0	0
FBgn0033192	380	397	331	365	711	762	TRUE	TRUE	TRUE	1	TRUE	TRUE	1	1
FBgn0033194	431	396	348	307	779	703	TRUE	TRUE	FALSE	0	TRUE	TRUE	1	0
FBgn0033195	93	85	66	75	159	160	TRUE	TRUE	TRUE	1	TRUE	TRUE	1	1
FBgn0033196	347	295	253	239	600	534	FALSE	TRUE	FALSE	0	TRUE	TRUE	1	0
FBgn0033202	144	98	96	73	240	171	FALSE	FALSE	FALSE	0	TRUE	TRUE	1	0
FBgn0033203	93	72	76	75	169	147	TRUE	TRUE	TRUE	1	TRUE	TRUE	1	1
FBgn0033204	137	119	131	103	268	222	TRUE	FALSE	FALSE	0	TRUE	TRUE	1	0
FBgn0033205	43	70	42	43	85	113	FALSE	TRUE	FALSE	0	FALSE	TRUE	0	0
FBgn0033206	44	41	41	51	85	92	TRUE	TRUE	TRUE	1	TRUE	TRUE	1	1
FBgn0033207	62	38	39	36	101	74	FALSE	TRUE	FALSE	0	FALSE	TRUE	0	0
FBgn0033208	58	59	35	35	93	94	TRUE	TRUE	TRUE	1	TRUE	TRUE	1	1
FBgn0033210	60	47	30	40	90	87	TRUE	TRUE	TRUE	1	TRUE	TRUE	1	1
FBgn0033212	348	387	287	314	635	701	TRUE	TRUE	FALSE	0	TRUE	TRUE	1	0
FBgn0033214	102	102	98	108	200	210	TRUE	TRUE	TRUE	1	TRUE	TRUE	1	1
FBgn0033215	131	98	94	82	225	180	FALSE	TRUE	FALSE	0	TRUE	TRUE	1	0
FBgn0033216	114	115	78	81	192	196	TRUE	TRUE	TRUE	1	TRUE	TRUE	1	1
FBgn0033221	81	111	79	93	160	204	FALSE	TRUE	FALSE	0	TRUE	TRUE	1	0
FBgn0033222	88	72	73	51	161	123	TRUE	FALSE	FALSE	0	TRUE	TRUE	1	0
FBgn0033224	163	155	127	130	290	285	TRUE	TRUE	TRUE	1	TRUE	TRUE	1	1
FBgn0033225	105	96	77	80	182	176	TRUE	TRUE	TRUE	1	TRUE	TRUE	1	1
FBgn0033226	52	54	41	51	93	105	TRUE	TRUE	TRUE	1	TRUE	TRUE	1	1
FBgn0033232	29	22	21	21	50	43	TRUE	TRUE	TRUE	1	TRUE	TRUE	1	1
FBgn0033233	49	53	43	39	92	92	TRUE	TRUE	TRUE	1	TRUE	TRUE	1	1
FBgn0033234	55	36	23	41	78	77	FALSE	FALSE	TRUE	0	FALSE	FALSE	0	0
FBgn0033235	36	54	36	38	72	92	FALSE	TRUE	TRUE	0	TRUE	TRUE	1	0
FBgn0033236	214	211	175	179	389	390	TRUE	TRUE	TRUE	1	TRUE	TRUE	1	1
FBgn0033240	102	148	111	105	213	253	FALSE	TRUE	FALSE	0	TRUE	TRUE	1	0
FBgn0033244	136	160	109	130	245	290	TRUE	TRUE	FALSE	0	TRUE	TRUE	1	0
FBgn0033246	491	528	350	364	841	892	TRUE	TRUE	TRUE	1	TRUE	TRUE	1	1
FBgn0033247	56	57	27	35	83	92	TRUE	TRUE	TRUE	1	TRUE	TRUE	1	1
FBgn0033248	42	47	36	40	78	87	TRUE	TRUE	TRUE	1	TRUE	TRUE	1	1
FBgn0033249	91	91	84	78	175	169	TRUE	TRUE	TRUE	1	TRUE	TRUE	1	1
FBgn0033250	289	260	237	214	526	474	TRUE	TRUE	TRUE	1	TRUE	TRUE	1	1
FBgn0033252	136	158	121	146	257	304	TRUE	TRUE	FALSE	0	TRUE	TRUE	1	0
FBgn0033257	63	47	77	70	140	117	TRUE	TRUE	TRUE	1	TRUE	TRUE	1	1
FBgn0033258	45	63	44	52	89	115	TRUE	TRUE	FALSE	0	TRUE	TRUE	1	0
FBgn0033259	53	71	68	50	121	121	TRUE	TRUE	TRUE	1	TRUE	TRUE	1	1
FBgn0033260	109	103	78	95	187	198	TRUE	TRUE	TRUE	1	TRUE	TRUE	1	1
FBgn0033261	75	65	54	66	129	131	TRUE	TRUE	TRUE	1	TRUE	TRUE	1	1
FBgn0033264	39	56	27	30	66	86	TRUE	TRUE	TRUE	1	TRUE	TRUE	1	1
FBgn0033265	74	45	50	50	124	95	FALSE	TRUE	FALSE	0	FALSE	TRUE	0	0
FBgn0033271	106	104	88	78	194	182	TRUE	TRUE	TRUE	1	TRUE	TRUE	1	1
FBgn0033272	43	35	37	31	80	66	TRUE	TRUE	TRUE	1	TRUE	TRUE	1	1
FBgn0033273	96	87	49	79	145	166	TRUE	FALSE	TRUE	0	TRUE	FALSE	0	0
FBgn0033274	30	22	16	22	46	44	TRUE	TRUE	TRUE	1	TRUE	TRUE	1	1
FBgn0033275	89	71	101	76	190	147	TRUE	FALSE	FALSE	0	TRUE	TRUE	1	0
FBgn0033277	135	130	100	98	235	228	TRUE	TRUE	TRUE	1	TRUE	TRUE	1	1
FBgn0033278	34	28	21	15	55	43	TRUE	TRUE	TRUE	1	TRUE	TRUE	1	1
FBgn0033279	101	79	89	75	190	154	TRUE	TRUE	FALSE	0	TRUE	TRUE	1	0
FBgn0033280	81	70	50	46	131	116	TRUE	TRUE	TRUE	1	TRUE	TRUE	1	1
FBgn0033283	26	30	15	28	41	58	TRUE	FALSE	TRUE	0	TRUE	FALSE	0	0
FBgn0033285	29	55	37	43	66	98	FALSE	TRUE	FALSE	0	FALSE	TRUE	0	0
FBgn0033286	18	26	32	21	50	47	TRUE	TRUE	TRUE	1	TRUE	FALSE	0	0
FBgn0033287	74	65	58	65	132	130	TRUE	TRUE	TRUE	1	TRUE	TRUE	1	1
FBgn0033289	208	202	145	155	353	357	TRUE	TRUE	TRUE	1	TRUE	TRUE	1	1
FBgn0033292	191	186	156	161	347	347	TRUE	TRUE	TRUE	1	TRUE	TRUE	1	1
FBgn0033294	28	30	32	36	60	66	TRUE	TRUE	TRUE	1	TRUE	TRUE	1	1
FBgn0033296	142	150	113	132	255	282	TRUE	TRUE	TRUE	1	TRUE	TRUE	1	1
FBgn0033297	41	44	31	38	72	82	TRUE	TRUE	TRUE	1	TRUE	TRUE	1	1
FBgn0033302	95	82	81	64	176	146	TRUE	TRUE	TRUE	1	TRUE	TRUE	1	1
FBgn0033303	116	116	103	82	219	198	TRUE	TRUE	TRUE	1	TRUE	TRUE	1	1
FBgn0033304	70	61	57	56	127	117	TRUE	TRUE	TRUE	1	TRUE	TRUE	1	1
FBgn0033307	88	79	79	96	167	175	TRUE	TRUE	TRUE	1	TRUE	TRUE	1	1
FBgn0033308	97	81	77	71	174	152	TRUE	TRUE	TRUE	1	TRUE	TRUE	1	1
FBgn0033309	139	151	121	102	260	253	TRUE	TRUE	TRUE	1	TRUE	TRUE	1	1
FBgn0033312	51	43	44	59	95	102	TRUE	TRUE	TRUE	1	TRUE	TRUE	1	1
FBgn0033313	474	430	367	367	841	797	TRUE	TRUE	TRUE	1	TRUE	TRUE	1	1
FBgn0033315	88	75	63	55	151	130	TRUE	TRUE	TRUE	1	TRUE	TRUE	1	1
FBgn0033316	116	83	88	66	204	149	FALSE	FALSE	FALSE	0	TRUE	TRUE	1	0
FBgn0033317	59	50	45	61	104	111	TRUE	TRUE	TRUE	1	TRUE	TRUE	1	1
FBgn0033320	156	162	131	133	287	295	TRUE	TRUE	TRUE	1	TRUE	TRUE	1	1
FBgn0033321	57	61	52	42	109	103	TRUE	TRUE	TRUE	1	TRUE	TRUE	1	1
FBgn0033322	40	29	24	24	64	53	TRUE	TRUE	TRUE	1	TRUE	TRUE	1	1
FBgn0033323	79	82	75	80	154	162	TRUE	TRUE	TRUE	1	TRUE	TRUE	1	1
FBgn0033324	189	157	141	152	330	309	FALSE	TRUE	TRUE	0	TRUE	TRUE	1	0
FBgn0033326	123	112	113	108	236	220	TRUE	TRUE	TRUE	1	TRUE	TRUE	1	1
FBgn0033327	90	116	76	95	166	211	FALSE	TRUE	FALSE	0	TRUE	TRUE	1	0
FBgn0033330	76	73	78	55	154	128	TRUE	FALSE	TRUE	0	TRUE	TRUE	1	0
FBgn0033337	99	81	86	82	185	163	TRUE	TRUE	TRUE	1	TRUE	TRUE	1	1
FBgn0033339	129	128	102	107	231	235	TRUE	TRUE	TRUE	1	TRUE	TRUE	1	1
FBgn0033347	23	32	21	14	44	46	TRUE	TRUE	TRUE	1	TRUE	TRUE	1	1
FBgn0033349	81	101	71	65	152	166	TRUE	TRUE	TRUE	1	TRUE	TRUE	1	1
FBgn0033350	58	50	24	45	82	95	TRUE	FALSE	TRUE	0	TRUE	FALSE	0	0
FBgn0033351	23	18	23	21	46	39	TRUE	TRUE	TRUE	1	TRUE	TRUE	1	1
FBgn0033352	87	89	80	64	167	153	TRUE	TRUE	TRUE	1	TRUE	TRUE	1	1
FBgn0033353	62	53	53	47	115	100	TRUE	TRUE	TRUE	1	TRUE	TRUE	1	1
FBgn0033354	151	155	120	142	271	297	TRUE	TRUE	TRUE	1	TRUE	TRUE	1	1
FBgn0033355	34	38	37	33	71	71	TRUE	TRUE	TRUE	1	TRUE	TRUE	1	1
FBgn0033356	55	55	36	46	91	101	TRUE	TRUE	TRUE	1	TRUE	TRUE	1	1
FBgn0033357	32	39	34	34	66	73	TRUE	TRUE	TRUE	1	TRUE	TRUE	1	1
FBgn0033358	100	107	98	98	198	205	TRUE	TRUE	TRUE	1	TRUE	TRUE	1	1
FBgn0033362	91	87	70	68	161	155	TRUE	TRUE	TRUE	1	TRUE	TRUE	1	1
FBgn0033363	158	161	114	123	272	284	TRUE	TRUE	TRUE	1	TRUE	TRUE	1	1
FBgn0033364	93	95	80	93	173	188	TRUE	TRUE	TRUE	1	TRUE	TRUE	1	1
FBgn0033365	243	242	195	203	438	445	TRUE	TRUE	TRUE	1	TRUE	TRUE	1	1
FBgn0033366	198	193	144	177	342	370	TRUE	FALSE	TRUE	0	TRUE	TRUE	1	0
FBgn0033367	139	137	116	89	255	226	TRUE	FALSE	TRUE	0	TRUE	TRUE	1	0
FBgn0033368	256	202	179	165	435	367	FALSE	TRUE	FALSE	0	TRUE	TRUE	1	0
FBgn0033369	60	68	60	50	120	118	TRUE	TRUE	TRUE	1	TRUE	TRUE	1	1
FBgn0033371	63	72	44	59	107	131	TRUE	TRUE	TRUE	1	TRUE	TRUE	1	1
FBgn0033372	93	76	64	91	157	167	TRUE	FALSE	TRUE	0	TRUE	TRUE	1	0
FBgn0033373	36	36	32	27	68	63	TRUE	TRUE	TRUE	1	TRUE	TRUE	1	1
FBgn0033374	60	83	56	41	116	124	FALSE	TRUE	TRUE	0	TRUE	TRUE	1	0
FBgn0033375	24	21	13	18	37	39	TRUE	TRUE	TRUE	1	TRUE	TRUE	1	1
FBgn0033376	117	138	97	86	214	224	TRUE	TRUE	TRUE	1	TRUE	TRUE	1	1
FBgn0033377	53	49	36	35	89	84	TRUE	TRUE	TRUE	1	TRUE	TRUE	1	1
FBgn0033379	41	39	45	28	86	67	TRUE	FALSE	TRUE	0	TRUE	FALSE	0	0
FBgn0033382	113	110	82	94	195	204	TRUE	TRUE	TRUE	1	TRUE	TRUE	1	1
FBgn0033387	134	127	71	105	205	232	TRUE	FALSE	TRUE	0	TRUE	TRUE	1	0
FBgn0033388	130	127	117	119	247	246	TRUE	TRUE	TRUE	1	TRUE	TRUE	1	1
FBgn0033389	36	33	20	28	56	61	TRUE	TRUE	TRUE	1	TRUE	TRUE	1	1
FBgn0033392	99	108	71	82	170	190	TRUE	TRUE	TRUE	1	TRUE	TRUE	1	1
FBgn0033395	215	226	193	160	408	386	TRUE	FALSE	TRUE	0	TRUE	TRUE	1	0
FBgn0033397	115	123	102	101	217	224	TRUE	TRUE	TRUE	1	TRUE	TRUE	1	1
FBgn0033401	45	41	19	36	64	77	TRUE	FALSE	TRUE	0	TRUE	FALSE	0	0
FBgn0033402	187	180	169	176	356	356	TRUE	TRUE	TRUE	1	TRUE	TRUE	1	1
FBgn0033403	127	121	90	106	217	227	TRUE	TRUE	TRUE	1	TRUE	TRUE	1	1
FBgn0033404	158	165	116	113	274	278	TRUE	TRUE	TRUE	1	TRUE	TRUE	1	1
FBgn0033405	111	99	90	91	201	190	TRUE	TRUE	TRUE	1	TRUE	TRUE	1	1
FBgn0033408	72	53	39	42	111	95	TRUE	TRUE	TRUE	1	TRUE	TRUE	1	1
FBgn0033412	160	156	133	135	293	291	TRUE	TRUE	TRUE	1	TRUE	TRUE	1	1
FBgn0033413	125	117	78	98	203	215	TRUE	TRUE	TRUE	1	TRUE	TRUE	1	1
FBgn0033421	289	316	250	260	539	576	TRUE	TRUE	TRUE	1	TRUE	TRUE	1	1
FBgn0033427	189	173	169	167	358	340	TRUE	TRUE	TRUE	1	TRUE	TRUE	1	1
FBgn0033428	44	54	36	41	80	95	TRUE	TRUE	TRUE	1	TRUE	TRUE	1	1
FBgn0033429	26	19	18	23	44	42	TRUE	TRUE	TRUE	1	TRUE	TRUE	1	1
FBgn0033431	71	100	55	60	126	160	FALSE	TRUE	FALSE	0	TRUE	TRUE	1	0
FBgn0033434	116	99	89	112	205	211	TRUE	TRUE	TRUE	1	TRUE	TRUE	1	1
FBgn0033437	26	13	29	31	55	44	FALSE	TRUE	TRUE	0	FALSE	TRUE	0	0
FBgn0033438	256	261	209	199	465	460	TRUE	TRUE	TRUE	1	TRUE	TRUE	1	1
FBgn0033439	102	121	67	63	169	184	TRUE	TRUE	TRUE	1	TRUE	TRUE	1	1
FBgn0033442	134	116	127	102	261	218	TRUE	TRUE	FALSE	0	TRUE	TRUE	1	0
FBgn0033443	265	311	249	263	514	574	FALSE	TRUE	FALSE	0	TRUE	TRUE	1	0
FBgn0033446	151	150	103	100	254	250	TRUE	TRUE	TRUE	1	TRUE	TRUE	1	1
FBgn0033447	193	194	151	148	344	342	TRUE	TRUE	TRUE	1	TRUE	TRUE	1	1
FBgn0033448	109	95	88	99	197	194	TRUE	TRUE	TRUE	1	TRUE	TRUE	1	1
FBgn0033449	84	101	80	87	164	188	TRUE	TRUE	TRUE	1	TRUE	TRUE	1	1
FBgn0033451	13	25	15	18	28	43	FALSE	TRUE	FALSE	0	FALSE	TRUE	0	0
FBgn0033453	121	90	71	79	192	169	FALSE	TRUE	TRUE	0	TRUE	TRUE	1	0
FBgn0033454	82	99	77	63	159	162	TRUE	TRUE	TRUE	1	TRUE	TRUE	1	1
FBgn0033457	55	63	48	53	103	116	TRUE	TRUE	TRUE	1	TRUE	TRUE	1	1
FBgn0033458	89	93	64	74	153	167	TRUE	TRUE	TRUE	1	TRUE	TRUE	1	1
FBgn0033459	50	53	45	40	95	93	TRUE	TRUE	TRUE	1	TRUE	TRUE	1	1
FBgn0033460	143	154	126	132	269	286	TRUE	TRUE	TRUE	1	TRUE	TRUE	1	1
FBgn0033461	64	69	45	87	109	156	TRUE	FALSE	FALSE	0	TRUE	FALSE	0	0
FBgn0033463	155	157	86	108	241	265	TRUE	TRUE	TRUE	1	TRUE	TRUE	1	1
FBgn0033464	88	81	80	75	168	156	TRUE	TRUE	TRUE	1	TRUE	TRUE	1	1
FBgn0033467	34	33	24	34	58	67	TRUE	TRUE	TRUE	1	TRUE	TRUE	1	1
FBgn0033468	28	45	33	22	61	67	FALSE	TRUE	TRUE	0	FALSE	TRUE	0	0
FBgn0033469	63	59	42	46	105	105	TRUE	TRUE	TRUE	1	TRUE	TRUE	1	1
FBgn0033471	34	25	16	17	50	42	TRUE	TRUE	TRUE	1	TRUE	TRUE	1	1
FBgn0033473	74	81	56	53	130	134	TRUE	TRUE	TRUE	1	TRUE	TRUE	1	1
FBgn0033474	68	55	45	61	113	116	TRUE	TRUE	TRUE	1	TRUE	TRUE	1	1
FBgn0033475	49	54	42	40	91	94	TRUE	TRUE	TRUE	1	TRUE	TRUE	1	1
FBgn0033476	280	316	237	250	517	566	TRUE	TRUE	TRUE	1	TRUE	TRUE	1	1
FBgn0033479	168	133	118	127	286	260	FALSE	TRUE	TRUE	0	TRUE	TRUE	1	0
FBgn0033481	73	74	56	56	129	130	TRUE	TRUE	TRUE	1	TRUE	TRUE	1	1
FBgn0033482	261	226	195	230	456	456	TRUE	FALSE	TRUE	0	TRUE	TRUE	1	0
FBgn0033483	126	123	111	105	237	228	TRUE	TRUE	TRUE	1	TRUE	TRUE	1	1
FBgn0033484	321	319	228	248	549	567	TRUE	TRUE	TRUE	1	TRUE	TRUE	1	1
FBgn0033485	44	38	31	25	75	63	TRUE	TRUE	TRUE	1	TRUE	TRUE	1	1
FBgn0033486	162	173	121	113	283	286	TRUE	TRUE	TRUE	1	TRUE	TRUE	1	1
FBgn0033490	119	120	96	89	215	209	TRUE	TRUE	TRUE	1	TRUE	TRUE	1	1
FBgn0033491	230	247	162	199	392	446	TRUE	FALSE	FALSE	0	TRUE	TRUE	1	0
FBgn0033494	202	229	175	192	377	421	TRUE	TRUE	TRUE	1	TRUE	TRUE	1	1
FBgn0033498	117	91	70	72	187	163	FALSE	TRUE	TRUE	0	TRUE	TRUE	1	0
FBgn0033499	87	80	58	61	145	141	TRUE	TRUE	TRUE	1	TRUE	TRUE	1	1
FBgn0033500	200	209	173	164	373	373	TRUE	TRUE	TRUE	1	TRUE	TRUE	1	1
FBgn0033501	125	150	128	89	253	239	TRUE	FALSE	TRUE	0	TRUE	TRUE	1	0
FBgn0033502	237	242	169	167	406	409	TRUE	TRUE	TRUE	1	TRUE	TRUE	1	1
FBgn0033504	1313	1274	1122	1090	2435	2364	TRUE	TRUE	TRUE	1	TRUE	TRUE	1	1
FBgn0033507	65	88	64	58	129	146	FALSE	TRUE	TRUE	0	TRUE	TRUE	1	0
FBgn0033508	62	64	52	48	114	112	TRUE	TRUE	TRUE	1	TRUE	TRUE	1	1
FBgn0033515	218	201	206	228	424	429	TRUE	TRUE	TRUE	1	TRUE	TRUE	1	1
FBgn0033516	56	52	45	50	101	102	TRUE	TRUE	TRUE	1	TRUE	TRUE	1	1
FBgn0033518	37	29	32	25	69	54	TRUE	TRUE	TRUE	1	TRUE	TRUE	1	1
FBgn0033519	91	86	73	68	164	154	TRUE	TRUE	TRUE	1	TRUE	TRUE	1	1
FBgn0033520	49	57	37	52	86	109	TRUE	TRUE	TRUE	1	TRUE	TRUE	1	1
FBgn0033521	88	40	61	28	149	68	FALSE	FALSE	FALSE	0	FALSE	FALSE	0	0
FBgn0033523	72	59	51	54	123	113	TRUE	TRUE	TRUE	1	TRUE	TRUE	1	1
FBgn0033524	429	396	306	309	735	705	TRUE	TRUE	TRUE	1	TRUE	TRUE	1	1
FBgn0033526	192	175	148	118	340	293	TRUE	FALSE	FALSE	0	TRUE	TRUE	1	0
FBgn0033527	39	33	24	37	63	70	TRUE	TRUE	TRUE	1	TRUE	FALSE	0	0
FBgn0033528	57	50	56	39	113	89	TRUE	TRUE	TRUE	1	TRUE	TRUE	1	1
FBgn0033529	78	79	80	72	158	151	TRUE	TRUE	TRUE	1	TRUE	TRUE	1	1
FBgn0033538	405	383	304	299	709	682	TRUE	TRUE	TRUE	1	TRUE	TRUE	1	1
FBgn0033539	266	277	227	241	493	518	TRUE	TRUE	TRUE	1	TRUE	TRUE	1	1
FBgn0033540	227	212	204	208	431	420	TRUE	TRUE	TRUE	1	TRUE	TRUE	1	1
FBgn0033541	71	69	59	58	130	127	TRUE	TRUE	TRUE	1	TRUE	TRUE	1	1
FBgn0033542	161	175	139	122	300	297	TRUE	TRUE	TRUE	1	TRUE	TRUE	1	1
FBgn0033543	123	120	117	97	240	217	TRUE	TRUE	TRUE	1	TRUE	TRUE	1	1
FBgn0033544	248	232	199	196	447	428	TRUE	TRUE	TRUE	1	TRUE	TRUE	1	1
FBgn0033547	62	55	66	50	128	105	TRUE	TRUE	TRUE	1	TRUE	TRUE	1	1
FBgn0033549	81	79	60	39	141	118	TRUE	FALSE	TRUE	0	TRUE	FALSE	0	0
FBgn0033550	44	53	36	46	80	99	TRUE	TRUE	TRUE	1	TRUE	TRUE	1	1
FBgn0033551	151	129	125	104	276	233	TRUE	TRUE	FALSE	0	TRUE	TRUE	1	0
FBgn0033555	34	33	31	23	65	56	TRUE	TRUE	TRUE	1	TRUE	TRUE	1	1
FBgn0033556	23	20	16	31	39	51	TRUE	FALSE	TRUE	0	TRUE	FALSE	0	0
FBgn0033557	110	151	137	133	247	284	FALSE	TRUE	TRUE	0	TRUE	TRUE	1	0
FBgn0033558	191	185	175	172	366	357	TRUE	TRUE	TRUE	1	TRUE	TRUE	1	1
FBgn0033564	210	216	187	190	397	406	TRUE	TRUE	TRUE	1	TRUE	TRUE	1	1
FBgn0033566	65	55	34	52	99	107	TRUE	FALSE	TRUE	0	TRUE	FALSE	0	0
FBgn0033569	83	70	66	68	149	138	TRUE	TRUE	TRUE	1	TRUE	TRUE	1	1
FBgn0033571	55	45	46	65	101	110	TRUE	FALSE	TRUE	0	TRUE	TRUE	1	0
FBgn0033572	159	125	145	135	304	260	FALSE	TRUE	FALSE	0	TRUE	TRUE	1	0
FBgn0033573	73	65	70	54	143	119	TRUE	TRUE	TRUE	1	TRUE	TRUE	1	1
FBgn0033574	304	319	243	249	547	568	TRUE	TRUE	TRUE	1	TRUE	TRUE	1	1
FBgn0033578	268	255	216	187	484	442	TRUE	TRUE	TRUE	1	TRUE	TRUE	1	1
FBgn0033579	323	343	292	264	615	607	TRUE	TRUE	TRUE	1	TRUE	TRUE	1	1
FBgn0033580	83	61	69	64	152	125	FALSE	TRUE	TRUE	0	TRUE	TRUE	1	0
FBgn0033581	148	177	129	110	277	287	TRUE	TRUE	TRUE	1	TRUE	TRUE	1	1
FBgn0033582	125	134	108	112	233	246	TRUE	TRUE	TRUE	1	TRUE	TRUE	1	1
FBgn0033584	204	226	181	175	385	401	TRUE	TRUE	TRUE	1	TRUE	TRUE	1	1
FBgn0033587	26	28	19	23	45	51	TRUE	TRUE	TRUE	1	TRUE	TRUE	1	1
FBgn0033588	64	51	50	49	114	100	TRUE	TRUE	TRUE	1	TRUE	TRUE	1	1
FBgn0033589	87	65	63	62	150	127	FALSE	TRUE	TRUE	0	TRUE	TRUE	1	0
FBgn0033590	32	42	26	28	58	70	TRUE	TRUE	TRUE	1	TRUE	TRUE	1	1
FBgn0033591	75	67	66	49	141	116	TRUE	TRUE	TRUE	1	TRUE	TRUE	1	1
FBgn0033592	78	103	79	60	157	163	FALSE	TRUE	TRUE	0	TRUE	TRUE	1	0
FBgn0033593	60	65	49	55	109	120	TRUE	TRUE	TRUE	1	TRUE	TRUE	1	1
FBgn0033594	104	106	79	71	183	177	TRUE	TRUE	TRUE	1	TRUE	TRUE	1	1
FBgn0033597	106	116	74	87	180	203	TRUE	TRUE	TRUE	1	TRUE	TRUE	1	1
FBgn0033598	56	62	47	66	103	128	TRUE	FALSE	TRUE	0	TRUE	TRUE	1	0
FBgn0033599	193	180	149	143	342	323	TRUE	TRUE	TRUE	1	TRUE	TRUE	1	1
FBgn0033600	79	85	80	59	159	144	TRUE	FALSE	TRUE	0	TRUE	TRUE	1	0
FBgn0033601	61	87	46	42	107	129	FALSE	TRUE	TRUE	0	TRUE	TRUE	1	0
FBgn0033602	112	122	85	103	197	225	TRUE	TRUE	TRUE	1	TRUE	TRUE	1	1
FBgn0033603	280	307	263	240	543	547	TRUE	TRUE	TRUE	1	TRUE	TRUE	1	1
FBgn0033607	57	72	36	56	93	128	TRUE	FALSE	FALSE	0	TRUE	FALSE	0	0
FBgn0033608	25	31	19	16	44	47	TRUE	TRUE	TRUE	1	TRUE	TRUE	1	1
FBgn0033609	167	167	149	160	316	327	TRUE	TRUE	TRUE	1	TRUE	TRUE	1	1
FBgn0033610	41	40	28	27	69	67	TRUE	TRUE	TRUE	1	TRUE	TRUE	1	1
FBgn0033615	191	167	145	149	336	316	TRUE	TRUE	TRUE	1	TRUE	TRUE	1	1
FBgn0033616	112	102	89	85	201	187	TRUE	TRUE	TRUE	1	TRUE	TRUE	1	1
FBgn0033623	32	26	20	17	52	43	TRUE	TRUE	TRUE	1	TRUE	TRUE	1	1
FBgn0033624	72	58	65	53	137	111	TRUE	TRUE	TRUE	1	TRUE	TRUE	1	1
FBgn0033627	130	147	97	105	227	252	TRUE	TRUE	TRUE	1	TRUE	TRUE	1	1
FBgn0033628	182	198	151	127	333	325	TRUE	TRUE	TRUE	1	TRUE	TRUE	1	1
FBgn0033629	124	112	79	97	203	209	TRUE	TRUE	TRUE	1	TRUE	TRUE	1	1
FBgn0033631	199	161	130	145	329	306	FALSE	TRUE	TRUE	0	TRUE	TRUE	1	0
FBgn0033633	228	178	180	188	408	366	FALSE	TRUE	TRUE	0	TRUE	TRUE	1	0
FBgn0033635	218	195	193	185	411	380	TRUE	TRUE	TRUE	1	TRUE	TRUE	1	1
FBgn0033636	780	768	686	647	1466	1415	TRUE	TRUE	TRUE	1	TRUE	TRUE	1	1
FBgn0033638	549	485	432	423	981	908	FALSE	TRUE	FALSE	0	TRUE	TRUE	1	0
FBgn0033639	299	289	234	222	533	511	TRUE	TRUE	TRUE	1	TRUE	TRUE	1	1
FBgn0033640	94	76	52	64	146	140	TRUE	TRUE	TRUE	1	TRUE	TRUE	1	1
FBgn0033644	79	103	89	84	168	187	FALSE	TRUE	TRUE	0	TRUE	TRUE	1	0
FBgn0033645	197	185	170	171	367	356	TRUE	TRUE	TRUE	1	TRUE	TRUE	1	1
FBgn0033648	155	159	147	126	302	285	TRUE	TRUE	TRUE	1	TRUE	TRUE	1	1
FBgn0033649	217	198	166	147	383	345	TRUE	TRUE	TRUE	1	TRUE	TRUE	1	1
FBgn0033650	95	77	44	64	139	141	TRUE	FALSE	TRUE	0	TRUE	TRUE	1	0
FBgn0033651	139	144	128	145	267	289	TRUE	TRUE	TRUE	1	TRUE	TRUE	1	1
FBgn0033652	499	519	458	376	957	895	TRUE	FALSE	TRUE	0	TRUE	TRUE	1	0
FBgn0033653	93	90	64	80	157	170	TRUE	TRUE	TRUE	1	TRUE	TRUE	1	1
FBgn0033654	254	250	232	203	486	453	TRUE	TRUE	TRUE	1	TRUE	TRUE	1	1
FBgn0033656	123	138	100	113	223	251	TRUE	TRUE	TRUE	1	TRUE	TRUE	1	1
FBgn0033657	131	121	106	115	237	236	TRUE	TRUE	TRUE	1	TRUE	TRUE	1	1
FBgn0033658	33	34	32	29	65	63	TRUE	TRUE	TRUE	1	TRUE	TRUE	1	1
FBgn0033659	137	133	88	84	225	217	TRUE	TRUE	TRUE	1	TRUE	TRUE	1	1
FBgn0033661	990	1022	844	846	1834	1868	TRUE	TRUE	TRUE	1	TRUE	TRUE	1	1
FBgn0033663	99	107	89	87	188	194	TRUE	TRUE	TRUE	1	TRUE	TRUE	1	1
FBgn0033665	98	97	77	84	175	181	TRUE	TRUE	TRUE	1	TRUE	TRUE	1	1
FBgn0033667	186	197	170	170	356	367	TRUE	TRUE	TRUE	1	TRUE	TRUE	1	1
FBgn0033668	253	273	208	213	461	486	TRUE	TRUE	TRUE	1	TRUE	TRUE	1	1
FBgn0033669	18	31	28	26	46	57	FALSE	TRUE	TRUE	0	FALSE	TRUE	0	0
FBgn0033672	64	52	50	49	114	101	TRUE	TRUE	TRUE	1	TRUE	TRUE	1	1
FBgn0033673	166	182	131	114	297	296	TRUE	TRUE	TRUE	1	TRUE	TRUE	1	1
FBgn0033677	40	54	28	41	68	95	TRUE	TRUE	FALSE	0	TRUE	TRUE	1	0
FBgn0033679	201	220	183	167	384	387	TRUE	TRUE	TRUE	1	TRUE	TRUE	1	1
FBgn0033680	50	56	49	50	99	106	TRUE	TRUE	TRUE	1	TRUE	TRUE	1	1
FBgn0033683	40	34	37	51	77	85	TRUE	TRUE	TRUE	1	TRUE	TRUE	1	1
FBgn0033685	44	45	50	29	94	74	TRUE	FALSE	TRUE	0	TRUE	FALSE	0	0
FBgn0033686	95	80	61	51	156	131	TRUE	TRUE	TRUE	1	TRUE	TRUE	1	1
FBgn0033687	41	53	36	45	77	98	TRUE	TRUE	TRUE	1	TRUE	TRUE	1	1
FBgn0033688	330	359	265	293	595	652	TRUE	TRUE	TRUE	1	TRUE	TRUE	1	1
FBgn0033696	21	33	43	22	64	55	TRUE	FALSE	TRUE	0	FALSE	FALSE	0	0
FBgn0033697	80	86	78	64	158	150	TRUE	TRUE	TRUE	1	TRUE	TRUE	1	1
FBgn0033698	341	326	269	294	610	620	TRUE	TRUE	TRUE	1	TRUE	TRUE	1	1
FBgn0033699	60	63	48	44	108	107	TRUE	TRUE	TRUE	1	TRUE	TRUE	1	1
FBgn0033702	294	268	237	240	531	508	TRUE	TRUE	TRUE	1	TRUE	TRUE	1	1
FBgn0033703	48	29	42	41	90	70	FALSE	TRUE	TRUE	0	FALSE	TRUE	0	0
FBgn0033705	72	77	75	70	147	147	TRUE	TRUE	TRUE	1	TRUE	TRUE	1	1
FBgn0033706	107	93	86	97	193	190	TRUE	TRUE	TRUE	1	TRUE	TRUE	1	1
FBgn0033708	65	57	50	53	115	110	TRUE	TRUE	TRUE	1	TRUE	TRUE	1	1
FBgn0033710	236	240	191	172	427	412	TRUE	TRUE	TRUE	1	TRUE	TRUE	1	1
FBgn0033712	112	127	93	90	205	217	TRUE	TRUE	TRUE	1	TRUE	TRUE	1	1
FBgn0033713	188	186	164	155	352	341	TRUE	TRUE	TRUE	1	TRUE	TRUE	1	1
FBgn0033716	42	49	39	37	81	86	TRUE	TRUE	TRUE	1	TRUE	TRUE	1	1
FBgn0033717	215	219	181	152	396	371	TRUE	TRUE	TRUE	1	TRUE	TRUE	1	1
FBgn0033720	191	178	146	123	337	301	TRUE	TRUE	TRUE	1	TRUE	TRUE	1	1
FBgn0033721	27	24	20	12	47	36	TRUE	TRUE	TRUE	1	TRUE	FALSE	0	0
FBgn0033723	56	57	55	38	111	95	TRUE	FALSE	TRUE	0	TRUE	TRUE	1	0
FBgn0033724	66	65	54	50	120	115	TRUE	TRUE	TRUE	1	TRUE	TRUE	1	1
FBgn0033725	157	163	114	113	271	276	TRUE	TRUE	TRUE	1	TRUE	TRUE	1	1
FBgn0033726	92	76	69	82	161	158	TRUE	TRUE	TRUE	1	TRUE	TRUE	1	1
FBgn0033727	63	48	37	51	100	99	TRUE	TRUE	TRUE	1	TRUE	TRUE	1	1
FBgn0033728	99	100	96	86	195	186	TRUE	TRUE	TRUE	1	TRUE	TRUE	1	1
FBgn0033729	80	85	58	71	138	156	TRUE	TRUE	TRUE	1	TRUE	TRUE	1	1
FBgn0033730	41	53	49	39	90	92	TRUE	TRUE	TRUE	1	TRUE	TRUE	1	1
FBgn0033731	38	32	40	35	78	67	TRUE	TRUE	TRUE	1	TRUE	TRUE	1	1
FBgn0033732	155	190	168	175	323	365	FALSE	TRUE	TRUE	0	TRUE	TRUE	1	0
FBgn0033733	106	74	73	74	179	148	FALSE	TRUE	FALSE	0	TRUE	TRUE	1	0
FBgn0033734	147	152	136	113	283	265	TRUE	TRUE	TRUE	1	TRUE	TRUE	1	1
FBgn0033735	117	105	77	74	194	179	TRUE	TRUE	TRUE	1	TRUE	TRUE	1	1
FBgn0033736	51	47	54	52	105	99	TRUE	TRUE	TRUE	1	TRUE	TRUE	1	1
FBgn0033737	86	78	61	68	147	146	TRUE	TRUE	TRUE	1	TRUE	TRUE	1	1
FBgn0033738	188	219	148	163	336	382	TRUE	TRUE	FALSE	0	TRUE	TRUE	1	0
FBgn0033739	297	311	274	264	571	575	TRUE	TRUE	TRUE	1	TRUE	TRUE	1	1
FBgn0033740	104	79	104	91	208	170	FALSE	TRUE	FALSE	0	TRUE	TRUE	1	0
FBgn0033741	143	101	104	101	247	202	FALSE	TRUE	FALSE	0	TRUE	TRUE	1	0
FBgn0033742	120	112	110	108	230	220	TRUE	TRUE	TRUE	1	TRUE	TRUE	1	1
FBgn0033744	240	245	214	186	454	431	TRUE	TRUE	TRUE	1	TRUE	TRUE	1	1
FBgn0033748	90	135	107	120	197	255	FALSE	TRUE	FALSE	0	TRUE	TRUE	1	0
FBgn0033749	175	161	153	142	328	303	TRUE	TRUE	TRUE	1	TRUE	TRUE	1	1
FBgn0033750	94	89	68	72	162	161	TRUE	TRUE	TRUE	1	TRUE	TRUE	1	1
FBgn0033751	30	36	26	24	56	60	TRUE	TRUE	TRUE	1	TRUE	TRUE	1	1
FBgn0033752	162	137	136	115	298	252	TRUE	TRUE	FALSE	0	TRUE	TRUE	1	0
FBgn0033753	160	160	136	155	296	315	TRUE	TRUE	TRUE	1	TRUE	TRUE	1	1
FBgn0033754	44	42	44	38	88	80	TRUE	TRUE	TRUE	1	TRUE	TRUE	1	1
FBgn0033755	85	91	82	95	167	186	TRUE	TRUE	TRUE	1	TRUE	TRUE	1	1
FBgn0033756	224	185	164	165	388	350	FALSE	TRUE	TRUE	0	TRUE	TRUE	1	0
FBgn0033757	231	243	159	190	390	433	TRUE	TRUE	TRUE	1	TRUE	TRUE	1	1
FBgn0033760	180	152	159	144	339	296	TRUE	TRUE	FALSE	0	TRUE	TRUE	1	0
FBgn0033761	120	119	86	80	206	199	TRUE	TRUE	TRUE	1	TRUE	TRUE	1	1
FBgn0033762	220	176	139	140	359	316	FALSE	TRUE	TRUE	0	TRUE	TRUE	1	0
FBgn0033763	237	172	189	161	426	333	FALSE	TRUE	FALSE	0	TRUE	TRUE	1	0
FBgn0033766	425	380	309	325	734	705	TRUE	TRUE	TRUE	1	TRUE	TRUE	1	1
FBgn0033767	125	125	94	110	219	235	TRUE	TRUE	TRUE	1	TRUE	TRUE	1	1
FBgn0033769	132	137	104	139	236	276	TRUE	FALSE	FALSE	0	TRUE	TRUE	1	0
FBgn0033770	102	88	58	64	160	152	TRUE	TRUE	TRUE	1	TRUE	TRUE	1	1
FBgn0033773	70	61	52	57	122	118	TRUE	TRUE	TRUE	1	TRUE	TRUE	1	1
FBgn0033774	151	151	146	127	297	278	TRUE	TRUE	TRUE	1	TRUE	TRUE	1	1
FBgn0033775	162	143	135	133	297	276	TRUE	TRUE	TRUE	1	TRUE	TRUE	1	1
FBgn0033777	230	175	211	145	441	320	FALSE	FALSE	FALSE	0	TRUE	TRUE	1	0
FBgn0033782	94	94	79	81	173	175	TRUE	TRUE	TRUE	1	TRUE	TRUE	1	1
FBgn0033783	180	187	150	154	330	341	TRUE	TRUE	TRUE	1	TRUE	TRUE	1	1
FBgn0033784	71	73	63	61	134	134	TRUE	TRUE	TRUE	1	TRUE	TRUE	1	1
FBgn0033785	146	159	122	138	268	297	TRUE	TRUE	TRUE	1	TRUE	TRUE	1	1
FBgn0033787	262	249	191	190	453	439	TRUE	TRUE	TRUE	1	TRUE	TRUE	1	1
FBgn0033788	181	171	128	131	309	302	TRUE	TRUE	TRUE	1	TRUE	TRUE	1	1
FBgn0033789	72	88	52	50	124	138	TRUE	TRUE	TRUE	1	TRUE	TRUE	1	1
FBgn0033791	470	471	404	415	874	886	TRUE	TRUE	TRUE	1	TRUE	TRUE	1	1
FBgn0033792	422	422	389	333	811	755	TRUE	FALSE	TRUE	0	TRUE	TRUE	1	0
FBgn0033793	61	86	52	70	113	156	FALSE	TRUE	FALSE	0	TRUE	TRUE	1	0
FBgn0033794	61	75	58	55	119	130	TRUE	TRUE	TRUE	1	TRUE	TRUE	1	1
FBgn0033799	125	102	123	129	248	231	TRUE	TRUE	TRUE	1	TRUE	TRUE	1	1
FBgn0033806	136	144	118	134	254	278	TRUE	TRUE	TRUE	1	TRUE	TRUE	1	1
FBgn0033807	174	163	135	141	309	304	TRUE	TRUE	TRUE	1	TRUE	TRUE	1	1
FBgn0033808	69	72	76	61	145	133	TRUE	TRUE	TRUE	1	TRUE	TRUE	1	1
FBgn0033809	236	231	209	206	445	437	TRUE	TRUE	TRUE	1	TRUE	TRUE	1	1
FBgn0033810	64	63	59	80	123	143	TRUE	FALSE	TRUE	0	TRUE	TRUE	1	0
FBgn0033812	66	66	52	60	118	126	TRUE	TRUE	TRUE	1	TRUE	TRUE	1	1
FBgn0033813	58	72	51	74	109	146	TRUE	FALSE	FALSE	0	TRUE	TRUE	1	0
FBgn0033814	184	164	146	129	330	293	TRUE	TRUE	TRUE	1	TRUE	TRUE	1	1
FBgn0033815	72	84	81	80	153	164	TRUE	TRUE	TRUE	1	TRUE	TRUE	1	1
FBgn0033816	122	126	101	99	223	225	TRUE	TRUE	TRUE	1	TRUE	TRUE	1	1
FBgn0033817	169	164	122	122	291	286	TRUE	TRUE	TRUE	1	TRUE	TRUE	1	1
FBgn0033818	173	139	137	123	310	262	FALSE	TRUE	FALSE	0	TRUE	TRUE	1	0
FBgn0033819	161	169	164	148	325	317	TRUE	TRUE	TRUE	1	TRUE	TRUE	1	1
FBgn0033820	64	63	53	54	117	117	TRUE	TRUE	TRUE	1	TRUE	TRUE	1	1
FBgn0033821	44	26	23	32	67	58	FALSE	TRUE	TRUE	0	FALSE	TRUE	0	0
FBgn0033826	149	134	119	118	268	252	TRUE	TRUE	TRUE	1	TRUE	TRUE	1	1
FBgn0033827	217	232	208	209	425	441	TRUE	TRUE	TRUE	1	TRUE	TRUE	1	1
FBgn0033828	82	75	47	55	129	130	TRUE	TRUE	TRUE	1	TRUE	TRUE	1	1
FBgn0033830	161	127	107	138	268	265	FALSE	FALSE	TRUE	0	TRUE	TRUE	1	0
FBgn0033834	185	175	146	134	331	309	TRUE	TRUE	TRUE	1	TRUE	TRUE	1	1
FBgn0033842	139	141	113	104	252	245	TRUE	TRUE	TRUE	1	TRUE	TRUE	1	1
FBgn0033844	261	252	220	232	481	484	TRUE	TRUE	TRUE	1	TRUE	TRUE	1	1
FBgn0033845	262	240	185	188	447	428	TRUE	TRUE	TRUE	1	TRUE	TRUE	1	1
FBgn0033846	254	254	199	211	453	465	TRUE	TRUE	TRUE	1	TRUE	TRUE	1	1
FBgn0033850	187	149	126	102	313	251	FALSE	TRUE	FALSE	0	TRUE	TRUE	1	0
FBgn0033851	119	89	84	95	203	184	FALSE	TRUE	TRUE	0	TRUE	TRUE	1	0
FBgn0033853	281	300	250	249	531	549	TRUE	TRUE	TRUE	1	TRUE	TRUE	1	1
FBgn0033855	140	152	111	98	251	250	TRUE	TRUE	TRUE	1	TRUE	TRUE	1	1
FBgn0033856	225	257	187	180	412	437	TRUE	TRUE	TRUE	1	TRUE	TRUE	1	1
FBgn0033859	274	249	186	218	460	467	TRUE	TRUE	TRUE	1	TRUE	TRUE	1	1
FBgn0033860	140	134	100	108	240	242	TRUE	TRUE	TRUE	1	TRUE	TRUE	1	1
FBgn0033861	66	67	61	56	127	123	TRUE	TRUE	TRUE	1	TRUE	TRUE	1	1
FBgn0033862	131	129	129	142	260	271	TRUE	TRUE	TRUE	1	TRUE	TRUE	1	1
FBgn0033863	212	229	170	194	382	423	TRUE	TRUE	TRUE	1	TRUE	TRUE	1	1
FBgn0033864	366	373	321	313	687	686	TRUE	TRUE	TRUE	1	TRUE	TRUE	1	1
FBgn0033865	101	107	103	81	204	188	TRUE	TRUE	TRUE	1	TRUE	TRUE	1	1
FBgn0033866	422	365	321	335	743	700	FALSE	TRUE	TRUE	0	TRUE	TRUE	1	0
FBgn0033867	327	349	269	303	596	652	TRUE	TRUE	TRUE	1	TRUE	TRUE	1	1
FBgn0033868	125	111	99	109	224	220	TRUE	TRUE	TRUE	1	TRUE	TRUE	1	1
FBgn0033869	179	145	135	117	314	262	FALSE	TRUE	FALSE	0	TRUE	TRUE	1	0
FBgn0033871	85	71	59	63	144	134	TRUE	TRUE	TRUE	1	TRUE	TRUE	1	1
FBgn0033872	213	224	170	191	383	415	TRUE	TRUE	TRUE	1	TRUE	TRUE	1	1
FBgn0033873	105	113	96	85	201	198	TRUE	TRUE	TRUE	1	TRUE	TRUE	1	1
FBgn0033874	132	136	103	103	235	239	TRUE	TRUE	TRUE	1	TRUE	TRUE	1	1
FBgn0033875	136	125	121	122	257	247	TRUE	TRUE	TRUE	1	TRUE	TRUE	1	1
FBgn0033876	179	182	150	152	329	334	TRUE	TRUE	TRUE	1	TRUE	TRUE	1	1
FBgn0033879	99	98	86	91	185	189	TRUE	TRUE	TRUE	1	TRUE	TRUE	1	1
FBgn0033883	82	77	61	84	143	161	TRUE	FALSE	TRUE	0	TRUE	TRUE	1	0
FBgn0033884	153	173	137	143	290	316	TRUE	TRUE	TRUE	1	TRUE	TRUE	1	1
FBgn0033885	60	55	35	56	95	111	TRUE	FALSE	TRUE	0	TRUE	FALSE	0	0
FBgn0033886	119	106	105	102	224	208	TRUE	TRUE	TRUE	1	TRUE	TRUE	1	1
FBgn0033887	87	83	71	71	158	154	TRUE	TRUE	TRUE	1	TRUE	TRUE	1	1
FBgn0033888	71	91	73	49	144	140	TRUE	FALSE	TRUE	0	TRUE	TRUE	1	0
FBgn0033889	291	285	254	212	545	497	TRUE	FALSE	TRUE	0	TRUE	TRUE	1	0
FBgn0033890	183	178	126	122	309	300	TRUE	TRUE	TRUE	1	TRUE	TRUE	1	1
FBgn0033891	110	106	78	86	188	192	TRUE	TRUE	TRUE	1	TRUE	TRUE	1	1
FBgn0033897	224	218	193	211	417	429	TRUE	TRUE	TRUE	1	TRUE	TRUE	1	1
FBgn0033899	50	43	36	34	86	77	TRUE	TRUE	TRUE	1	TRUE	TRUE	1	1
FBgn0033900	48	37	29	25	77	62	TRUE	TRUE	TRUE	1	TRUE	TRUE	1	1
FBgn0033901	14	27	15	22	29	49	FALSE	TRUE	FALSE	0	FALSE	TRUE	0	0
FBgn0033902	91	88	71	77	162	165	TRUE	TRUE	TRUE	1	TRUE	TRUE	1	1
FBgn0033903	64	78	60	53	124	131	TRUE	TRUE	TRUE	1	TRUE	TRUE	1	1
FBgn0033904	50	40	36	41	86	81	TRUE	TRUE	TRUE	1	TRUE	TRUE	1	1
FBgn0033906	103	100	92	103	195	203	TRUE	TRUE	TRUE	1	TRUE	TRUE	1	1
FBgn0033907	16	18	23	21	39	39	TRUE	TRUE	TRUE	1	TRUE	TRUE	1	1
FBgn0033911	64	57	58	61	122	118	TRUE	TRUE	TRUE	1	TRUE	TRUE	1	1
FBgn0033912	83	77	76	71	159	148	TRUE	TRUE	TRUE	1	TRUE	TRUE	1	1
FBgn0033913	187	194	176	163	363	357	TRUE	TRUE	TRUE	1	TRUE	TRUE	1	1
FBgn0033915	152	135	132	120	284	255	TRUE	TRUE	TRUE	1	TRUE	TRUE	1	1
FBgn0033916	165	177	124	123	289	300	TRUE	TRUE	TRUE	1	TRUE	TRUE	1	1
FBgn0033917	98	108	90	81	188	189	TRUE	TRUE	TRUE	1	TRUE	TRUE	1	1
FBgn0033918	67	83	52	50	119	133	TRUE	TRUE	TRUE	1	TRUE	TRUE	1	1
FBgn0033919	243	224	207	184	450	408	TRUE	TRUE	TRUE	1	TRUE	TRUE	1	1
FBgn0033921	153	147	132	124	285	271	TRUE	TRUE	TRUE	1	TRUE	TRUE	1	1
FBgn0033924	217	206	182	187	399	393	TRUE	TRUE	TRUE	1	TRUE	TRUE	1	1
FBgn0033925	63	63	47	55	110	118	TRUE	TRUE	TRUE	1	TRUE	TRUE	1	1
FBgn0033926	80	106	70	103	150	209	FALSE	FALSE	FALSE	0	TRUE	TRUE	1	0
FBgn0033928	87	75	53	56	140	131	TRUE	TRUE	TRUE	1	TRUE	TRUE	1	1
FBgn0033929	73	74	49	57	122	131	TRUE	TRUE	TRUE	1	TRUE	TRUE	1	1
FBgn0033931	73	75	56	48	129	123	TRUE	TRUE	TRUE	1	TRUE	TRUE	1	1
FBgn0033932	302	297	250	236	552	533	TRUE	TRUE	TRUE	1	TRUE	TRUE	1	1
FBgn0033933	114	121	112	99	226	220	TRUE	TRUE	TRUE	1	TRUE	TRUE	1	1
FBgn0033934	146	135	126	137	272	272	TRUE	TRUE	TRUE	1	TRUE	TRUE	1	1
FBgn0033935	126	110	113	92	239	202	TRUE	TRUE	FALSE	0	TRUE	TRUE	1	0
FBgn0033936	297	280	232	235	529	515	TRUE	TRUE	TRUE	1	TRUE	TRUE	1	1
FBgn0033943	284	296	229	254	513	550	TRUE	TRUE	TRUE	1	TRUE	TRUE	1	1
FBgn0033945	47	61	53	44	100	105	TRUE	TRUE	TRUE	1	TRUE	TRUE	1	1
FBgn0033948	132	163	114	109	246	272	FALSE	TRUE	TRUE	0	TRUE	TRUE	1	0
FBgn0033949	103	110	87	77	190	187	TRUE	TRUE	TRUE	1	TRUE	TRUE	1	1
FBgn0033950	54	46	51	56	105	102	TRUE	TRUE	TRUE	1	TRUE	TRUE	1	1
FBgn0033951	72	57	73	49	145	106	TRUE	FALSE	FALSE	0	TRUE	TRUE	1	0
FBgn0033952	161	179	121	131	282	310	TRUE	TRUE	TRUE	1	TRUE	TRUE	1	1
FBgn0033953	90	98	75	71	165	169	TRUE	TRUE	TRUE	1	TRUE	TRUE	1	1
FBgn0033954	44	66	30	48	74	114	FALSE	FALSE	FALSE	0	TRUE	FALSE	0	0
FBgn0033955	133	120	110	105	243	225	TRUE	TRUE	TRUE	1	TRUE	TRUE	1	1
FBgn0033958	411	403	285	342	696	745	TRUE	FALSE	TRUE	0	TRUE	TRUE	1	0
FBgn0033960	201	202	154	151	355	353	TRUE	TRUE	TRUE	1	TRUE	TRUE	1	1
FBgn0033961	31	33	11	20	42	53	TRUE	TRUE	TRUE	1	TRUE	FALSE	0	0
FBgn0033963	111	102	93	87	204	189	TRUE	TRUE	TRUE	1	TRUE	TRUE	1	1
FBgn0033968	122	107	100	99	222	206	TRUE	TRUE	TRUE	1	TRUE	TRUE	1	1
FBgn0033969	177	185	175	147	352	332	TRUE	TRUE	TRUE	1	TRUE	TRUE	1	1
FBgn0033970	78	69	55	58	133	127	TRUE	TRUE	TRUE	1	TRUE	TRUE	1	1
FBgn0033971	193	178	140	144	333	322	TRUE	TRUE	TRUE	1	TRUE	TRUE	1	1
FBgn0033972	83	124	84	65	167	189	FALSE	TRUE	TRUE	0	TRUE	TRUE	1	0
FBgn0033973	122	100	66	84	188	184	TRUE	TRUE	TRUE	1	TRUE	TRUE	1	1
FBgn0033978	102	128	105	100	207	228	FALSE	TRUE	TRUE	0	TRUE	TRUE	1	0
FBgn0033979	104	120	99	88	203	208	TRUE	TRUE	TRUE	1	TRUE	TRUE	1	1
FBgn0033980	81	66	67	71	148	137	TRUE	TRUE	TRUE	1	TRUE	TRUE	1	1
FBgn0033981	123	127	120	85	243	212	TRUE	FALSE	TRUE	0	TRUE	TRUE	1	0
FBgn0033982	173	163	131	134	304	297	TRUE	TRUE	TRUE	1	TRUE	TRUE	1	1
FBgn0033983	271	273	209	243	480	516	TRUE	TRUE	TRUE	1	TRUE	TRUE	1	1
FBgn0033984	387	372	318	296	705	668	TRUE	TRUE	TRUE	1	TRUE	TRUE	1	1
FBgn0033985	156	164	124	108	280	272	TRUE	TRUE	TRUE	1	TRUE	TRUE	1	1
FBgn0033987	442	457	367	337	809	794	TRUE	TRUE	TRUE	1	TRUE	TRUE	1	1
FBgn0033988	155	161	140	147	295	308	TRUE	TRUE	TRUE	1	TRUE	TRUE	1	1
FBgn0033989	172	136	121	125	293	261	FALSE	TRUE	TRUE	0	TRUE	TRUE	1	0
FBgn0033990	103	92	79	57	182	149	TRUE	FALSE	FALSE	0	TRUE	TRUE	1	0
FBgn0033993	147	137	126	134	273	271	TRUE	TRUE	TRUE	1	TRUE	TRUE	1	1
FBgn0033994	107	106	126	106	233	212	TRUE	TRUE	TRUE	1	TRUE	TRUE	1	1
FBgn0033995	163	154	161	144	324	298	TRUE	TRUE	TRUE	1	TRUE	TRUE	1	1
FBgn0033996	112	115	93	105	205	220	TRUE	TRUE	TRUE	1	TRUE	TRUE	1	1
FBgn0033997	90	95	61	70	151	165	TRUE	TRUE	TRUE	1	TRUE	TRUE	1	1
FBgn0033998	219	229	169	180	388	409	TRUE	TRUE	TRUE	1	TRUE	TRUE	1	1
FBgn0033999	76	92	66	65	142	157	TRUE	TRUE	TRUE	1	TRUE	TRUE	1	1
FBgn0034000	53	48	50	35	103	83	TRUE	TRUE	TRUE	1	TRUE	TRUE	1	1
FBgn0034001	49	55	34	39	83	94	TRUE	TRUE	TRUE	1	TRUE	TRUE	1	1
FBgn0034002	172	193	161	162	333	355	TRUE	TRUE	TRUE	1	TRUE	TRUE	1	1
FBgn0034005	224	180	156	177	380	357	FALSE	TRUE	TRUE	0	TRUE	TRUE	1	0
FBgn0034007	120	131	99	108	219	239	TRUE	TRUE	TRUE	1	TRUE	TRUE	1	1
FBgn0034008	112	109	86	111	198	220	TRUE	FALSE	TRUE	0	TRUE	TRUE	1	0
FBgn0034009	114	106	101	105	215	211	TRUE	TRUE	TRUE	1	TRUE	TRUE	1	1
FBgn0034010	51	52	36	44	87	96	TRUE	TRUE	TRUE	1	TRUE	TRUE	1	1
FBgn0034011	74	81	48	49	122	130	TRUE	TRUE	TRUE	1	TRUE	TRUE	1	1
FBgn0034012	276	261	198	218	474	479	TRUE	TRUE	TRUE	1	TRUE	TRUE	1	1
FBgn0034013	349	306	289	260	638	566	TRUE	TRUE	FALSE	0	TRUE	TRUE	1	0
FBgn0034021	80	82	59	96	139	178	TRUE	FALSE	FALSE	0	TRUE	FALSE	0	0
FBgn0034022	335	317	281	311	616	628	TRUE	TRUE	TRUE	1	TRUE	TRUE	1	1
FBgn0034023	173	151	137	147	310	298	TRUE	TRUE	TRUE	1	TRUE	TRUE	1	1
FBgn0034025	220	262	222	193	442	455	FALSE	TRUE	TRUE	0	TRUE	TRUE	1	0
FBgn0034027	54	44	35	43	89	87	TRUE	TRUE	TRUE	1	TRUE	TRUE	1	1
FBgn0034029	85	78	53	64	138	142	TRUE	TRUE	TRUE	1	TRUE	TRUE	1	1
FBgn0034030	127	150	87	123	214	273	TRUE	FALSE	FALSE	0	TRUE	TRUE	1	0
FBgn0034031	457	437	370	386	827	823	TRUE	TRUE	TRUE	1	TRUE	TRUE	1	1
FBgn0034032	157	190	132	158	289	348	FALSE	TRUE	FALSE	0	TRUE	TRUE	1	0
FBgn0034033	73	62	54	65	127	127	TRUE	TRUE	TRUE	1	TRUE	TRUE	1	1
FBgn0034045	255	333	268	233	523	566	FALSE	TRUE	TRUE	0	TRUE	TRUE	1	0
FBgn0034046	260	284	242	245	502	529	TRUE	TRUE	TRUE	1	TRUE	TRUE	1	1
FBgn0034047	111	74	67	67	178	141	FALSE	TRUE	FALSE	0	TRUE	TRUE	1	0
FBgn0034049	481	431	364	355	845	786	TRUE	TRUE	TRUE	1	TRUE	TRUE	1	1
FBgn0034050	69	62	54	55	123	117	TRUE	TRUE	TRUE	1	TRUE	TRUE	1	1
FBgn0034051	143	145	129	164	272	309	TRUE	FALSE	TRUE	0	TRUE	TRUE	1	0
FBgn0034052	95	74	71	49	166	123	TRUE	FALSE	FALSE	0	TRUE	TRUE	1	0
FBgn0034053	120	135	110	87	230	222	TRUE	TRUE	TRUE	1	TRUE	TRUE	1	1
FBgn0034054	36	48	30	51	66	99	TRUE	FALSE	FALSE	0	TRUE	FALSE	0	0
FBgn0034057	123	109	106	104	229	213	TRUE	TRUE	TRUE	1	TRUE	TRUE	1	1
FBgn0034058	45	53	39	49	84	102	TRUE	TRUE	TRUE	1	TRUE	TRUE	1	1
FBgn0034059	22	42	21	32	43	74	FALSE	TRUE	FALSE	0	FALSE	FALSE	0	0
FBgn0034060	349	349	257	239	606	588	TRUE	TRUE	TRUE	1	TRUE	TRUE	1	1
FBgn0034061	65	43	42	33	107	76	FALSE	TRUE	FALSE	0	FALSE	TRUE	0	0
FBgn0034062	155	155	133	132	288	287	TRUE	TRUE	TRUE	1	TRUE	TRUE	1	1
FBgn0034063	146	162	127	118	273	280	TRUE	TRUE	TRUE	1	TRUE	TRUE	1	1
FBgn0034066	86	79	73	67	159	146	TRUE	TRUE	TRUE	1	TRUE	TRUE	1	1
FBgn0034067	193	167	169	158	362	325	TRUE	TRUE	TRUE	1	TRUE	TRUE	1	1
FBgn0034068	156	152	103	133	259	285	TRUE	FALSE	TRUE	0	TRUE	TRUE	1	0
FBgn0034069	97	94	83	78	180	172	TRUE	TRUE	TRUE	1	TRUE	TRUE	1	1
FBgn0034070	517	508	452	429	969	937	TRUE	TRUE	TRUE	1	TRUE	TRUE	1	1
FBgn0034071	390	368	288	298	678	666	TRUE	TRUE	TRUE	1	TRUE	TRUE	1	1
FBgn0034072	709	622	532	541	1241	1163	FALSE	TRUE	TRUE	0	TRUE	TRUE	1	0
FBgn0034073	272	286	220	212	492	498	TRUE	TRUE	TRUE	1	TRUE	TRUE	1	1
FBgn0034075	380	362	293	307	673	669	TRUE	TRUE	TRUE	1	TRUE	TRUE	1	1
FBgn0034076	139	151	125	133	264	284	TRUE	TRUE	TRUE	1	TRUE	TRUE	1	1
FBgn0034081	98	96	87	92	185	188	TRUE	TRUE	TRUE	1	TRUE	TRUE	1	1
FBgn0034082	129	113	123	143	252	256	TRUE	TRUE	TRUE	1	TRUE	TRUE	1	1
FBgn0034083	483	522	423	447	906	969	TRUE	TRUE	TRUE	1	TRUE	TRUE	1	1
FBgn0034084	103	102	78	94	181	196	TRUE	TRUE	TRUE	1	TRUE	TRUE	1	1
FBgn0034085	527	464	412	424	939	888	FALSE	TRUE	TRUE	0	TRUE	TRUE	1	0
FBgn0034086	104	98	91	86	195	184	TRUE	TRUE	TRUE	1	TRUE	TRUE	1	1
FBgn0034087	398	411	309	306	707	717	TRUE	TRUE	TRUE	1	TRUE	TRUE	1	1
FBgn0034091	320	322	253	271	573	593	TRUE	TRUE	TRUE	1	TRUE	TRUE	1	1
FBgn0034093	255	224	189	171	444	395	TRUE	TRUE	FALSE	0	TRUE	TRUE	1	0
FBgn0034094	230	234	177	153	407	387	TRUE	TRUE	TRUE	1	TRUE	TRUE	1	1
FBgn0034095	292	303	243	237	535	540	TRUE	TRUE	TRUE	1	TRUE	TRUE	1	1
FBgn0034096	81	59	57	66	138	125	FALSE	TRUE	TRUE	0	TRUE	TRUE	1	0
FBgn0034097	71	63	56	47	127	110	TRUE	TRUE	TRUE	1	TRUE	TRUE	1	1
FBgn0034098	155	150	111	112	266	262	TRUE	TRUE	TRUE	1	TRUE	TRUE	1	1
FBgn0034099	89	85	63	81	152	166	TRUE	TRUE	TRUE	1	TRUE	TRUE	1	1
FBgn0034103	37	58	58	52	95	110	FALSE	TRUE	TRUE	0	FALSE	TRUE	0	0
FBgn0034104	43	58	48	55	91	113	TRUE	TRUE	TRUE	1	TRUE	TRUE	1	1
FBgn0034105	120	113	88	106	208	219	TRUE	TRUE	TRUE	1	TRUE	TRUE	1	1
FBgn0034106	281	281	272	251	553	532	TRUE	TRUE	TRUE	1	TRUE	TRUE	1	1
FBgn0034109	83	80	67	78	150	158	TRUE	TRUE	TRUE	1	TRUE	TRUE	1	1
FBgn0034110	127	127	106	132	233	259	TRUE	TRUE	TRUE	1	TRUE	TRUE	1	1
FBgn0034113	266	315	252	241	518	556	FALSE	TRUE	TRUE	0	TRUE	TRUE	1	0
FBgn0034114	174	183	129	153	303	336	TRUE	TRUE	TRUE	1	TRUE	TRUE	1	1
FBgn0034117	204	171	161	176	365	347	FALSE	TRUE	TRUE	0	TRUE	TRUE	1	0
FBgn0034118	125	105	83	81	208	186	TRUE	TRUE	TRUE	1	TRUE	TRUE	1	1
FBgn0034120	45	40	43	37	88	77	TRUE	TRUE	TRUE	1	TRUE	TRUE	1	1
FBgn0034121	199	203	188	188	387	391	TRUE	TRUE	TRUE	1	TRUE	TRUE	1	1
FBgn0034122	188	198	149	149	337	347	TRUE	TRUE	TRUE	1	TRUE	TRUE	1	1
FBgn0034126	107	105	80	97	187	202	TRUE	TRUE	TRUE	1	TRUE	TRUE	1	1
FBgn0034127	113	105	83	86	196	191	TRUE	TRUE	TRUE	1	TRUE	TRUE	1	1
FBgn0034128	107	112	97	85	204	197	TRUE	TRUE	TRUE	1	TRUE	TRUE	1	1
FBgn0034129	112	110	91	108	203	218	TRUE	TRUE	TRUE	1	TRUE	TRUE	1	1
FBgn0034131	93	103	69	72	162	175	TRUE	TRUE	TRUE	1	TRUE	TRUE	1	1
FBgn0034132	170	187	174	153	344	340	TRUE	TRUE	TRUE	1	TRUE	TRUE	1	1
FBgn0034135	314	338	254	272	568	610	TRUE	TRUE	TRUE	1	TRUE	TRUE	1	1
FBgn0034136	330	347	297	287	627	634	TRUE	TRUE	TRUE	1	TRUE	TRUE	1	1
FBgn0034137	225	266	162	198	387	464	FALSE	FALSE	FALSE	0	TRUE	TRUE	1	0
FBgn0034138	68	72	65	61	133	133	TRUE	TRUE	TRUE	1	TRUE	TRUE	1	1
FBgn0034139	131	128	129	125	260	253	TRUE	TRUE	TRUE	1	TRUE	TRUE	1	1
FBgn0034140	143	156	113	100	256	256	TRUE	TRUE	TRUE	1	TRUE	TRUE	1	1
FBgn0034141	217	193	195	188	412	381	TRUE	TRUE	TRUE	1	TRUE	TRUE	1	1
FBgn0034142	225	200	219	188	444	388	TRUE	TRUE	FALSE	0	TRUE	TRUE	1	0
FBgn0034143	212	240	172	207	384	447	TRUE	FALSE	FALSE	0	TRUE	TRUE	1	0
FBgn0034144	142	142	107	109	249	251	TRUE	TRUE	TRUE	1	TRUE	TRUE	1	1
FBgn0034145	464	453	366	322	830	775	TRUE	TRUE	TRUE	1	TRUE	TRUE	1	1
FBgn0034151	146	101	125	113	271	214	FALSE	TRUE	FALSE	0	TRUE	TRUE	1	0
FBgn0034152	92	73	65	84	157	157	TRUE	TRUE	TRUE	1	TRUE	TRUE	1	1
FBgn0034153	81	67	47	83	128	150	TRUE	FALSE	TRUE	0	TRUE	FALSE	0	0
FBgn0034154	85	81	55	48	140	129	TRUE	TRUE	TRUE	1	TRUE	TRUE	1	1
FBgn0034156	106	118	112	102	218	220	TRUE	TRUE	TRUE	1	TRUE	TRUE	1	1
FBgn0034157	227	234	181	160	408	394	TRUE	TRUE	TRUE	1	TRUE	TRUE	1	1
FBgn0034158	325	316	276	265	601	581	TRUE	TRUE	TRUE	1	TRUE	TRUE	1	1
FBgn0034159	131	141	135	117	266	258	TRUE	TRUE	TRUE	1	TRUE	TRUE	1	1
FBgn0034160	102	104	96	75	198	179	TRUE	TRUE	TRUE	1	TRUE	TRUE	1	1
FBgn0034162	82	85	85	79	167	164	TRUE	TRUE	TRUE	1	TRUE	TRUE	1	1
FBgn0034165	66	61	45	44	111	105	TRUE	TRUE	TRUE	1	TRUE	TRUE	1	1
FBgn0034166	158	158	148	134	306	292	TRUE	TRUE	TRUE	1	TRUE	TRUE	1	1
FBgn0034168	50	43	44	41	94	84	TRUE	TRUE	TRUE	1	TRUE	TRUE	1	1
FBgn0034172	85	101	73	74	158	175	TRUE	TRUE	TRUE	1	TRUE	TRUE	1	1
FBgn0034173	22	24	26	22	48	46	TRUE	TRUE	TRUE	1	TRUE	TRUE	1	1
FBgn0034175	36	45	46	35	82	80	TRUE	TRUE	TRUE	1	TRUE	TRUE	1	1
FBgn0034176	66	42	41	46	107	88	FALSE	TRUE	TRUE	0	FALSE	TRUE	0	0
FBgn0034177	107	96	73	98	180	194	TRUE	FALSE	TRUE	0	TRUE	TRUE	1	0
FBgn0034179	135	139	117	128	252	267	TRUE	TRUE	TRUE	1	TRUE	TRUE	1	1
FBgn0034180	402	354	295	308	697	662	FALSE	TRUE	TRUE	0	TRUE	TRUE	1	0
FBgn0034181	137	158	112	119	249	277	TRUE	TRUE	TRUE	1	TRUE	TRUE	1	1
FBgn0034182	63	61	51	51	114	112	TRUE	TRUE	TRUE	1	TRUE	TRUE	1	1
FBgn0034183	61	72	54	73	115	145	TRUE	TRUE	FALSE	0	TRUE	TRUE	1	0
FBgn0034184	192	197	161	152	353	349	TRUE	TRUE	TRUE	1	TRUE	TRUE	1	1
FBgn0034186	138	132	138	95	276	227	TRUE	FALSE	FALSE	0	TRUE	TRUE	1	0
FBgn0034187	119	127	127	125	246	252	TRUE	TRUE	TRUE	1	TRUE	TRUE	1	1
FBgn0034191	62	65	65	48	127	113	TRUE	TRUE	TRUE	1	TRUE	TRUE	1	1
FBgn0034194	164	155	131	144	295	299	TRUE	TRUE	TRUE	1	TRUE	TRUE	1	1
FBgn0034197	147	147	111	121	258	268	TRUE	TRUE	TRUE	1	TRUE	TRUE	1	1
FBgn0034198	88	122	88	80	176	202	FALSE	TRUE	TRUE	0	TRUE	TRUE	1	0
FBgn0034199	27	26	25	27	52	53	TRUE	TRUE	TRUE	1	TRUE	TRUE	1	1
FBgn0034200	166	179	150	125	316	304	TRUE	TRUE	TRUE	1	TRUE	TRUE	1	1
FBgn0034201	139	134	124	100	263	234	TRUE	TRUE	TRUE	1	TRUE	TRUE	1	1
FBgn0034202	58	60	50	46	108	106	TRUE	TRUE	TRUE	1	TRUE	TRUE	1	1
FBgn0034204	124	87	70	67	194	154	FALSE	TRUE	FALSE	0	TRUE	TRUE	1	0
FBgn0034205	128	115	113	131	241	246	TRUE	TRUE	TRUE	1	TRUE	TRUE	1	1
FBgn0034206	59	54	64	42	123	96	TRUE	FALSE	FALSE	0	TRUE	FALSE	0	0
FBgn0034210	156	157	170	135	326	292	TRUE	FALSE	TRUE	0	TRUE	TRUE	1	0
FBgn0034214	57	44	51	36	108	80	TRUE	TRUE	FALSE	0	TRUE	TRUE	1	0
FBgn0034215	94	73	67	72	161	145	TRUE	TRUE	TRUE	1	TRUE	TRUE	1	1
FBgn0034217	31	26	24	18	55	44	TRUE	TRUE	TRUE	1	TRUE	TRUE	1	1
FBgn0034218	147	143	118	91	265	234	TRUE	FALSE	TRUE	0	TRUE	TRUE	1	0
FBgn0034219	159	189	144	142	303	331	TRUE	TRUE	TRUE	1	TRUE	TRUE	1	1
FBgn0034221	179	207	152	146	331	353	TRUE	TRUE	TRUE	1	TRUE	TRUE	1	1
FBgn0034223	231	243	172	209	403	452	TRUE	FALSE	TRUE	0	TRUE	TRUE	1	0
FBgn0034224	89	68	46	70	135	138	TRUE	FALSE	TRUE	0	TRUE	FALSE	0	0
FBgn0034229	180	154	131	139	311	293	TRUE	TRUE	TRUE	1	TRUE	TRUE	1	1
FBgn0034230	190	205	179	170	369	375	TRUE	TRUE	TRUE	1	TRUE	TRUE	1	1
FBgn0034232	39	50	42	40	81	90	TRUE	TRUE	TRUE	1	TRUE	TRUE	1	1
FBgn0034237	215	224	185	203	400	427	TRUE	TRUE	TRUE	1	TRUE	TRUE	1	1
FBgn0034240	326	351	313	286	639	637	TRUE	TRUE	TRUE	1	TRUE	TRUE	1	1
FBgn0034243	113	119	78	116	191	235	TRUE	FALSE	FALSE	0	TRUE	TRUE	1	0
FBgn0034246	232	230	195	190	427	420	TRUE	TRUE	TRUE	1	TRUE	TRUE	1	1
FBgn0034247	67	50	46	53	113	103	TRUE	TRUE	TRUE	1	TRUE	TRUE	1	1
FBgn0034249	149	149	117	124	266	273	TRUE	TRUE	TRUE	1	TRUE	TRUE	1	1
FBgn0034251	160	188	147	149	307	337	TRUE	TRUE	TRUE	1	TRUE	TRUE	1	1
FBgn0034253	419	420	373	346	792	766	TRUE	TRUE	TRUE	1	TRUE	TRUE	1	1
FBgn0034255	35	25	18	25	53	50	TRUE	TRUE	TRUE	1	TRUE	TRUE	1	1
FBgn0034258	132	144	103	137	235	281	TRUE	FALSE	FALSE	0	TRUE	TRUE	1	0
FBgn0034259	84	94	70	92	154	186	TRUE	FALSE	FALSE	0	TRUE	TRUE	1	0
FBgn0034261	307	292	243	232	550	524	TRUE	TRUE	TRUE	1	TRUE	TRUE	1	1
FBgn0034262	197	217	151	147	348	364	TRUE	TRUE	TRUE	1	TRUE	TRUE	1	1
FBgn0034263	40	47	37	27	77	74	TRUE	TRUE	TRUE	1	TRUE	TRUE	1	1
FBgn0034264	100	91	74	70	174	161	TRUE	TRUE	TRUE	1	TRUE	TRUE	1	1
FBgn0034265	107	134	116	131	223	265	FALSE	TRUE	FALSE	0	TRUE	TRUE	1	0
FBgn0034267	36	35	25	30	61	65	TRUE	TRUE	TRUE	1	TRUE	TRUE	1	1
FBgn0034269	191	196	148	159	339	355	TRUE	TRUE	TRUE	1	TRUE	TRUE	1	1
FBgn0034270	99	92	65	67	164	159	TRUE	TRUE	TRUE	1	TRUE	TRUE	1	1
FBgn0034271	158	149	102	136	260	285	TRUE	FALSE	TRUE	0	TRUE	TRUE	1	0
FBgn0034272	104	111	95	59	199	170	TRUE	FALSE	TRUE	0	TRUE	FALSE	0	0
FBgn0034274	71	65	63	57	134	122	TRUE	TRUE	TRUE	1	TRUE	TRUE	1	1
FBgn0034275	266	303	244	205	510	508	TRUE	FALSE	TRUE	0	TRUE	TRUE	1	0
FBgn0034276	163	171	165	137	328	308	TRUE	TRUE	TRUE	1	TRUE	TRUE	1	1
FBgn0034277	98	93	82	67	180	160	TRUE	TRUE	TRUE	1	TRUE	TRUE	1	1
FBgn0034278	45	46	30	41	75	87	TRUE	TRUE	TRUE	1	TRUE	TRUE	1	1
FBgn0034279	196	184	139	138	335	322	TRUE	TRUE	TRUE	1	TRUE	TRUE	1	1
FBgn0034281	24	38	17	16	41	54	FALSE	TRUE	TRUE	0	FALSE	TRUE	0	0
FBgn0034282	130	129	109	123	239	252	TRUE	TRUE	TRUE	1	TRUE	TRUE	1	1
FBgn0034283	65	65	55	59	120	124	TRUE	TRUE	TRUE	1	TRUE	TRUE	1	1
FBgn0034284	59	71	55	50	114	121	TRUE	TRUE	TRUE	1	TRUE	TRUE	1	1
FBgn0034286	206	237	167	185	373	422	TRUE	TRUE	FALSE	0	TRUE	TRUE	1	0
FBgn0034288	117	104	118	109	235	213	TRUE	TRUE	TRUE	1	TRUE	TRUE	1	1
FBgn0034289	110	89	75	82	185	171	TRUE	TRUE	TRUE	1	TRUE	TRUE	1	1
FBgn0034290	114	114	82	91	196	205	TRUE	TRUE	TRUE	1	TRUE	TRUE	1	1
FBgn0034291	86	68	39	63	125	131	TRUE	FALSE	TRUE	0	TRUE	FALSE	0	0
FBgn0034292	73	79	79	75	152	154	TRUE	TRUE	TRUE	1	TRUE	TRUE	1	1
FBgn0034293	77	91	74	65	151	156	TRUE	TRUE	TRUE	1	TRUE	TRUE	1	1
FBgn0034294	148	122	124	109	272	231	TRUE	TRUE	FALSE	0	TRUE	TRUE	1	0
FBgn0034295	127	127	111	117	238	244	TRUE	TRUE	TRUE	1	TRUE	TRUE	1	1
FBgn0034296	75	76	61	74	136	150	TRUE	TRUE	TRUE	1	TRUE	TRUE	1	1
FBgn0034299	81	51	47	42	128	93	FALSE	TRUE	FALSE	0	FALSE	TRUE	0	0
FBgn0034300	308	340	281	264	589	604	TRUE	TRUE	TRUE	1	TRUE	TRUE	1	1
FBgn0034301	311	296	252	225	563	521	TRUE	TRUE	TRUE	1	TRUE	TRUE	1	1
FBgn0034304	172	184	127	155	299	339	TRUE	TRUE	TRUE	1	TRUE	TRUE	1	1
FBgn0034307	127	162	118	87	245	249	FALSE	FALSE	TRUE	0	TRUE	TRUE	1	0
FBgn0034308	213	240	124	151	337	391	TRUE	TRUE	FALSE	0	TRUE	TRUE	1	0
FBgn0034310	128	140	94	99	222	239	TRUE	TRUE	TRUE	1	TRUE	TRUE	1	1
FBgn0034312	40	28	44	38	84	66	TRUE	TRUE	TRUE	1	TRUE	TRUE	1	1
FBgn0034313	184	164	153	170	337	334	TRUE	TRUE	TRUE	1	TRUE	TRUE	1	1
FBgn0034314	63	76	76	63	139	139	TRUE	TRUE	TRUE	1	TRUE	TRUE	1	1
FBgn0034315	36	32	29	19	65	51	TRUE	TRUE	TRUE	1	TRUE	FALSE	0	0
FBgn0034317	45	49	28	36	73	85	TRUE	TRUE	TRUE	1	TRUE	TRUE	1	1
FBgn0034318	99	85	62	67	161	152	TRUE	TRUE	TRUE	1	TRUE	TRUE	1	1
FBgn0034321	165	173	183	149	348	322	TRUE	FALSE	TRUE	0	TRUE	TRUE	1	0
FBgn0034322	89	76	74	75	163	151	TRUE	TRUE	TRUE	1	TRUE	TRUE	1	1
FBgn0034323	76	76	72	66	148	142	TRUE	TRUE	TRUE	1	TRUE	TRUE	1	1
FBgn0034324	59	72	68	42	127	114	TRUE	FALSE	TRUE	0	TRUE	FALSE	0	0
FBgn0034325	69	95	59	55	128	150	FALSE	TRUE	TRUE	0	TRUE	TRUE	1	0
FBgn0034326	62	50	50	58	112	108	TRUE	TRUE	TRUE	1	TRUE	TRUE	1	1
FBgn0034327	55	61	57	42	112	103	TRUE	TRUE	TRUE	1	TRUE	TRUE	1	1
FBgn0034328	72	63	51	57	123	120	TRUE	TRUE	TRUE	1	TRUE	TRUE	1	1
FBgn0034329	41	54	52	60	93	114	TRUE	TRUE	TRUE	1	TRUE	TRUE	1	1
FBgn0034330	26	29	24	19	50	48	TRUE	TRUE	TRUE	1	TRUE	TRUE	1	1
FBgn0034331	48	55	48	74	96	129	TRUE	FALSE	FALSE	0	TRUE	FALSE	0	0
FBgn0034335	98	74	70	57	168	131	FALSE	TRUE	FALSE	0	TRUE	TRUE	1	0
FBgn0034345	173	180	165	163	338	343	TRUE	TRUE	TRUE	1	TRUE	TRUE	1	1
FBgn0034346	265	250	186	194	451	444	TRUE	TRUE	TRUE	1	TRUE	TRUE	1	1
FBgn0034351	63	71	63	61	126	132	TRUE	TRUE	TRUE	1	TRUE	TRUE	1	1
FBgn0034352	119	152	104	90	223	242	FALSE	TRUE	TRUE	0	TRUE	TRUE	1	0
FBgn0034354	117	98	84	71	201	169	TRUE	TRUE	TRUE	1	TRUE	TRUE	1	1
FBgn0034356	228	246	177	177	405	423	TRUE	TRUE	TRUE	1	TRUE	TRUE	1	1
FBgn0034360	73	63	56	62	129	125	TRUE	TRUE	TRUE	1	TRUE	TRUE	1	1
FBgn0034361	49	56	50	53	99	109	TRUE	TRUE	TRUE	1	TRUE	TRUE	1	1
FBgn0034362	50	56	42	49	92	105	TRUE	TRUE	TRUE	1	TRUE	TRUE	1	1
FBgn0034363	49	58	42	41	91	99	TRUE	TRUE	TRUE	1	TRUE	TRUE	1	1
FBgn0034364	32	32	39	36	71	68	TRUE	TRUE	TRUE	1	TRUE	TRUE	1	1
FBgn0034365	87	95	83	81	170	176	TRUE	TRUE	TRUE	1	TRUE	TRUE	1	1
FBgn0034366	294	220	206	204	500	424	FALSE	TRUE	FALSE	0	TRUE	TRUE	1	0
FBgn0034368	134	144	106	119	240	263	TRUE	TRUE	TRUE	1	TRUE	TRUE	1	1
FBgn0034371	173	171	143	147	316	318	TRUE	TRUE	TRUE	1	TRUE	TRUE	1	1
FBgn0034377	78	59	63	78	141	137	TRUE	TRUE	TRUE	1	TRUE	TRUE	1	1
FBgn0034379	131	118	152	109	283	227	TRUE	FALSE	FALSE	0	TRUE	TRUE	1	0
FBgn0034380	195	205	170	158	365	363	TRUE	TRUE	TRUE	1	TRUE	TRUE	1	1
FBgn0034381	167	131	134	155	301	286	FALSE	TRUE	TRUE	0	TRUE	TRUE	1	0
FBgn0034382	77	82	65	75	142	157	TRUE	TRUE	TRUE	1	TRUE	TRUE	1	1
FBgn0034383	108	109	96	91	204	200	TRUE	TRUE	TRUE	1	TRUE	TRUE	1	1
FBgn0034387	201	199	164	149	365	348	TRUE	TRUE	TRUE	1	TRUE	TRUE	1	1
FBgn0034389	457	480	405	385	862	865	TRUE	TRUE	TRUE	1	TRUE	TRUE	1	1
FBgn0034391	444	494	359	395	803	889	TRUE	TRUE	FALSE	0	TRUE	TRUE	1	0
FBgn0034392	150	152	132	120	282	272	TRUE	TRUE	TRUE	1	TRUE	TRUE	1	1
FBgn0034394	206	188	163	166	369	354	TRUE	TRUE	TRUE	1	TRUE	TRUE	1	1
FBgn0034396	288	318	220	241	508	559	TRUE	TRUE	TRUE	1	TRUE	TRUE	1	1
FBgn0034397	172	177	131	134	303	311	TRUE	TRUE	TRUE	1	TRUE	TRUE	1	1
FBgn0034398	41	38	35	35	76	73	TRUE	TRUE	TRUE	1	TRUE	TRUE	1	1
FBgn0034399	46	31	47	42	93	73	TRUE	TRUE	TRUE	1	TRUE	TRUE	1	1
FBgn0034400	453	486	369	368	822	854	TRUE	TRUE	TRUE	1	TRUE	TRUE	1	1
FBgn0034401	153	163	147	171	300	334	TRUE	TRUE	TRUE	1	TRUE	TRUE	1	1
FBgn0034402	59	35	32	43	91	78	FALSE	TRUE	TRUE	0	FALSE	TRUE	0	0
FBgn0034403	74	89	68	71	142	160	TRUE	TRUE	TRUE	1	TRUE	TRUE	1	1
FBgn0034405	179	185	159	147	338	332	TRUE	TRUE	TRUE	1	TRUE	TRUE	1	1
FBgn0034406	141	127	105	135	246	262	TRUE	FALSE	TRUE	0	TRUE	TRUE	1	0
FBgn0034407	20	19	11	35	31	54	TRUE	FALSE	FALSE	0	TRUE	FALSE	0	0
FBgn0034408	419	440	399	361	818	801	TRUE	TRUE	TRUE	1	TRUE	TRUE	1	1
FBgn0034411	42	31	29	25	71	56	TRUE	TRUE	TRUE	1	TRUE	TRUE	1	1
FBgn0034413	105	105	68	88	173	193	TRUE	TRUE	TRUE	1	TRUE	TRUE	1	1
FBgn0034415	50	70	64	66	114	136	FALSE	TRUE	TRUE	0	TRUE	TRUE	1	0
FBgn0034416	121	112	113	102	234	214	TRUE	TRUE	TRUE	1	TRUE	TRUE	1	1
FBgn0034417	303	294	244	221	547	515	TRUE	TRUE	TRUE	1	TRUE	TRUE	1	1
FBgn0034418	246	260	181	207	427	467	TRUE	TRUE	TRUE	1	TRUE	TRUE	1	1
FBgn0034419	179	195	160	130	339	325	TRUE	FALSE	TRUE	0	TRUE	TRUE	1	0
FBgn0034420	654	683	527	564	1181	1247	TRUE	TRUE	TRUE	1	TRUE	TRUE	1	1
FBgn0034422	93	85	75	68	168	153	TRUE	TRUE	TRUE	1	TRUE	TRUE	1	1
FBgn0034423	103	97	89	78	192	175	TRUE	TRUE	TRUE	1	TRUE	TRUE	1	1
FBgn0034425	184	205	180	167	364	372	TRUE	TRUE	TRUE	1	TRUE	TRUE	1	1
FBgn0034426	40	54	26	48	66	102	TRUE	FALSE	FALSE	0	TRUE	FALSE	0	0
FBgn0034427	108	93	81	88	189	181	TRUE	TRUE	TRUE	1	TRUE	TRUE	1	1
FBgn0034428	98	114	136	99	234	213	TRUE	FALSE	TRUE	0	TRUE	TRUE	1	0
FBgn0034429	63	59	51	41	114	100	TRUE	TRUE	TRUE	1	TRUE	TRUE	1	1
FBgn0034430	74	90	73	60	147	150	TRUE	TRUE	TRUE	1	TRUE	TRUE	1	1
FBgn0034432	184	143	121	137	305	280	FALSE	TRUE	TRUE	0	TRUE	TRUE	1	0
FBgn0034433	153	153	121	123	274	276	TRUE	TRUE	TRUE	1	TRUE	TRUE	1	1
FBgn0034435	283	291	233	241	516	532	TRUE	TRUE	TRUE	1	TRUE	TRUE	1	1
FBgn0034436	441	443	366	380	807	823	TRUE	TRUE	TRUE	1	TRUE	TRUE	1	1
FBgn0034437	278	253	242	189	520	442	TRUE	FALSE	FALSE	0	TRUE	TRUE	1	0
FBgn0034438	291	329	248	265	539	594	TRUE	TRUE	TRUE	1	TRUE	TRUE	1	1
FBgn0034439	304	335	278	281	582	616	TRUE	TRUE	TRUE	1	TRUE	TRUE	1	1
FBgn0034440	433	365	290	270	723	635	FALSE	TRUE	FALSE	0	TRUE	TRUE	1	0
FBgn0034441	334	335	275	257	609	592	TRUE	TRUE	TRUE	1	TRUE	TRUE	1	1
FBgn0034442	150	165	117	118	267	283	TRUE	TRUE	TRUE	1	TRUE	TRUE	1	1
FBgn0034443	24	21	22	27	46	48	TRUE	TRUE	TRUE	1	TRUE	TRUE	1	1
FBgn0034446	44	47	49	44	93	91	TRUE	TRUE	TRUE	1	TRUE	TRUE	1	1
FBgn0034447	182	172	133	165	315	337	TRUE	FALSE	TRUE	0	TRUE	TRUE	1	0
FBgn0034451	87	85	73	82	160	167	TRUE	TRUE	TRUE	1	TRUE	TRUE	1	1
FBgn0034452	331	336	315	299	646	635	TRUE	TRUE	TRUE	1	TRUE	TRUE	1	1
FBgn0034454	100	100	72	61	172	161	TRUE	TRUE	TRUE	1	TRUE	TRUE	1	1
FBgn0034455	139	166	98	119	237	285	TRUE	TRUE	FALSE	0	TRUE	TRUE	1	0
FBgn0034456	144	129	104	110	248	239	TRUE	TRUE	TRUE	1	TRUE	TRUE	1	1
FBgn0034457	149	175	130	145	279	320	TRUE	TRUE	TRUE	1	TRUE	TRUE	1	1
FBgn0034458	185	193	155	150	340	343	TRUE	TRUE	TRUE	1	TRUE	TRUE	1	1
FBgn0034459	161	200	176	132	337	332	FALSE	FALSE	TRUE	0	TRUE	TRUE	1	0
FBgn0034460	55	64	36	43	91	107	TRUE	TRUE	TRUE	1	TRUE	TRUE	1	1
FBgn0034461	50	92	70	53	120	145	FALSE	TRUE	TRUE	0	FALSE	TRUE	0	0
FBgn0034462	124	118	106	121	230	239	TRUE	TRUE	TRUE	1	TRUE	TRUE	1	1
FBgn0034463	116	126	84	78	200	204	TRUE	TRUE	TRUE	1	TRUE	TRUE	1	1
FBgn0034464	140	118	117	112	257	230	TRUE	TRUE	TRUE	1	TRUE	TRUE	1	1
FBgn0034467	209	251	164	159	373	410	FALSE	TRUE	TRUE	0	TRUE	TRUE	1	0
FBgn0034468	84	69	75	84	159	153	TRUE	TRUE	TRUE	1	TRUE	TRUE	1	1
FBgn0034470	147	137	127	88	274	225	TRUE	FALSE	FALSE	0	TRUE	TRUE	1	0
FBgn0034472	36	56	33	45	69	101	FALSE	TRUE	FALSE	0	FALSE	TRUE	0	0
FBgn0034473	70	52	38	54	108	106	TRUE	TRUE	TRUE	1	TRUE	TRUE	1	1
FBgn0034474	69	44	67	54	136	98	FALSE	TRUE	FALSE	0	FALSE	TRUE	0	0
FBgn0034475	56	61	64	71	120	132	TRUE	TRUE	TRUE	1	TRUE	TRUE	1	1
FBgn0034476	382	426	315	339	697	765	TRUE	TRUE	FALSE	0	TRUE	TRUE	1	0
FBgn0034477	159	136	124	141	283	277	TRUE	TRUE	TRUE	1	TRUE	TRUE	1	1
FBgn0034478	61	62	48	54	109	116	TRUE	TRUE	TRUE	1	TRUE	TRUE	1	1
FBgn0034479	212	243	180	196	392	439	TRUE	TRUE	TRUE	1	TRUE	TRUE	1	1
FBgn0034480	50	53	49	39	99	92	TRUE	TRUE	TRUE	1	TRUE	TRUE	1	1
FBgn0034481	71	86	73	72	144	158	TRUE	TRUE	TRUE	1	TRUE	TRUE	1	1
FBgn0034483	53	59	39	63	92	122	TRUE	FALSE	FALSE	0	TRUE	FALSE	0	0
FBgn0034484	194	168	137	133	331	301	TRUE	TRUE	TRUE	1	TRUE	TRUE	1	1
FBgn0034485	149	155	130	129	279	284	TRUE	TRUE	TRUE	1	TRUE	TRUE	1	1
FBgn0034486	29	19	15	17	44	36	TRUE	TRUE	TRUE	1	FALSE	TRUE	0	0
FBgn0034487	192	161	150	141	342	302	TRUE	TRUE	TRUE	1	TRUE	TRUE	1	1
FBgn0034488	157	152	129	139	286	291	TRUE	TRUE	TRUE	1	TRUE	TRUE	1	1
FBgn0034489	180	187	174	143	354	330	TRUE	FALSE	TRUE	0	TRUE	TRUE	1	0
FBgn0034490	170	165	155	169	325	334	TRUE	TRUE	TRUE	1	TRUE	TRUE	1	1
FBgn0034491	170	185	129	123	299	308	TRUE	TRUE	TRUE	1	TRUE	TRUE	1	1
FBgn0034493	388	437	362	332	750	769	FALSE	TRUE	TRUE	0	TRUE	TRUE	1	0
FBgn0034494	223	193	165	172	388	365	TRUE	TRUE	TRUE	1	TRUE	TRUE	1	1
FBgn0034495	114	95	75	71	189	166	TRUE	TRUE	TRUE	1	TRUE	TRUE	1	1
FBgn0034496	198	193	188	157	386	350	TRUE	TRUE	TRUE	1	TRUE	TRUE	1	1
FBgn0034497	173	144	106	125	279	269	TRUE	TRUE	TRUE	1	TRUE	TRUE	1	1
FBgn0034498	437	467	379	345	816	812	TRUE	TRUE	TRUE	1	TRUE	TRUE	1	1
FBgn0034499	91	137	81	91	172	228	FALSE	TRUE	FALSE	0	FALSE	TRUE	0	0
FBgn0034500	214	169	173	171	387	340	FALSE	TRUE	FALSE	0	TRUE	TRUE	1	0
FBgn0034501	227	227	215	204	442	431	TRUE	TRUE	TRUE	1	TRUE	TRUE	1	1
FBgn0034502	150	153	117	112	267	265	TRUE	TRUE	TRUE	1	TRUE	TRUE	1	1
FBgn0034503	54	45	44	42	98	87	TRUE	TRUE	TRUE	1	TRUE	TRUE	1	1
FBgn0034504	107	120	92	87	199	207	TRUE	TRUE	TRUE	1	TRUE	TRUE	1	1
FBgn0034505	44	64	44	59	88	123	FALSE	TRUE	FALSE	0	TRUE	TRUE	1	0
FBgn0034506	93	96	90	78	183	174	TRUE	TRUE	TRUE	1	TRUE	TRUE	1	1
FBgn0034507	105	105	74	80	179	185	TRUE	TRUE	TRUE	1	TRUE	TRUE	1	1
FBgn0034509	38	36	34	63	72	99	TRUE	FALSE	FALSE	0	TRUE	FALSE	0	0
FBgn0034510	65	68	62	50	127	118	TRUE	TRUE	TRUE	1	TRUE	TRUE	1	1
FBgn0034511	46	56	23	49	69	105	TRUE	FALSE	FALSE	0	TRUE	FALSE	0	0
FBgn0034512	133	136	120	110	253	246	TRUE	TRUE	TRUE	1	TRUE	TRUE	1	1
FBgn0034513	161	176	145	144	306	320	TRUE	TRUE	TRUE	1	TRUE	TRUE	1	1
FBgn0034514	17	30	23	23	40	53	FALSE	TRUE	TRUE	0	FALSE	TRUE	0	0
FBgn0034515	106	114	120	84	226	198	TRUE	FALSE	TRUE	0	TRUE	TRUE	1	0
FBgn0034520	172	172	130	115	302	287	TRUE	TRUE	TRUE	1	TRUE	TRUE	1	1
FBgn0034521	150	140	110	106	260	246	TRUE	TRUE	TRUE	1	TRUE	TRUE	1	1
FBgn0034523	46	41	39	48	85	89	TRUE	TRUE	TRUE	1	TRUE	TRUE	1	1
FBgn0034527	72	77	61	53	133	130	TRUE	TRUE	TRUE	1	TRUE	TRUE	1	1
FBgn0034528	79	69	69	60	148	129	TRUE	TRUE	TRUE	1	TRUE	TRUE	1	1
FBgn0034529	290	280	250	256	540	536	TRUE	TRUE	TRUE	1	TRUE	TRUE	1	1
FBgn0034530	243	241	232	210	475	451	TRUE	TRUE	TRUE	1	TRUE	TRUE	1	1
FBgn0034532	106	129	110	99	216	228	TRUE	TRUE	TRUE	1	TRUE	TRUE	1	1
FBgn0034534	29	29	27	26	56	55	TRUE	TRUE	TRUE	1	TRUE	TRUE	1	1
FBgn0034535	37	37	34	37	71	74	TRUE	TRUE	TRUE	1	TRUE	TRUE	1	1
FBgn0034537	101	121	96	76	197	197	TRUE	TRUE	TRUE	1	TRUE	TRUE	1	1
FBgn0034538	136	127	133	137	269	264	TRUE	TRUE	TRUE	1	TRUE	TRUE	1	1
FBgn0034539	50	60	63	57	113	117	TRUE	TRUE	TRUE	1	TRUE	TRUE	1	1
FBgn0034540	355	302	273	270	628	572	FALSE	TRUE	TRUE	0	TRUE	TRUE	1	0
FBgn0034541	48	47	50	45	98	92	TRUE	TRUE	TRUE	1	TRUE	TRUE	1	1
FBgn0034542	141	134	100	123	241	257	TRUE	TRUE	TRUE	1	TRUE	TRUE	1	1
FBgn0034543	126	118	103	110	229	228	TRUE	TRUE	TRUE	1	TRUE	TRUE	1	1
FBgn0034545	74	81	77	76	151	157	TRUE	TRUE	TRUE	1	TRUE	TRUE	1	1
FBgn0034546	175	203	159	171	334	374	TRUE	TRUE	TRUE	1	TRUE	TRUE	1	1
FBgn0034548	98	98	75	77	173	175	TRUE	TRUE	TRUE	1	TRUE	TRUE	1	1
FBgn0034551	42	37	28	35	70	72	TRUE	TRUE	TRUE	1	TRUE	TRUE	1	1
FBgn0034552	227	212	184	196	411	408	TRUE	TRUE	TRUE	1	TRUE	TRUE	1	1
FBgn0034553	214	181	173	154	387	335	TRUE	TRUE	FALSE	0	TRUE	TRUE	1	0
FBgn0034554	152	123	138	133	290	256	FALSE	TRUE	TRUE	0	TRUE	TRUE	1	0
FBgn0034558	117	135	117	127	234	262	TRUE	TRUE	TRUE	1	TRUE	TRUE	1	1
FBgn0034560	65	82	73	66	138	148	TRUE	TRUE	TRUE	1	TRUE	TRUE	1	1
FBgn0034563	100	101	84	100	184	201	TRUE	TRUE	TRUE	1	TRUE	TRUE	1	1
FBgn0034564	43	33	45	29	88	62	TRUE	FALSE	FALSE	0	TRUE	FALSE	0	0
FBgn0034565	76	76	62	67	138	143	TRUE	TRUE	TRUE	1	TRUE	TRUE	1	1
FBgn0034566	178	179	176	181	354	360	TRUE	TRUE	TRUE	1	TRUE	TRUE	1	1
FBgn0034567	184	177	152	131	336	308	TRUE	TRUE	TRUE	1	TRUE	TRUE	1	1
FBgn0034568	395	372	304	301	699	673	TRUE	TRUE	TRUE	1	TRUE	TRUE	1	1
FBgn0034569	206	212	188	180	394	392	TRUE	TRUE	TRUE	1	TRUE	TRUE	1	1
FBgn0034570	222	215	208	161	430	376	TRUE	FALSE	FALSE	0	TRUE	TRUE	1	0
FBgn0034572	139	147	127	93	266	240	TRUE	FALSE	TRUE	0	TRUE	TRUE	1	0
FBgn0034573	112	123	74	82	186	205	TRUE	TRUE	TRUE	1	TRUE	TRUE	1	1
FBgn0034576	85	77	63	71	148	148	TRUE	TRUE	TRUE	1	TRUE	TRUE	1	1
FBgn0034577	137	143	87	115	224	258	TRUE	FALSE	TRUE	0	TRUE	TRUE	1	0
FBgn0034579	57	92	58	67	115	159	FALSE	TRUE	FALSE	0	FALSE	TRUE	0	0
FBgn0034580	129	126	103	133	232	259	TRUE	FALSE	TRUE	0	TRUE	TRUE	1	0
FBgn0034582	24	26	22	31	46	57	TRUE	TRUE	TRUE	1	TRUE	TRUE	1	1
FBgn0034583	44	50	41	43	85	93	TRUE	TRUE	TRUE	1	TRUE	TRUE	1	1
FBgn0034585	116	110	92	80	208	190	TRUE	TRUE	TRUE	1	TRUE	TRUE	1	1
FBgn0034588	176	200	145	158	321	358	TRUE	TRUE	TRUE	1	TRUE	TRUE	1	1
FBgn0034590	464	401	360	373	824	774	FALSE	TRUE	TRUE	0	TRUE	TRUE	1	0
FBgn0034592	57	35	43	43	100	78	FALSE	TRUE	TRUE	0	FALSE	TRUE	0	0
FBgn0034595	34	24	17	21	51	45	TRUE	TRUE	TRUE	1	TRUE	TRUE	1	1
FBgn0034598	333	322	242	275	575	597	TRUE	TRUE	TRUE	1	TRUE	TRUE	1	1
FBgn0034599	40	41	42	26	82	67	TRUE	FALSE	TRUE	0	TRUE	FALSE	0	0
FBgn0034601	72	98	78	61	150	159	FALSE	TRUE	TRUE	0	TRUE	TRUE	1	0
FBgn0034602	187	192	174	150	361	342	TRUE	TRUE	TRUE	1	TRUE	TRUE	1	1
FBgn0034605	236	222	192	211	428	433	TRUE	TRUE	TRUE	1	TRUE	TRUE	1	1
FBgn0034606	403	399	347	350	750	749	TRUE	TRUE	TRUE	1	TRUE	TRUE	1	1
FBgn0034611	123	131	93	102	216	233	TRUE	TRUE	TRUE	1	TRUE	TRUE	1	1
FBgn0034612	166	180	145	147	311	327	TRUE	TRUE	TRUE	1	TRUE	TRUE	1	1
FBgn0034618	195	240	167	174	362	414	FALSE	TRUE	FALSE	0	TRUE	TRUE	1	0
FBgn0034622	247	224	188	202	435	426	TRUE	TRUE	TRUE	1	TRUE	TRUE	1	1
FBgn0034623	100	120	82	96	182	216	TRUE	TRUE	FALSE	0	TRUE	TRUE	1	0
FBgn0034624	102	103	76	80	178	183	TRUE	TRUE	TRUE	1	TRUE	TRUE	1	1
FBgn0034626	78	76	49	60	127	136	TRUE	TRUE	TRUE	1	TRUE	TRUE	1	1
FBgn0034627	151	150	139	138	290	288	TRUE	TRUE	TRUE	1	TRUE	TRUE	1	1
FBgn0034628	190	164	161	159	351	323	TRUE	TRUE	TRUE	1	TRUE	TRUE	1	1
FBgn0034629	254	227	211	184	465	411	TRUE	TRUE	FALSE	0	TRUE	TRUE	1	0
FBgn0034631	132	143	111	111	243	254	TRUE	TRUE	TRUE	1	TRUE	TRUE	1	1
FBgn0034634	118	91	91	81	209	172	FALSE	TRUE	FALSE	0	TRUE	TRUE	1	0
FBgn0034636	148	152	133	137	281	289	TRUE	TRUE	TRUE	1	TRUE	TRUE	1	1
FBgn0034638	116	94	80	81	196	175	TRUE	TRUE	TRUE	1	TRUE	TRUE	1	1
FBgn0034639	110	107	73	77	183	184	TRUE	TRUE	TRUE	1	TRUE	TRUE	1	1
FBgn0034641	328	371	267	252	595	623	TRUE	TRUE	TRUE	1	TRUE	TRUE	1	1
FBgn0034643	143	114	102	137	245	251	FALSE	FALSE	TRUE	0	TRUE	TRUE	1	0
FBgn0034644	235	203	171	190	406	393	TRUE	TRUE	TRUE	1	TRUE	TRUE	1	1
FBgn0034645	44	48	23	48	67	96	TRUE	FALSE	FALSE	0	TRUE	FALSE	0	0
FBgn0034646	78	104	82	50	160	154	FALSE	FALSE	TRUE	0	TRUE	FALSE	0	0
FBgn0034647	196	169	162	110	358	279	TRUE	FALSE	FALSE	0	TRUE	TRUE	1	0
FBgn0034650	27	37	38	27	65	64	TRUE	TRUE	TRUE	1	TRUE	TRUE	1	1
FBgn0034651	103	89	64	78	167	167	TRUE	TRUE	TRUE	1	TRUE	TRUE	1	1
FBgn0034654	50	35	36	52	86	87	TRUE	TRUE	TRUE	1	TRUE	TRUE	1	1
FBgn0034655	130	77	101	89	231	166	FALSE	TRUE	FALSE	0	FALSE	TRUE	0	0
FBgn0034657	254	243	191	196	445	439	TRUE	TRUE	TRUE	1	TRUE	TRUE	1	1
FBgn0034658	58	57	41	45	99	102	TRUE	TRUE	TRUE	1	TRUE	TRUE	1	1
FBgn0034659	125	110	106	129	231	239	TRUE	TRUE	TRUE	1	TRUE	TRUE	1	1
FBgn0034660	190	202	174	179	364	381	TRUE	TRUE	TRUE	1	TRUE	TRUE	1	1
FBgn0034661	101	103	92	79	193	182	TRUE	TRUE	TRUE	1	TRUE	TRUE	1	1
FBgn0034662	575	536	453	422	1028	958	TRUE	TRUE	TRUE	1	TRUE	TRUE	1	1
FBgn0034663	62	65	49	67	111	132	TRUE	TRUE	TRUE	1	TRUE	TRUE	1	1
FBgn0034664	72	112	85	91	157	203	FALSE	TRUE	FALSE	0	FALSE	TRUE	0	0
FBgn0034665	100	102	97	83	197	185	TRUE	TRUE	TRUE	1	TRUE	TRUE	1	1
FBgn0034666	29	49	26	28	55	77	FALSE	TRUE	FALSE	0	FALSE	TRUE	0	0
FBgn0034667	162	138	140	155	302	293	TRUE	TRUE	TRUE	1	TRUE	TRUE	1	1
FBgn0034670	131	144	118	113	249	257	TRUE	TRUE	TRUE	1	TRUE	TRUE	1	1
FBgn0034671	67	72	51	40	118	112	TRUE	TRUE	TRUE	1	TRUE	TRUE	1	1
FBgn0034674	181	200	156	159	337	359	TRUE	TRUE	TRUE	1	TRUE	TRUE	1	1
FBgn0034681	77	87	58	61	135	148	TRUE	TRUE	TRUE	1	TRUE	TRUE	1	1
FBgn0034683	125	115	135	126	260	241	TRUE	TRUE	TRUE	1	TRUE	TRUE	1	1
FBgn0034684	184	175	135	149	319	324	TRUE	TRUE	TRUE	1	TRUE	TRUE	1	1
FBgn0034687	106	109	74	74	180	183	TRUE	TRUE	TRUE	1	TRUE	TRUE	1	1
FBgn0034688	168	175	134	131	302	306	TRUE	TRUE	TRUE	1	TRUE	TRUE	1	1
FBgn0034689	155	144	113	121	268	265	TRUE	TRUE	TRUE	1	TRUE	TRUE	1	1
FBgn0034691	396	386	291	334	687	720	TRUE	FALSE	TRUE	0	TRUE	TRUE	1	0
FBgn0034692	199	203	164	180	363	383	TRUE	TRUE	TRUE	1	TRUE	TRUE	1	1
FBgn0034693	248	215	164	163	412	378	TRUE	TRUE	TRUE	1	TRUE	TRUE	1	1
FBgn0034694	247	236	200	191	447	427	TRUE	TRUE	TRUE	1	TRUE	TRUE	1	1
FBgn0034697	177	184	137	158	314	342	TRUE	TRUE	TRUE	1	TRUE	TRUE	1	1
FBgn0034703	123	147	121	124	244	271	TRUE	TRUE	TRUE	1	TRUE	TRUE	1	1
FBgn0034704	25	27	27	39	52	66	TRUE	TRUE	TRUE	1	TRUE	TRUE	1	1
FBgn0034705	118	151	116	102	234	253	FALSE	TRUE	TRUE	0	TRUE	TRUE	1	0
FBgn0034706	168	181	153	136	321	317	TRUE	TRUE	TRUE	1	TRUE	TRUE	1	1
FBgn0034707	182	179	167	131	349	310	TRUE	FALSE	TRUE	0	TRUE	TRUE	1	0
FBgn0034708	233	220	186	170	419	390	TRUE	TRUE	TRUE	1	TRUE	TRUE	1	1
FBgn0034709	154	160	122	123	276	283	TRUE	TRUE	TRUE	1	TRUE	TRUE	1	1
FBgn0034710	175	166	130	144	305	310	TRUE	TRUE	TRUE	1	TRUE	TRUE	1	1
FBgn0034712	194	207	161	196	355	403	TRUE	FALSE	FALSE	0	TRUE	TRUE	1	0
FBgn0034713	93	105	90	99	183	204	TRUE	TRUE	TRUE	1	TRUE	TRUE	1	1
FBgn0034715	198	192	196	186	394	378	TRUE	TRUE	TRUE	1	TRUE	TRUE	1	1
FBgn0034716	312	250	262	282	574	532	FALSE	TRUE	TRUE	0	TRUE	TRUE	1	0
FBgn0034717	291	281	256	247	547	528	TRUE	TRUE	TRUE	1	TRUE	TRUE	1	1
FBgn0034718	325	295	271	251	596	546	TRUE	TRUE	TRUE	1	TRUE	TRUE	1	1
FBgn0034720	548	562	450	481	998	1043	TRUE	TRUE	TRUE	1	TRUE	TRUE	1	1
FBgn0034721	90	69	61	56	151	125	TRUE	TRUE	TRUE	1	TRUE	TRUE	1	1
FBgn0034722	151	135	109	119	260	254	TRUE	TRUE	TRUE	1	TRUE	TRUE	1	1
FBgn0034723	215	218	180	199	395	417	TRUE	TRUE	TRUE	1	TRUE	TRUE	1	1
FBgn0034724	116	117	117	75	233	192	TRUE	FALSE	FALSE	0	TRUE	FALSE	0	0
FBgn0034725	158	146	118	128	276	274	TRUE	TRUE	TRUE	1	TRUE	TRUE	1	1
FBgn0034726	63	79	44	73	107	152	TRUE	FALSE	FALSE	0	TRUE	FALSE	0	0
FBgn0034727	53	77	51	55	104	132	FALSE	TRUE	FALSE	0	TRUE	TRUE	1	0
FBgn0034728	262	243	210	215	472	458	TRUE	TRUE	TRUE	1	TRUE	TRUE	1	1
FBgn0034729	84	104	53	58	137	162	TRUE	TRUE	TRUE	1	TRUE	TRUE	1	1
FBgn0034730	143	129	119	133	262	262	TRUE	TRUE	TRUE	1	TRUE	TRUE	1	1
FBgn0034731	297	307	246	217	543	524	TRUE	TRUE	TRUE	1	TRUE	TRUE	1	1
FBgn0034733	351	351	341	302	692	653	TRUE	TRUE	TRUE	1	TRUE	TRUE	1	1
FBgn0034734	696	699	573	556	1269	1255	TRUE	TRUE	TRUE	1	TRUE	TRUE	1	1
FBgn0034735	115	133	122	120	237	253	TRUE	TRUE	TRUE	1	TRUE	TRUE	1	1
FBgn0034736	177	164	150	123	327	287	TRUE	TRUE	TRUE	1	TRUE	TRUE	1	1
FBgn0034737	69	68	58	63	127	131	TRUE	TRUE	TRUE	1	TRUE	TRUE	1	1
FBgn0034739	72	93	89	68	161	161	TRUE	TRUE	TRUE	1	TRUE	TRUE	1	1
FBgn0034740	170	185	119	129	289	314	TRUE	TRUE	TRUE	1	TRUE	TRUE	1	1
FBgn0034741	86	87	70	68	156	155	TRUE	TRUE	TRUE	1	TRUE	TRUE	1	1
FBgn0034742	167	169	129	132	296	301	TRUE	TRUE	TRUE	1	TRUE	TRUE	1	1
FBgn0034743	33	45	25	48	58	93	TRUE	FALSE	FALSE	0	TRUE	FALSE	0	0
FBgn0034744	23	26	17	20	40	46	TRUE	TRUE	TRUE	1	TRUE	TRUE	1	1
FBgn0034745	218	256	180	168	398	424	FALSE	TRUE	TRUE	0	TRUE	TRUE	1	0
FBgn0034748	50	69	49	45	99	114	FALSE	TRUE	TRUE	0	TRUE	TRUE	1	0
FBgn0034750	76	49	55	48	131	97	FALSE	TRUE	FALSE	0	FALSE	TRUE	0	0
FBgn0034753	67	70	58	41	125	111	TRUE	TRUE	TRUE	1	TRUE	TRUE	1	1
FBgn0034755	44	47	35	33	79	80	TRUE	TRUE	TRUE	1	TRUE	TRUE	1	1
FBgn0034756	31	50	32	34	63	84	FALSE	TRUE	FALSE	0	FALSE	TRUE	0	0
FBgn0034761	73	59	52	43	125	102	TRUE	TRUE	TRUE	1	TRUE	TRUE	1	1
FBgn0034763	102	78	92	69	194	147	FALSE	FALSE	FALSE	0	TRUE	TRUE	1	0
FBgn0034766	51	61	50	34	101	95	TRUE	TRUE	TRUE	1	TRUE	TRUE	1	1
FBgn0034768	113	116	69	83	182	199	TRUE	TRUE	TRUE	1	TRUE	TRUE	1	1
FBgn0034769	110	114	84	90	194	204	TRUE	TRUE	TRUE	1	TRUE	TRUE	1	1
FBgn0034770	89	88	85	82	174	170	TRUE	TRUE	TRUE	1	TRUE	TRUE	1	1
FBgn0034774	74	60	42	39	116	99	TRUE	TRUE	TRUE	1	TRUE	TRUE	1	1
FBgn0034776	114	116	92	69	206	185	TRUE	FALSE	TRUE	0	TRUE	TRUE	1	0
FBgn0034782	190	207	157	153	347	360	TRUE	TRUE	TRUE	1	TRUE	TRUE	1	1
FBgn0034783	171	181	145	147	316	328	TRUE	TRUE	TRUE	1	TRUE	TRUE	1	1
FBgn0034784	137	148	135	130	272	278	TRUE	TRUE	TRUE	1	TRUE	TRUE	1	1
FBgn0034785	152	174	109	149	261	323	TRUE	FALSE	FALSE	0	TRUE	TRUE	1	0
FBgn0034786	480	453	361	373	841	826	TRUE	TRUE	TRUE	1	TRUE	TRUE	1	1
FBgn0034788	155	157	153	152	308	309	TRUE	TRUE	TRUE	1	TRUE	TRUE	1	1
FBgn0034789	347	332	264	245	611	577	TRUE	TRUE	TRUE	1	TRUE	TRUE	1	1
FBgn0034792	133	128	95	109	228	237	TRUE	TRUE	TRUE	1	TRUE	TRUE	1	1
FBgn0034793	82	59	52	44	134	103	FALSE	TRUE	FALSE	0	TRUE	TRUE	1	0
FBgn0034795	420	450	361	358	781	808	TRUE	TRUE	TRUE	1	TRUE	TRUE	1	1
FBgn0034796	108	97	81	77	189	174	TRUE	TRUE	TRUE	1	TRUE	TRUE	1	1
FBgn0034797	278	233	231	186	509	419	FALSE	FALSE	FALSE	0	TRUE	TRUE	1	0
FBgn0034800	44	49	39	63	83	112	TRUE	FALSE	FALSE	0	TRUE	FALSE	0	0
FBgn0034808	209	163	195	180	404	343	FALSE	TRUE	FALSE	0	TRUE	TRUE	1	0
FBgn0034814	82	71	62	62	144	133	TRUE	TRUE	TRUE	1	TRUE	TRUE	1	1
FBgn0034816	163	148	149	120	312	268	TRUE	FALSE	FALSE	0	TRUE	TRUE	1	0
FBgn0034817	167	172	131	110	298	282	TRUE	TRUE	TRUE	1	TRUE	TRUE	1	1
FBgn0034819	56	47	47	46	103	93	TRUE	TRUE	TRUE	1	TRUE	TRUE	1	1
FBgn0034820	98	102	94	85	192	187	TRUE	TRUE	TRUE	1	TRUE	TRUE	1	1
FBgn0034821	163	167	154	137	317	304	TRUE	TRUE	TRUE	1	TRUE	TRUE	1	1
FBgn0034822	30	19	14	35	44	54	TRUE	FALSE	TRUE	0	FALSE	FALSE	0	0
FBgn0034824	112	93	94	85	206	178	TRUE	TRUE	TRUE	1	TRUE	TRUE	1	1
FBgn0034825	61	75	50	43	111	118	TRUE	TRUE	TRUE	1	TRUE	TRUE	1	1
FBgn0034826	84	106	46	81	130	187	TRUE	FALSE	FALSE	0	TRUE	FALSE	0	0
FBgn0034827	94	83	74	67	168	150	TRUE	TRUE	TRUE	1	TRUE	TRUE	1	1
FBgn0034828	86	65	40	53	126	118	TRUE	TRUE	TRUE	1	TRUE	TRUE	1	1
FBgn0034829	305	292	233	245	538	537	TRUE	TRUE	TRUE	1	TRUE	TRUE	1	1
FBgn0034833	107	110	100	104	207	214	TRUE	TRUE	TRUE	1	TRUE	TRUE	1	1
FBgn0034834	52	52	25	57	77	109	TRUE	FALSE	FALSE	0	TRUE	FALSE	0	0
FBgn0034835	107	100	74	64	181	164	TRUE	TRUE	TRUE	1	TRUE	TRUE	1	1
FBgn0034837	77	65	57	54	134	119	TRUE	TRUE	TRUE	1	TRUE	TRUE	1	1
FBgn0034838	93	90	78	73	171	163	TRUE	TRUE	TRUE	1	TRUE	TRUE	1	1
FBgn0034839	76	65	50	43	126	108	TRUE	TRUE	TRUE	1	TRUE	TRUE	1	1
FBgn0034840	125	138	102	93	227	231	TRUE	TRUE	TRUE	1	TRUE	TRUE	1	1
FBgn0034841	84	109	72	74	156	183	FALSE	TRUE	TRUE	0	TRUE	TRUE	1	0
FBgn0034842	109	122	103	106	212	228	TRUE	TRUE	TRUE	1	TRUE	TRUE	1	1
FBgn0034844	221	203	164	158	385	361	TRUE	TRUE	TRUE	1	TRUE	TRUE	1	1
FBgn0034846	37	34	29	31	66	65	TRUE	TRUE	TRUE	1	TRUE	TRUE	1	1
FBgn0034849	57	56	33	44	90	100	TRUE	TRUE	TRUE	1	TRUE	TRUE	1	1
FBgn0034850	35	44	19	24	54	68	TRUE	TRUE	TRUE	1	TRUE	TRUE	1	1
FBgn0034853	292	280	244	236	536	516	TRUE	TRUE	TRUE	1	TRUE	TRUE	1	1
FBgn0034854	300	280	242	226	542	506	TRUE	TRUE	TRUE	1	TRUE	TRUE	1	1
FBgn0034856	54	48	32	38	86	86	TRUE	TRUE	TRUE	1	TRUE	TRUE	1	1
FBgn0034858	42	46	35	35	77	81	TRUE	TRUE	TRUE	1	TRUE	TRUE	1	1
FBgn0034859	356	350	306	289	662	639	TRUE	TRUE	TRUE	1	TRUE	TRUE	1	1
FBgn0034860	200	211	171	185	371	396	TRUE	TRUE	TRUE	1	TRUE	TRUE	1	1
FBgn0034861	191	171	142	147	333	318	TRUE	TRUE	TRUE	1	TRUE	TRUE	1	1
FBgn0034863	78	91	69	71	147	162	TRUE	TRUE	TRUE	1	TRUE	TRUE	1	1
FBgn0034865	151	178	125	140	276	318	TRUE	TRUE	FALSE	0	TRUE	TRUE	1	0
FBgn0034866	114	116	91	95	205	211	TRUE	TRUE	TRUE	1	TRUE	TRUE	1	1
FBgn0034867	73	67	75	77	148	144	TRUE	TRUE	TRUE	1	TRUE	TRUE	1	1
FBgn0034869	107	113	102	79	209	192	TRUE	TRUE	TRUE	1	TRUE	TRUE	1	1
FBgn0034870	81	113	90	68	171	181	FALSE	FALSE	TRUE	0	TRUE	TRUE	1	0
FBgn0034871	98	66	64	50	162	116	FALSE	TRUE	FALSE	0	TRUE	TRUE	1	0
FBgn0034876	97	87	62	78	159	165	TRUE	TRUE	TRUE	1	TRUE	TRUE	1	1
FBgn0034877	43	36	34	30	77	66	TRUE	TRUE	TRUE	1	TRUE	TRUE	1	1
FBgn0034878	152	138	132	123	284	261	TRUE	TRUE	TRUE	1	TRUE	TRUE	1	1
FBgn0034879	79	59	42	54	121	113	TRUE	TRUE	TRUE	1	TRUE	TRUE	1	1
FBgn0034880	256	276	182	177	438	453	TRUE	TRUE	TRUE	1	TRUE	TRUE	1	1
FBgn0034882	85	73	74	51	159	124	TRUE	FALSE	FALSE	0	TRUE	TRUE	1	0
FBgn0034883	217	188	146	142	363	330	TRUE	TRUE	TRUE	1	TRUE	TRUE	1	1
FBgn0034884	88	81	87	55	175	136	TRUE	FALSE	FALSE	0	TRUE	FALSE	0	0
FBgn0034885	243	233	192	191	435	424	TRUE	TRUE	TRUE	1	TRUE	TRUE	1	1
FBgn0034887	113	108	102	83	215	191	TRUE	TRUE	TRUE	1	TRUE	TRUE	1	1
FBgn0034893	36	34	40	34	76	68	TRUE	TRUE	TRUE	1	TRUE	TRUE	1	1
FBgn0034894	110	102	92	83	202	185	TRUE	TRUE	TRUE	1	TRUE	TRUE	1	1
FBgn0034897	92	106	67	70	159	176	TRUE	TRUE	TRUE	1	TRUE	TRUE	1	1
FBgn0034898	67	71	67	52	134	123	TRUE	TRUE	TRUE	1	TRUE	TRUE	1	1
FBgn0034899	98	109	81	76	179	185	TRUE	TRUE	TRUE	1	TRUE	TRUE	1	1
FBgn0034901	45	34	33	36	78	70	TRUE	TRUE	TRUE	1	TRUE	TRUE	1	1
FBgn0034902	75	74	54	47	129	121	TRUE	TRUE	TRUE	1	TRUE	TRUE	1	1
FBgn0034903	576	605	442	492	1018	1097	TRUE	TRUE	FALSE	0	TRUE	TRUE	1	0
FBgn0034904	81	74	59	62	140	136	TRUE	TRUE	TRUE	1	TRUE	TRUE	1	1
FBgn0034906	35	35	41	32	76	67	TRUE	TRUE	TRUE	1	TRUE	TRUE	1	1
FBgn0034907	45	46	55	45	100	91	TRUE	TRUE	TRUE	1	TRUE	TRUE	1	1
FBgn0034908	133	120	114	97	247	217	TRUE	TRUE	TRUE	1	TRUE	TRUE	1	1
FBgn0034909	84	107	76	73	160	180	TRUE	TRUE	TRUE	1	TRUE	TRUE	1	1
FBgn0034910	150	133	116	98	266	231	TRUE	TRUE	TRUE	1	TRUE	TRUE	1	1
FBgn0034911	480	479	383	359	863	838	TRUE	TRUE	TRUE	1	TRUE	TRUE	1	1
FBgn0034913	127	107	66	68	193	175	TRUE	TRUE	TRUE	1	TRUE	TRUE	1	1
FBgn0034914	118	89	79	74	197	163	FALSE	TRUE	FALSE	0	TRUE	TRUE	1	0
FBgn0034915	96	67	74	74	170	141	FALSE	TRUE	TRUE	0	TRUE	TRUE	1	0
FBgn0034918	56	66	51	43	107	109	TRUE	TRUE	TRUE	1	TRUE	TRUE	1	1
FBgn0034919	61	56	29	39	90	95	TRUE	TRUE	TRUE	1	TRUE	TRUE	1	1
FBgn0034920	106	117	77	59	183	176	TRUE	TRUE	TRUE	1	TRUE	TRUE	1	1
FBgn0034923	116	127	122	108	238	235	TRUE	TRUE	TRUE	1	TRUE	TRUE	1	1
FBgn0034924	59	44	49	53	108	97	TRUE	TRUE	TRUE	1	TRUE	TRUE	1	1
FBgn0034925	31	32	35	33	66	65	TRUE	TRUE	TRUE	1	TRUE	TRUE	1	1
FBgn0034928	111	121	83	86	194	207	TRUE	TRUE	TRUE	1	TRUE	TRUE	1	1
FBgn0034933	200	197	185	156	385	353	TRUE	TRUE	TRUE	1	TRUE	TRUE	1	1
FBgn0034935	132	123	95	97	227	220	TRUE	TRUE	TRUE	1	TRUE	TRUE	1	1
FBgn0034936	97	98	73	91	170	189	TRUE	TRUE	TRUE	1	TRUE	TRUE	1	1
FBgn0034937	61	69	54	45	115	114	TRUE	TRUE	TRUE	1	TRUE	TRUE	1	1
FBgn0034938	117	93	67	74	184	167	TRUE	TRUE	TRUE	1	TRUE	TRUE	1	1
FBgn0034939	125	120	93	105	218	225	TRUE	TRUE	TRUE	1	TRUE	TRUE	1	1
FBgn0034940	83	86	62	66	145	152	TRUE	TRUE	TRUE	1	TRUE	TRUE	1	1
FBgn0034942	51	52	47	45	98	97	TRUE	TRUE	TRUE	1	TRUE	TRUE	1	1
FBgn0034943	168	193	134	141	302	334	TRUE	TRUE	TRUE	1	TRUE	TRUE	1	1
FBgn0034946	69	97	76	69	145	166	FALSE	TRUE	TRUE	0	TRUE	TRUE	1	0
FBgn0034948	143	144	109	111	252	255	TRUE	TRUE	TRUE	1	TRUE	TRUE	1	1
FBgn0034950	141	122	86	118	227	240	TRUE	FALSE	TRUE	0	TRUE	TRUE	1	0
FBgn0034951	126	119	119	114	245	233	TRUE	TRUE	TRUE	1	TRUE	TRUE	1	1
FBgn0034956	202	173	157	174	359	347	TRUE	TRUE	TRUE	1	TRUE	TRUE	1	1
FBgn0034957	177	155	154	129	331	284	TRUE	TRUE	FALSE	0	TRUE	TRUE	1	0
FBgn0034958	114	119	105	99	219	218	TRUE	TRUE	TRUE	1	TRUE	TRUE	1	1
FBgn0034959	54	70	42	41	96	111	TRUE	TRUE	TRUE	1	TRUE	TRUE	1	1
FBgn0034961	46	37	26	29	72	66	TRUE	TRUE	TRUE	1	TRUE	TRUE	1	1
FBgn0034962	138	130	112	126	250	256	TRUE	TRUE	TRUE	1	TRUE	TRUE	1	1
FBgn0034963	90	91	76	82	166	173	TRUE	TRUE	TRUE	1	TRUE	TRUE	1	1
FBgn0034964	425	393	306	319	731	712	TRUE	TRUE	TRUE	1	TRUE	TRUE	1	1
FBgn0034965	136	154	114	127	250	281	TRUE	TRUE	TRUE	1	TRUE	TRUE	1	1
FBgn0034966	134	145	117	119	251	264	TRUE	TRUE	TRUE	1	TRUE	TRUE	1	1
FBgn0034968	53	55	50	51	103	106	TRUE	TRUE	TRUE	1	TRUE	TRUE	1	1
FBgn0034970	67	68	55	54	122	122	TRUE	TRUE	TRUE	1	TRUE	TRUE	1	1
FBgn0034971	152	173	136	127	288	300	TRUE	TRUE	TRUE	1	TRUE	TRUE	1	1
FBgn0034972	163	162	120	130	283	292	TRUE	TRUE	TRUE	1	TRUE	TRUE	1	1
FBgn0034973	59	64	49	51	108	115	TRUE	TRUE	TRUE	1	TRUE	TRUE	1	1
FBgn0034974	215	246	195	180	410	426	TRUE	TRUE	TRUE	1	TRUE	TRUE	1	1
FBgn0034975	439	414	397	402	836	816	TRUE	TRUE	TRUE	1	TRUE	TRUE	1	1
FBgn0034976	444	385	323	335	767	720	FALSE	TRUE	TRUE	0	TRUE	TRUE	1	0
FBgn0034978	244	250	166	202	410	452	TRUE	FALSE	TRUE	0	TRUE	TRUE	1	0
FBgn0034982	165	149	151	136	316	285	TRUE	TRUE	TRUE	1	TRUE	TRUE	1	1
FBgn0034985	382	416	357	327	739	743	TRUE	TRUE	TRUE	1	TRUE	TRUE	1	1
FBgn0034986	29	33	22	26	51	59	TRUE	TRUE	TRUE	1	TRUE	TRUE	1	1
FBgn0034988	64	74	60	72	124	146	TRUE	TRUE	TRUE	1	TRUE	TRUE	1	1
FBgn0034989	82	85	62	63	144	148	TRUE	TRUE	TRUE	1	TRUE	TRUE	1	1
FBgn0034990	271	252	176	189	447	441	TRUE	TRUE	TRUE	1	TRUE	TRUE	1	1
FBgn0034994	133	107	93	118	226	225	TRUE	FALSE	TRUE	0	TRUE	TRUE	1	0
FBgn0034996	121	133	89	96	210	229	TRUE	TRUE	TRUE	1	TRUE	TRUE	1	1
FBgn0034997	191	164	157	144	348	308	TRUE	TRUE	TRUE	1	TRUE	TRUE	1	1
FBgn0034998	120	86	91	81	211	167	FALSE	TRUE	FALSE	0	TRUE	TRUE	1	0
FBgn0034999	199	230	167	181	366	411	TRUE	TRUE	TRUE	1	TRUE	TRUE	1	1
FBgn0035000	60	47	31	39	91	86	TRUE	TRUE	TRUE	1	TRUE	TRUE	1	1
FBgn0035001	370	356	289	314	659	670	TRUE	TRUE	TRUE	1	TRUE	TRUE	1	1
FBgn0035003	97	93	68	75	165	168	TRUE	TRUE	TRUE	1	TRUE	TRUE	1	1
FBgn0035004	59	60	46	52	105	112	TRUE	TRUE	TRUE	1	TRUE	TRUE	1	1
FBgn0035005	67	68	62	63	129	131	TRUE	TRUE	TRUE	1	TRUE	TRUE	1	1
FBgn0035006	116	118	105	85	221	203	TRUE	TRUE	TRUE	1	TRUE	TRUE	1	1
FBgn0035007	67	83	47	52	114	135	TRUE	TRUE	TRUE	1	TRUE	TRUE	1	1
FBgn0035008	54	40	41	45	95	85	TRUE	TRUE	TRUE	1	TRUE	TRUE	1	1
FBgn0035009	65	58	65	47	130	105	TRUE	TRUE	TRUE	1	TRUE	TRUE	1	1
FBgn0035010	255	219	215	201	470	420	TRUE	TRUE	TRUE	1	TRUE	TRUE	1	1
FBgn0035011	67	55	55	58	122	113	TRUE	TRUE	TRUE	1	TRUE	TRUE	1	1
FBgn0035012	67	49	49	48	116	97	TRUE	TRUE	TRUE	1	TRUE	TRUE	1	1
FBgn0035014	58	53	50	43	108	96	TRUE	TRUE	TRUE	1	TRUE	TRUE	1	1
FBgn0035016	114	110	87	94	201	204	TRUE	TRUE	TRUE	1	TRUE	TRUE	1	1
FBgn0035019	114	119	97	80	211	199	TRUE	TRUE	TRUE	1	TRUE	TRUE	1	1
FBgn0035020	110	99	94	95	204	194	TRUE	TRUE	TRUE	1	TRUE	TRUE	1	1
FBgn0035021	153	162	131	135	284	297	TRUE	TRUE	TRUE	1	TRUE	TRUE	1	1
FBgn0035023	191	181	153	145	344	326	TRUE	TRUE	TRUE	1	TRUE	TRUE	1	1
FBgn0035024	87	73	79	69	166	142	TRUE	TRUE	TRUE	1	TRUE	TRUE	1	1
FBgn0035025	16	28	28	34	44	62	FALSE	TRUE	FALSE	0	FALSE	TRUE	0	0
FBgn0035026	128	115	88	74	216	189	TRUE	TRUE	TRUE	1	TRUE	TRUE	1	1
FBgn0035027	113	102	89	96	202	198	TRUE	TRUE	TRUE	1	TRUE	TRUE	1	1
FBgn0035028	128	103	88	125	216	228	TRUE	FALSE	TRUE	0	TRUE	TRUE	1	0
FBgn0035031	68	72	68	56	136	128	TRUE	TRUE	TRUE	1	TRUE	TRUE	1	1
FBgn0035032	44	44	37	27	81	71	TRUE	TRUE	TRUE	1	TRUE	TRUE	1	1
FBgn0035033	75	82	62	72	137	154	TRUE	TRUE	TRUE	1	TRUE	TRUE	1	1
FBgn0035034	21	16	15	18	36	34	TRUE	TRUE	TRUE	1	TRUE	TRUE	1	1
FBgn0035036	48	49	57	36	105	85	TRUE	FALSE	TRUE	0	TRUE	FALSE	0	0
FBgn0035039	69	89	62	72	131	161	TRUE	TRUE	FALSE	0	TRUE	TRUE	1	0
FBgn0035040	85	92	62	77	147	169	TRUE	TRUE	TRUE	1	TRUE	TRUE	1	1
FBgn0035041	229	264	181	167	410	431	TRUE	TRUE	TRUE	1	TRUE	TRUE	1	1
FBgn0035042	37	65	30	43	67	108	FALSE	TRUE	FALSE	0	FALSE	TRUE	0	0
FBgn0035043	79	79	62	61	141	140	TRUE	TRUE	TRUE	1	TRUE	TRUE	1	1
FBgn0035044	29	30	24	18	53	48	TRUE	TRUE	TRUE	1	TRUE	TRUE	1	1
FBgn0035046	22	25	13	25	35	50	TRUE	FALSE	TRUE	0	TRUE	FALSE	0	0
FBgn0035047	50	40	40	40	90	80	TRUE	TRUE	TRUE	1	TRUE	TRUE	1	1
FBgn0035049	189	246	157	185	346	431	FALSE	TRUE	FALSE	0	TRUE	TRUE	1	0
FBgn0035050	29	23	34	22	63	45	TRUE	TRUE	TRUE	1	TRUE	FALSE	0	0
FBgn0035056	53	49	49	39	102	88	TRUE	TRUE	TRUE	1	TRUE	TRUE	1	1
FBgn0035060	80	89	67	80	147	169	TRUE	TRUE	TRUE	1	TRUE	TRUE	1	1
FBgn0035065	24	25	24	24	48	49	TRUE	TRUE	TRUE	1	TRUE	TRUE	1	1
FBgn0035068	44	51	26	32	70	83	TRUE	TRUE	TRUE	1	TRUE	TRUE	1	1
FBgn0035069	61	88	36	40	97	128	FALSE	TRUE	FALSE	0	TRUE	TRUE	1	0
FBgn0035070	69	64	39	54	108	118	TRUE	TRUE	TRUE	1	TRUE	TRUE	1	1
FBgn0035073	103	85	98	80	201	165	TRUE	TRUE	FALSE	0	TRUE	TRUE	1	0
FBgn0035076	45	52	41	40	86	92	TRUE	TRUE	TRUE	1	TRUE	TRUE	1	1
FBgn0035078	50	44	38	36	88	80	TRUE	TRUE	TRUE	1	TRUE	TRUE	1	1
FBgn0035083	17	25	23	18	40	43	TRUE	TRUE	TRUE	1	TRUE	TRUE	1	1
FBgn0035084	32	26	22	22	54	48	TRUE	TRUE	TRUE	1	TRUE	TRUE	1	1
FBgn0035086	56	67	48	37	104	104	TRUE	TRUE	TRUE	1	TRUE	TRUE	1	1
FBgn0035087	48	47	43	38	91	85	TRUE	TRUE	TRUE	1	TRUE	TRUE	1	1
FBgn0035091	40	41	43	32	83	73	TRUE	TRUE	TRUE	1	TRUE	TRUE	1	1
FBgn0035092	33	36	22	23	55	59	TRUE	TRUE	TRUE	1	TRUE	TRUE	1	1
FBgn0035094	288	310	236	267	524	577	TRUE	TRUE	TRUE	1	TRUE	TRUE	1	1
FBgn0035099	25	33	29	24	54	57	TRUE	TRUE	TRUE	1	TRUE	TRUE	1	1
FBgn0035104	39	32	27	24	66	56	TRUE	TRUE	TRUE	1	TRUE	TRUE	1	1
FBgn0035106	112	82	74	75	186	157	FALSE	TRUE	TRUE	0	TRUE	TRUE	1	0
FBgn0035109	29	19	15	24	44	43	TRUE	TRUE	TRUE	1	FALSE	FALSE	0	0
FBgn0035120	21	14	25	15	46	29	TRUE	TRUE	FALSE	0	TRUE	FALSE	0	0
FBgn0035121	51	44	38	27	89	71	TRUE	TRUE	TRUE	1	TRUE	TRUE	1	1
FBgn0035122	25	16	18	26	43	42	TRUE	TRUE	TRUE	1	FALSE	TRUE	0	0
FBgn0035124	66	74	68	60	134	134	TRUE	TRUE	TRUE	1	TRUE	TRUE	1	1
FBgn0035131	107	113	109	89	216	202	TRUE	TRUE	TRUE	1	TRUE	TRUE	1	1
FBgn0035132	151	132	116	114	267	246	TRUE	TRUE	TRUE	1	TRUE	TRUE	1	1
FBgn0035134	28	15	18	18	46	33	FALSE	TRUE	TRUE	0	FALSE	TRUE	0	0
FBgn0035137	35	34	37	38	72	72	TRUE	TRUE	TRUE	1	TRUE	TRUE	1	1
FBgn0035138	48	41	34	42	82	83	TRUE	TRUE	TRUE	1	TRUE	TRUE	1	1
FBgn0035140	62	56	53	46	115	102	TRUE	TRUE	TRUE	1	TRUE	TRUE	1	1
FBgn0035141	55	49	33	42	88	91	TRUE	TRUE	TRUE	1	TRUE	TRUE	1	1
FBgn0035142	709	699	558	595	1267	1294	TRUE	TRUE	TRUE	1	TRUE	TRUE	1	1
FBgn0035143	119	112	102	96	221	208	TRUE	TRUE	TRUE	1	TRUE	TRUE	1	1
FBgn0035144	171	159	133	127	304	286	TRUE	TRUE	TRUE	1	TRUE	TRUE	1	1
FBgn0035145	374	319	265	302	639	621	FALSE	TRUE	TRUE	0	TRUE	TRUE	1	0
FBgn0035146	55	67	49	59	104	126	TRUE	TRUE	TRUE	1	TRUE	TRUE	1	1
FBgn0035147	188	207	142	160	330	367	TRUE	TRUE	TRUE	1	TRUE	TRUE	1	1
FBgn0035148	77	77	62	84	139	161	TRUE	FALSE	TRUE	0	TRUE	TRUE	1	0
FBgn0035149	46	36	41	35	87	71	TRUE	TRUE	TRUE	1	TRUE	TRUE	1	1
FBgn0035150	221	215	176	175	397	390	TRUE	TRUE	TRUE	1	TRUE	TRUE	1	1
FBgn0035151	168	148	167	116	335	264	TRUE	FALSE	FALSE	0	TRUE	TRUE	1	0
FBgn0035152	116	101	102	101	218	202	TRUE	TRUE	TRUE	1	TRUE	TRUE	1	1
FBgn0035153	207	190	140	114	347	304	TRUE	TRUE	FALSE	0	TRUE	TRUE	1	0
FBgn0035154	177	176	148	164	325	340	TRUE	TRUE	TRUE	1	TRUE	TRUE	1	1
FBgn0035155	63	92	45	57	108	149	FALSE	TRUE	FALSE	0	TRUE	TRUE	1	0
FBgn0035157	186	187	163	166	349	353	TRUE	TRUE	TRUE	1	TRUE	TRUE	1	1
FBgn0035158	149	167	134	130	283	297	TRUE	TRUE	TRUE	1	TRUE	TRUE	1	1
FBgn0035159	94	88	59	76	153	164	TRUE	TRUE	TRUE	1	TRUE	TRUE	1	1
FBgn0035160	161	141	111	128	272	269	TRUE	TRUE	TRUE	1	TRUE	TRUE	1	1
FBgn0035161	62	75	36	48	98	123	TRUE	TRUE	TRUE	1	TRUE	TRUE	1	1
FBgn0035162	135	113	97	83	232	196	TRUE	TRUE	FALSE	0	TRUE	TRUE	1	0
FBgn0035164	88	67	41	60	129	127	TRUE	FALSE	TRUE	0	TRUE	TRUE	1	0
FBgn0035165	75	110	72	104	147	214	FALSE	FALSE	FALSE	0	TRUE	TRUE	1	0
FBgn0035166	101	113	101	104	202	217	TRUE	TRUE	TRUE	1	TRUE	TRUE	1	1
FBgn0035167	190	174	175	149	365	323	TRUE	TRUE	TRUE	1	TRUE	TRUE	1	1
FBgn0035168	599	592	438	446	1037	1038	TRUE	TRUE	TRUE	1	TRUE	TRUE	1	1
FBgn0035169	98	85	90	87	188	172	TRUE	TRUE	TRUE	1	TRUE	TRUE	1	1
FBgn0035170	245	264	228	194	473	458	TRUE	TRUE	TRUE	1	TRUE	TRUE	1	1
FBgn0035171	343	358	279	269	622	627	TRUE	TRUE	TRUE	1	TRUE	TRUE	1	1
FBgn0035173	338	305	237	266	575	571	TRUE	TRUE	TRUE	1	TRUE	TRUE	1	1
FBgn0035176	121	119	120	95	241	214	TRUE	TRUE	TRUE	1	TRUE	TRUE	1	1
FBgn0035179	123	110	128	96	251	206	TRUE	FALSE	FALSE	0	TRUE	TRUE	1	0
FBgn0035181	87	94	87	71	174	165	TRUE	TRUE	TRUE	1	TRUE	TRUE	1	1
FBgn0035187	55	49	52	37	107	86	TRUE	TRUE	TRUE	1	TRUE	TRUE	1	1
FBgn0035189	121	86	68	83	189	169	FALSE	TRUE	TRUE	0	TRUE	TRUE	1	0
FBgn0035192	53	51	43	28	96	79	TRUE	FALSE	TRUE	0	TRUE	FALSE	0	0
FBgn0035193	24	21	18	18	42	39	TRUE	TRUE	TRUE	1	TRUE	TRUE	1	1
FBgn0035194	49	29	40	42	89	71	FALSE	TRUE	TRUE	0	FALSE	TRUE	0	0
FBgn0035196	55	55	54	56	109	111	TRUE	TRUE	TRUE	1	TRUE	TRUE	1	1
FBgn0035199	244	221	191	186	435	407	TRUE	TRUE	TRUE	1	TRUE	TRUE	1	1
FBgn0035208	95	110	72	70	167	180	TRUE	TRUE	TRUE	1	TRUE	TRUE	1	1
FBgn0035210	56	54	39	46	95	100	TRUE	TRUE	TRUE	1	TRUE	TRUE	1	1
FBgn0035211	100	110	92	122	192	232	TRUE	FALSE	FALSE	0	TRUE	TRUE	1	0
FBgn0035213	145	140	139	164	284	304	TRUE	TRUE	TRUE	1	TRUE	TRUE	1	1
FBgn0035216	210	198	186	191	396	389	TRUE	TRUE	TRUE	1	TRUE	TRUE	1	1
FBgn0035217	178	158	148	125	326	283	TRUE	TRUE	FALSE	0	TRUE	TRUE	1	0
FBgn0035218	235	222	153	159	388	381	TRUE	TRUE	TRUE	1	TRUE	TRUE	1	1
FBgn0035227	505	484	408	402	913	886	TRUE	TRUE	TRUE	1	TRUE	TRUE	1	1
FBgn0035228	128	124	84	98	212	222	TRUE	TRUE	TRUE	1	TRUE	TRUE	1	1
FBgn0035229	507	536	385	399	892	935	TRUE	TRUE	TRUE	1	TRUE	TRUE	1	1
FBgn0035231	128	134	118	110	246	244	TRUE	TRUE	TRUE	1	TRUE	TRUE	1	1
FBgn0035232	203	197	147	150	350	347	TRUE	TRUE	TRUE	1	TRUE	TRUE	1	1
FBgn0035233	79	76	53	42	132	118	TRUE	TRUE	TRUE	1	TRUE	TRUE	1	1
FBgn0035234	142	128	111	119	253	247	TRUE	TRUE	TRUE	1	TRUE	TRUE	1	1
FBgn0035235	273	270	219	202	492	472	TRUE	TRUE	TRUE	1	TRUE	TRUE	1	1
FBgn0035236	350	410	317	311	667	721	FALSE	TRUE	TRUE	0	TRUE	TRUE	1	0
FBgn0035237	544	614	458	476	1002	1090	FALSE	TRUE	FALSE	0	TRUE	TRUE	1	0
FBgn0035238	80	63	75	62	155	125	TRUE	TRUE	FALSE	0	TRUE	TRUE	1	0
FBgn0035241	354	345	296	278	650	623	TRUE	TRUE	TRUE	1	TRUE	TRUE	1	1
FBgn0035244	198	194	175	169	373	363	TRUE	TRUE	TRUE	1	TRUE	TRUE	1	1
FBgn0035245	195	212	127	176	322	388	TRUE	FALSE	FALSE	0	TRUE	TRUE	1	0
FBgn0035246	38	36	24	18	62	54	TRUE	TRUE	TRUE	1	TRUE	TRUE	1	1
FBgn0035249	22	23	18	16	40	39	TRUE	TRUE	TRUE	1	TRUE	TRUE	1	1
FBgn0035252	44	25	43	28	87	53	FALSE	FALSE	FALSE	0	FALSE	FALSE	0	0
FBgn0035253	287	325	232	285	519	610	TRUE	FALSE	FALSE	0	TRUE	TRUE	1	0
FBgn0035255	105	116	86	79	191	195	TRUE	TRUE	TRUE	1	TRUE	TRUE	1	1
FBgn0035256	165	168	164	158	329	326	TRUE	TRUE	TRUE	1	TRUE	TRUE	1	1
FBgn0035257	100	92	71	80	171	172	TRUE	TRUE	TRUE	1	TRUE	TRUE	1	1
FBgn0035258	124	98	88	95	212	193	FALSE	TRUE	TRUE	0	TRUE	TRUE	1	0
FBgn0035260	364	340	262	285	626	625	TRUE	TRUE	TRUE	1	TRUE	TRUE	1	1
FBgn0035262	149	158	120	105	269	263	TRUE	TRUE	TRUE	1	TRUE	TRUE	1	1
FBgn0035263	90	110	88	79	178	189	TRUE	TRUE	TRUE	1	TRUE	TRUE	1	1
FBgn0035264	138	156	120	98	258	254	TRUE	TRUE	TRUE	1	TRUE	TRUE	1	1
FBgn0035265	90	92	77	67	167	159	TRUE	TRUE	TRUE	1	TRUE	TRUE	1	1
FBgn0035266	136	128	108	125	244	253	TRUE	TRUE	TRUE	1	TRUE	TRUE	1	1
FBgn0035267	182	126	129	112	311	238	FALSE	TRUE	FALSE	0	TRUE	TRUE	1	0
FBgn0035268	34	29	30	25	64	54	TRUE	TRUE	TRUE	1	TRUE	TRUE	1	1
FBgn0035270	33	43	36	40	69	83	TRUE	TRUE	TRUE	1	TRUE	TRUE	1	1
FBgn0035273	65	52	50	33	115	85	TRUE	FALSE	FALSE	0	TRUE	FALSE	0	0
FBgn0035279	49	46	34	39	83	85	TRUE	TRUE	TRUE	1	TRUE	TRUE	1	1
FBgn0035281	134	119	102	104	236	223	TRUE	TRUE	TRUE	1	TRUE	TRUE	1	1
FBgn0035282	157	190	139	151	296	341	FALSE	TRUE	FALSE	0	TRUE	TRUE	1	0
FBgn0035283	71	55	77	55	148	110	TRUE	FALSE	FALSE	0	TRUE	TRUE	1	0
FBgn0035285	163	183	152	149	315	332	TRUE	TRUE	TRUE	1	TRUE	TRUE	1	1
FBgn0035286	153	135	96	95	249	230	TRUE	TRUE	TRUE	1	TRUE	TRUE	1	1
FBgn0035287	212	166	154	176	366	342	FALSE	TRUE	TRUE	0	TRUE	TRUE	1	0
FBgn0035290	321	309	249	263	570	572	TRUE	TRUE	TRUE	1	TRUE	TRUE	1	1
FBgn0035293	279	273	233	224	512	497	TRUE	TRUE	TRUE	1	TRUE	TRUE	1	1
FBgn0035294	102	93	70	68	172	161	TRUE	TRUE	TRUE	1	TRUE	TRUE	1	1
FBgn0035295	250	205	160	188	410	393	FALSE	TRUE	TRUE	0	TRUE	TRUE	1	0
FBgn0035298	56	41	20	35	76	76	TRUE	FALSE	TRUE	0	TRUE	FALSE	0	0
FBgn0035300	198	211	171	173	369	384	TRUE	TRUE	TRUE	1	TRUE	TRUE	1	1
FBgn0035308	374	340	305	317	679	657	TRUE	TRUE	TRUE	1	TRUE	TRUE	1	1
FBgn0035309	138	129	135	136	273	265	TRUE	TRUE	TRUE	1	TRUE	TRUE	1	1
FBgn0035312	95	88	84	96	179	184	TRUE	TRUE	TRUE	1	TRUE	TRUE	1	1
FBgn0035313	112	132	95	102	207	234	TRUE	TRUE	TRUE	1	TRUE	TRUE	1	1
FBgn0035315	62	65	53	45	115	110	TRUE	TRUE	TRUE	1	TRUE	TRUE	1	1
FBgn0035316	140	120	131	111	271	231	TRUE	TRUE	FALSE	0	TRUE	TRUE	1	0
FBgn0035317	454	448	289	302	743	750	TRUE	TRUE	TRUE	1	TRUE	TRUE	1	1
FBgn0035318	34	35	33	31	67	66	TRUE	TRUE	TRUE	1	TRUE	TRUE	1	1
FBgn0035321	281	279	159	148	440	427	TRUE	TRUE	TRUE	1	TRUE	TRUE	1	1
FBgn0035325	100	106	57	75	157	181	TRUE	TRUE	TRUE	1	TRUE	TRUE	1	1
FBgn0035328	208	188	91	99	299	287	TRUE	TRUE	TRUE	1	TRUE	TRUE	1	1
FBgn0035331	444	431	360	350	804	781	TRUE	TRUE	TRUE	1	TRUE	TRUE	1	1
FBgn0035332	187	173	128	149	315	322	TRUE	TRUE	TRUE	1	TRUE	TRUE	1	1
FBgn0035333	196	232	201	206	397	438	FALSE	TRUE	TRUE	0	TRUE	TRUE	1	0
FBgn0035334	18	16	18	18	36	34	TRUE	TRUE	TRUE	1	TRUE	TRUE	1	1
FBgn0035335	58	56	27	42	85	98	TRUE	FALSE	TRUE	0	TRUE	FALSE	0	0
FBgn0035336	229	231	180	199	409	430	TRUE	TRUE	TRUE	1	TRUE	TRUE	1	1
FBgn0035337	81	77	70	67	151	144	TRUE	TRUE	TRUE	1	TRUE	TRUE	1	1
FBgn0035343	91	97	86	76	177	173	TRUE	TRUE	TRUE	1	TRUE	TRUE	1	1
FBgn0035344	165	185	169	152	334	337	TRUE	TRUE	TRUE	1	TRUE	TRUE	1	1
FBgn0035346	229	236	213	223	442	459	TRUE	TRUE	TRUE	1	TRUE	TRUE	1	1
FBgn0035348	153	144	104	100	257	244	TRUE	TRUE	TRUE	1	TRUE	TRUE	1	1
FBgn0035355	40	44	30	39	70	83	TRUE	TRUE	TRUE	1	TRUE	TRUE	1	1
FBgn0035356	80	57	64	49	144	106	FALSE	TRUE	FALSE	0	TRUE	TRUE	1	0
FBgn0035357	46	47	41	62	87	109	TRUE	FALSE	TRUE	0	TRUE	FALSE	0	0
FBgn0035358	111	104	103	102	214	206	TRUE	TRUE	TRUE	1	TRUE	TRUE	1	1
FBgn0035359	218	196	167	166	385	362	TRUE	TRUE	TRUE	1	TRUE	TRUE	1	1
FBgn0035360	129	136	103	117	232	253	TRUE	TRUE	TRUE	1	TRUE	TRUE	1	1
FBgn0035370	64	65	59	48	123	113	TRUE	TRUE	TRUE	1	TRUE	TRUE	1	1
FBgn0035371	223	219	162	170	385	389	TRUE	TRUE	TRUE	1	TRUE	TRUE	1	1
FBgn0035372	152	138	127	118	279	256	TRUE	TRUE	TRUE	1	TRUE	TRUE	1	1
FBgn0035374	76	79	58	64	134	143	TRUE	TRUE	TRUE	1	TRUE	TRUE	1	1
FBgn0035375	235	257	213	199	448	456	TRUE	TRUE	TRUE	1	TRUE	TRUE	1	1
FBgn0035379	285	239	220	200	505	439	FALSE	TRUE	FALSE	0	TRUE	TRUE	1	0
FBgn0035380	117	106	102	116	219	222	TRUE	TRUE	TRUE	1	TRUE	TRUE	1	1
FBgn0035382	209	177	161	196	370	373	TRUE	FALSE	TRUE	0	TRUE	TRUE	1	0
FBgn0035383	182	202	140	162	322	364	TRUE	TRUE	TRUE	1	TRUE	TRUE	1	1
FBgn0035384	72	94	77	67	149	161	TRUE	TRUE	TRUE	1	TRUE	TRUE	1	1
FBgn0035385	347	320	280	305	627	625	TRUE	TRUE	TRUE	1	TRUE	TRUE	1	1
FBgn0035388	244	265	180	251	424	516	TRUE	FALSE	FALSE	0	TRUE	TRUE	1	0
FBgn0035390	130	169	144	145	274	314	FALSE	TRUE	TRUE	0	TRUE	TRUE	1	0
FBgn0035392	183	165	112	113	295	278	TRUE	TRUE	TRUE	1	TRUE	TRUE	1	1
FBgn0035393	33	46	46	31	79	77	TRUE	TRUE	TRUE	1	TRUE	TRUE	1	1
FBgn0035397	426	485	378	393	804	878	FALSE	TRUE	FALSE	0	TRUE	TRUE	1	0
FBgn0035398	306	328	249	264	555	592	TRUE	TRUE	TRUE	1	TRUE	TRUE	1	1
FBgn0035400	475	480	347	394	822	874	TRUE	FALSE	TRUE	0	TRUE	TRUE	1	0
FBgn0035401	122	134	116	92	238	226	TRUE	TRUE	TRUE	1	TRUE	TRUE	1	1
FBgn0035402	163	206	142	124	305	330	FALSE	TRUE	TRUE	0	TRUE	TRUE	1	0
FBgn0035405	150	137	100	121	250	258	TRUE	TRUE	TRUE	1	TRUE	TRUE	1	1
FBgn0035407	83	80	60	55	143	135	TRUE	TRUE	TRUE	1	TRUE	TRUE	1	1
FBgn0035409	41	50	46	41	87	91	TRUE	TRUE	TRUE	1	TRUE	TRUE	1	1
FBgn0035410	190	181	155	157	345	338	TRUE	TRUE	TRUE	1	TRUE	TRUE	1	1
FBgn0035412	41	42	37	37	78	79	TRUE	TRUE	TRUE	1	TRUE	TRUE	1	1
FBgn0035413	49	40	39	28	88	68	TRUE	TRUE	TRUE	1	TRUE	TRUE	1	1
FBgn0035414	93	104	81	90	174	194	TRUE	TRUE	TRUE	1	TRUE	TRUE	1	1
FBgn0035415	42	52	37	18	79	70	TRUE	FALSE	TRUE	0	TRUE	FALSE	0	0
FBgn0035420	553	602	491	494	1044	1096	TRUE	TRUE	TRUE	1	TRUE	TRUE	1	1
FBgn0035421	90	88	65	69	155	157	TRUE	TRUE	TRUE	1	TRUE	TRUE	1	1
FBgn0035422	28	23	21	38	49	61	TRUE	FALSE	TRUE	0	TRUE	FALSE	0	0
FBgn0035423	61	67	60	77	121	144	TRUE	TRUE	TRUE	1	TRUE	TRUE	1	1
FBgn0035424	426	423	343	343	769	766	TRUE	TRUE	TRUE	1	TRUE	TRUE	1	1
FBgn0035425	97	80	67	82	164	162	TRUE	TRUE	TRUE	1	TRUE	TRUE	1	1
FBgn0035426	114	106	82	89	196	195	TRUE	TRUE	TRUE	1	TRUE	TRUE	1	1
FBgn0035427	165	149	145	115	310	264	TRUE	FALSE	FALSE	0	TRUE	TRUE	1	0
FBgn0035428	194	150	149	149	343	299	FALSE	TRUE	FALSE	0	TRUE	TRUE	1	0
FBgn0035429	302	298	265	235	567	533	TRUE	TRUE	TRUE	1	TRUE	TRUE	1	1
FBgn0035430	312	346	238	287	550	633	TRUE	FALSE	FALSE	0	TRUE	TRUE	1	0
FBgn0035431	179	186	153	121	332	307	TRUE	FALSE	TRUE	0	TRUE	TRUE	1	0
FBgn0035432	309	298	293	254	602	552	TRUE	TRUE	TRUE	1	TRUE	TRUE	1	1
FBgn0035434	56	60	37	38	93	98	TRUE	TRUE	TRUE	1	TRUE	TRUE	1	1
FBgn0035435	69	63	44	59	113	122	TRUE	TRUE	TRUE	1	TRUE	TRUE	1	1
FBgn0035437	258	248	212	208	470	456	TRUE	TRUE	TRUE	1	TRUE	TRUE	1	1
FBgn0035438	131	154	130	136	261	290	TRUE	TRUE	TRUE	1	TRUE	TRUE	1	1
FBgn0035439	227	209	181	150	408	359	TRUE	FALSE	FALSE	0	TRUE	TRUE	1	0
FBgn0035440	115	104	124	99	239	203	TRUE	TRUE	FALSE	0	TRUE	TRUE	1	0
FBgn0035443	152	135	140	123	292	258	TRUE	TRUE	TRUE	1	TRUE	TRUE	1	1
FBgn0035444	109	128	108	89	217	217	TRUE	TRUE	TRUE	1	TRUE	TRUE	1	1
FBgn0035445	113	110	71	93	184	203	TRUE	TRUE	TRUE	1	TRUE	TRUE	1	1
FBgn0035449	145	135	98	119	243	254	TRUE	TRUE	TRUE	1	TRUE	TRUE	1	1
FBgn0035452	175	166	156	140	331	306	TRUE	TRUE	TRUE	1	TRUE	TRUE	1	1
FBgn0035453	137	154	127	118	264	272	TRUE	TRUE	TRUE	1	TRUE	TRUE	1	1
FBgn0035455	95	77	49	49	144	126	TRUE	TRUE	TRUE	1	TRUE	TRUE	1	1
FBgn0035458	133	152	117	117	250	269	TRUE	TRUE	TRUE	1	TRUE	TRUE	1	1
FBgn0035461	83	99	70	65	153	164	TRUE	TRUE	TRUE	1	TRUE	TRUE	1	1
FBgn0035462	168	168	115	118	283	286	TRUE	TRUE	TRUE	1	TRUE	TRUE	1	1
FBgn0035464	89	118	77	97	166	215	FALSE	TRUE	FALSE	0	TRUE	TRUE	1	0
FBgn0035468	131	120	117	101	248	221	TRUE	TRUE	TRUE	1	TRUE	TRUE	1	1
FBgn0035469	39	47	40	39	79	86	TRUE	TRUE	TRUE	1	TRUE	TRUE	1	1
FBgn0035470	83	68	47	71	130	139	TRUE	FALSE	TRUE	0	TRUE	FALSE	0	0
FBgn0035471	118	121	98	107	216	228	TRUE	TRUE	TRUE	1	TRUE	TRUE	1	1
FBgn0035473	127	151	117	105	244	256	TRUE	TRUE	TRUE	1	TRUE	TRUE	1	1
FBgn0035475	135	132	106	78	241	210	TRUE	FALSE	TRUE	0	TRUE	TRUE	1	0
FBgn0035476	149	164	121	122	270	286	TRUE	TRUE	TRUE	1	TRUE	TRUE	1	1
FBgn0035477	404	427	320	330	724	757	TRUE	TRUE	TRUE	1	TRUE	TRUE	1	1
FBgn0035478	77	63	56	45	133	108	TRUE	TRUE	TRUE	1	TRUE	TRUE	1	1
FBgn0035480	98	144	109	107	207	251	FALSE	TRUE	FALSE	0	TRUE	TRUE	1	0
FBgn0035481	528	515	434	387	962	902	TRUE	TRUE	TRUE	1	TRUE	TRUE	1	1
FBgn0035482	240	250	178	189	418	439	TRUE	TRUE	TRUE	1	TRUE	TRUE	1	1
FBgn0035483	82	91	73	74	155	165	TRUE	TRUE	TRUE	1	TRUE	TRUE	1	1
FBgn0035484	230	200	181	172	411	372	TRUE	TRUE	TRUE	1	TRUE	TRUE	1	1
FBgn0035488	155	171	128	136	283	307	TRUE	TRUE	TRUE	1	TRUE	TRUE	1	1
FBgn0035490	224	206	161	147	385	353	TRUE	TRUE	TRUE	1	TRUE	TRUE	1	1
FBgn0035491	29	48	47	24	76	72	FALSE	FALSE	TRUE	0	FALSE	FALSE	0	0
FBgn0035495	232	238	216	191	448	429	TRUE	TRUE	TRUE	1	TRUE	TRUE	1	1
FBgn0035496	60	67	49	70	109	137	TRUE	FALSE	FALSE	0	TRUE	TRUE	1	0
FBgn0035497	408	389	348	324	756	713	TRUE	TRUE	TRUE	1	TRUE	TRUE	1	1
FBgn0035498	159	155	144	125	303	280	TRUE	TRUE	TRUE	1	TRUE	TRUE	1	1
FBgn0035499	70	93	89	87	159	180	FALSE	TRUE	TRUE	0	TRUE	TRUE	1	0
FBgn0035501	187	170	143	151	330	321	TRUE	TRUE	TRUE	1	TRUE	TRUE	1	1
FBgn0035504	288	264	232	219	520	483	TRUE	TRUE	TRUE	1	TRUE	TRUE	1	1
FBgn0035505	277	245	228	219	505	464	TRUE	TRUE	TRUE	1	TRUE	TRUE	1	1
FBgn0035508	199	190	176	180	375	370	TRUE	TRUE	TRUE	1	TRUE	TRUE	1	1
FBgn0035510	115	83	86	80	201	163	FALSE	TRUE	FALSE	0	TRUE	TRUE	1	0
FBgn0035511	77	78	67	58	144	136	TRUE	TRUE	TRUE	1	TRUE	TRUE	1	1
FBgn0035512	83	82	61	67	144	149	TRUE	TRUE	TRUE	1	TRUE	TRUE	1	1
FBgn0035513	98	66	50	65	148	131	FALSE	TRUE	TRUE	0	TRUE	TRUE	1	0
FBgn0035515	161	137	113	106	274	243	TRUE	TRUE	TRUE	1	TRUE	TRUE	1	1
FBgn0035517	41	51	62	41	103	92	TRUE	FALSE	TRUE	0	TRUE	FALSE	0	0
FBgn0035518	219	167	163	154	382	321	FALSE	TRUE	FALSE	0	TRUE	TRUE	1	0
FBgn0035519	116	104	88	93	204	197	TRUE	TRUE	TRUE	1	TRUE	TRUE	1	1
FBgn0035520	80	48	43	47	123	95	FALSE	TRUE	FALSE	0	FALSE	TRUE	0	0
FBgn0035521	81	87	66	73	147	160	TRUE	TRUE	TRUE	1	TRUE	TRUE	1	1
FBgn0035522	490	450	381	369	871	819	TRUE	TRUE	TRUE	1	TRUE	TRUE	1	1
FBgn0035523	261	260	227	198	488	458	TRUE	TRUE	TRUE	1	TRUE	TRUE	1	1
FBgn0035524	110	101	78	91	188	192	TRUE	TRUE	TRUE	1	TRUE	TRUE	1	1
FBgn0035526	214	251	219	214	433	465	FALSE	TRUE	TRUE	0	TRUE	TRUE	1	0
FBgn0035528	59	78	43	54	102	132	TRUE	TRUE	FALSE	0	TRUE	TRUE	1	0
FBgn0035529	78	82	75	63	153	145	TRUE	TRUE	TRUE	1	TRUE	TRUE	1	1
FBgn0035532	83	98	86	85	169	183	TRUE	TRUE	TRUE	1	TRUE	TRUE	1	1
FBgn0035533	319	329	258	280	577	609	TRUE	TRUE	TRUE	1	TRUE	TRUE	1	1
FBgn0035534	63	42	50	52	113	94	FALSE	TRUE	TRUE	0	TRUE	TRUE	1	0
FBgn0035537	72	84	60	63	132	147	TRUE	TRUE	TRUE	1	TRUE	TRUE	1	1
FBgn0035538	287	263	264	287	551	550	TRUE	TRUE	TRUE	1	TRUE	TRUE	1	1
FBgn0035539	191	191	138	153	329	344	TRUE	TRUE	TRUE	1	TRUE	TRUE	1	1
FBgn0035540	42	45	28	29	70	74	TRUE	TRUE	TRUE	1	TRUE	TRUE	1	1
FBgn0035541	41	43	32	38	73	81	TRUE	TRUE	TRUE	1	TRUE	TRUE	1	1
FBgn0035542	302	349	263	286	565	635	FALSE	TRUE	FALSE	0	TRUE	TRUE	1	0
FBgn0035543	355	345	299	279	654	624	TRUE	TRUE	TRUE	1	TRUE	TRUE	1	1
FBgn0035544	98	78	66	65	164	143	TRUE	TRUE	TRUE	1	TRUE	TRUE	1	1
FBgn0035545	97	87	86	73	183	160	TRUE	TRUE	TRUE	1	TRUE	TRUE	1	1
FBgn0035546	79	82	81	66	160	148	TRUE	TRUE	TRUE	1	TRUE	TRUE	1	1
FBgn0035547	94	87	84	91	178	178	TRUE	TRUE	TRUE	1	TRUE	TRUE	1	1
FBgn0035548	66	70	48	53	114	123	TRUE	TRUE	TRUE	1	TRUE	TRUE	1	1
FBgn0035550	168	171	140	164	308	335	TRUE	TRUE	TRUE	1	TRUE	TRUE	1	1
FBgn0035551	56	63	69	48	125	111	TRUE	FALSE	TRUE	0	TRUE	TRUE	1	0
FBgn0035552	83	86	64	72	147	158	TRUE	TRUE	TRUE	1	TRUE	TRUE	1	1
FBgn0035553	204	193	163	129	367	322	TRUE	FALSE	FALSE	0	TRUE	TRUE	1	0
FBgn0035554	85	75	60	73	145	148	TRUE	TRUE	TRUE	1	TRUE	TRUE	1	1
FBgn0035555	160	142	101	124	261	266	TRUE	TRUE	TRUE	1	TRUE	TRUE	1	1
FBgn0035557	278	258	242	241	520	499	TRUE	TRUE	TRUE	1	TRUE	TRUE	1	1
FBgn0035558	206	274	204	225	410	499	FALSE	TRUE	FALSE	0	TRUE	TRUE	1	0
FBgn0035563	30	26	27	33	57	59	TRUE	TRUE	TRUE	1	TRUE	TRUE	1	1
FBgn0035567	127	126	111	112	238	238	TRUE	TRUE	TRUE	1	TRUE	TRUE	1	1
FBgn0035568	85	100	68	68	153	168	TRUE	TRUE	TRUE	1	TRUE	TRUE	1	1
FBgn0035569	73	70	39	46	112	116	TRUE	TRUE	TRUE	1	TRUE	TRUE	1	1
FBgn0035570	46	46	36	45	82	91	TRUE	TRUE	TRUE	1	TRUE	TRUE	1	1
FBgn0035571	106	97	58	76	164	173	TRUE	TRUE	TRUE	1	TRUE	TRUE	1	1
FBgn0035572	88	74	68	69	156	143	TRUE	TRUE	TRUE	1	TRUE	TRUE	1	1
FBgn0035574	546	565	486	471	1032	1036	TRUE	TRUE	TRUE	1	TRUE	TRUE	1	1
FBgn0035575	114	129	90	104	204	233	TRUE	TRUE	TRUE	1	TRUE	TRUE	1	1
FBgn0035577	177	156	128	124	305	280	TRUE	TRUE	TRUE	1	TRUE	TRUE	1	1
FBgn0035578	193	166	136	136	329	302	TRUE	TRUE	TRUE	1	TRUE	TRUE	1	1
FBgn0035581	1337	1296	1100	1146	2437	2442	TRUE	TRUE	TRUE	1	TRUE	TRUE	1	1
FBgn0035582	91	78	59	88	150	166	TRUE	FALSE	TRUE	0	TRUE	TRUE	1	0
FBgn0035583	83	85	73	68	156	153	TRUE	TRUE	TRUE	1	TRUE	TRUE	1	1
FBgn0035585	47	20	24	33	71	53	FALSE	TRUE	TRUE	0	FALSE	TRUE	0	0
FBgn0035586	133	97	91	97	224	194	FALSE	TRUE	TRUE	0	TRUE	TRUE	1	0
FBgn0035587	75	111	66	88	141	199	FALSE	FALSE	FALSE	0	TRUE	TRUE	1	0
FBgn0035589	73	71	64	51	137	122	TRUE	TRUE	TRUE	1	TRUE	TRUE	1	1
FBgn0035590	18	25	18	13	36	38	TRUE	TRUE	TRUE	1	TRUE	TRUE	1	1
FBgn0035591	100	95	78	91	178	186	TRUE	TRUE	TRUE	1	TRUE	TRUE	1	1
FBgn0035593	131	106	79	95	210	201	TRUE	TRUE	TRUE	1	TRUE	TRUE	1	1
FBgn0035594	36	48	49	38	85	86	TRUE	TRUE	TRUE	1	TRUE	TRUE	1	1
FBgn0035598	122	151	129	110	251	261	FALSE	TRUE	TRUE	0	TRUE	TRUE	1	0
FBgn0035600	79	64	69	71	148	135	TRUE	TRUE	TRUE	1	TRUE	TRUE	1	1
FBgn0035604	309	254	272	225	581	479	FALSE	FALSE	FALSE	0	TRUE	TRUE	1	0
FBgn0035607	320	303	223	268	543	571	TRUE	FALSE	TRUE	0	TRUE	TRUE	1	0
FBgn0035608	25	29	28	22	53	51	TRUE	TRUE	TRUE	1	TRUE	TRUE	1	1
FBgn0035610	296	301	306	286	602	587	TRUE	TRUE	TRUE	1	TRUE	TRUE	1	1
FBgn0035611	100	110	86	75	186	185	TRUE	TRUE	TRUE	1	TRUE	TRUE	1	1
FBgn0035612	175	114	112	125	287	239	FALSE	TRUE	FALSE	0	FALSE	TRUE	0	0
FBgn0035617	298	285	247	249	545	534	TRUE	TRUE	TRUE	1	TRUE	TRUE	1	1
FBgn0035619	104	122	87	73	191	195	TRUE	TRUE	TRUE	1	TRUE	TRUE	1	1
FBgn0035620	99	102	78	80	177	182	TRUE	TRUE	TRUE	1	TRUE	TRUE	1	1
FBgn0035621	101	111	60	90	161	201	TRUE	FALSE	FALSE	0	TRUE	TRUE	1	0
FBgn0035622	32	39	19	29	51	68	TRUE	TRUE	TRUE	1	TRUE	FALSE	0	0
FBgn0035623	93	90	116	72	209	162	TRUE	FALSE	FALSE	0	TRUE	FALSE	0	0
FBgn0035624	56	74	71	64	127	138	TRUE	TRUE	TRUE	1	TRUE	TRUE	1	1
FBgn0035625	497	474	444	391	941	865	TRUE	FALSE	FALSE	0	TRUE	TRUE	1	0
FBgn0035626	111	103	93	99	204	202	TRUE	TRUE	TRUE	1	TRUE	TRUE	1	1
FBgn0035627	214	223	185	189	399	412	TRUE	TRUE	TRUE	1	TRUE	TRUE	1	1
FBgn0035630	102	122	107	100	209	222	TRUE	TRUE	TRUE	1	TRUE	TRUE	1	1
FBgn0035631	107	110	81	84	188	194	TRUE	TRUE	TRUE	1	TRUE	TRUE	1	1
FBgn0035636	13	29	7	24	20	53	FALSE	FALSE	FALSE	0	FALSE	FALSE	0	0
FBgn0035638	103	101	85	86	188	187	TRUE	TRUE	TRUE	1	TRUE	TRUE	1	1
FBgn0035639	52	39	45	52	97	91	TRUE	TRUE	TRUE	1	TRUE	TRUE	1	1
FBgn0035640	68	70	40	64	108	134	TRUE	FALSE	TRUE	0	TRUE	FALSE	0	0
FBgn0035641	144	151	131	110	275	261	TRUE	TRUE	TRUE	1	TRUE	TRUE	1	1
FBgn0035642	203	202	152	150	355	352	TRUE	TRUE	TRUE	1	TRUE	TRUE	1	1
FBgn0035643	173	149	123	127	296	276	TRUE	TRUE	TRUE	1	TRUE	TRUE	1	1
FBgn0035644	146	136	93	87	239	223	TRUE	TRUE	TRUE	1	TRUE	TRUE	1	1
FBgn0035645	182	179	124	149	306	328	TRUE	TRUE	TRUE	1	TRUE	TRUE	1	1
FBgn0035647	280	245	230	193	510	438	TRUE	FALSE	FALSE	0	TRUE	TRUE	1	0
FBgn0035648	233	260	199	212	432	472	TRUE	TRUE	TRUE	1	TRUE	TRUE	1	1
FBgn0035649	107	121	94	92	201	213	TRUE	TRUE	TRUE	1	TRUE	TRUE	1	1
FBgn0035656	148	138	126	122	274	260	TRUE	TRUE	TRUE	1	TRUE	TRUE	1	1
FBgn0035657	138	127	132	116	270	243	TRUE	TRUE	TRUE	1	TRUE	TRUE	1	1
FBgn0035661	126	149	98	88	224	237	TRUE	TRUE	TRUE	1	TRUE	TRUE	1	1
FBgn0035663	78	70	73	71	151	141	TRUE	TRUE	TRUE	1	TRUE	TRUE	1	1
FBgn0035665	49	47	52	37	101	84	TRUE	TRUE	TRUE	1	TRUE	TRUE	1	1
FBgn0035666	114	105	86	93	200	198	TRUE	TRUE	TRUE	1	TRUE	TRUE	1	1
FBgn0035667	80	80	71	70	151	150	TRUE	TRUE	TRUE	1	TRUE	TRUE	1	1
FBgn0035669	150	134	101	132	251	266	TRUE	FALSE	TRUE	0	TRUE	TRUE	1	0
FBgn0035670	98	90	88	72	186	162	TRUE	TRUE	TRUE	1	TRUE	TRUE	1	1
FBgn0035673	81	98	103	85	184	183	TRUE	TRUE	TRUE	1	TRUE	TRUE	1	1
FBgn0035674	127	104	119	95	246	199	TRUE	TRUE	FALSE	0	TRUE	TRUE	1	0
FBgn0035675	47	20	29	26	76	46	FALSE	TRUE	FALSE	0	FALSE	TRUE	0	0
FBgn0035676	257	290	260	255	517	545	TRUE	TRUE	TRUE	1	TRUE	TRUE	1	1
FBgn0035677	249	245	196	210	445	455	TRUE	TRUE	TRUE	1	TRUE	TRUE	1	1
FBgn0035678	87	61	49	48	136	109	FALSE	TRUE	FALSE	0	TRUE	TRUE	1	0
FBgn0035679	141	130	99	116	240	246	TRUE	TRUE	TRUE	1	TRUE	TRUE	1	1
FBgn0035685	93	67	77	72	170	139	FALSE	TRUE	FALSE	0	TRUE	TRUE	1	0
FBgn0035686	59	45	40	44	99	89	TRUE	TRUE	TRUE	1	TRUE	TRUE	1	1
FBgn0035687	104	123	82	93	186	216	TRUE	TRUE	TRUE	1	TRUE	TRUE	1	1
FBgn0035688	382	404	354	332	736	736	TRUE	TRUE	TRUE	1	TRUE	TRUE	1	1
FBgn0035689	292	313	233	279	525	592	TRUE	FALSE	FALSE	0	TRUE	TRUE	1	0
FBgn0035690	183	161	129	143	312	304	TRUE	TRUE	TRUE	1	TRUE	TRUE	1	1
FBgn0035691	134	150	127	118	261	268	TRUE	TRUE	TRUE	1	TRUE	TRUE	1	1
FBgn0035692	84	75	71	67	155	142	TRUE	TRUE	TRUE	1	TRUE	TRUE	1	1
FBgn0035693	59	59	52	58	111	117	TRUE	TRUE	TRUE	1	TRUE	TRUE	1	1
FBgn0035694	25	12	19	20	44	32	FALSE	TRUE	TRUE	0	FALSE	TRUE	0	0
FBgn0035695	223	235	178	181	401	416	TRUE	TRUE	TRUE	1	TRUE	TRUE	1	1
FBgn0035696	325	409	352	330	677	739	FALSE	TRUE	TRUE	0	TRUE	TRUE	1	0
FBgn0035697	112	114	102	113	214	227	TRUE	TRUE	TRUE	1	TRUE	TRUE	1	1
FBgn0035699	236	208	162	201	398	409	TRUE	FALSE	TRUE	0	TRUE	TRUE	1	0
FBgn0035702	162	129	109	104	271	233	FALSE	TRUE	FALSE	0	TRUE	TRUE	1	0
FBgn0035703	241	196	195	173	436	369	FALSE	TRUE	FALSE	0	TRUE	TRUE	1	0
FBgn0035704	256	280	255	231	511	511	TRUE	TRUE	TRUE	1	TRUE	TRUE	1	1
FBgn0035708	301	302	253	286	554	588	TRUE	TRUE	TRUE	1	TRUE	TRUE	1	1
FBgn0035709	54	63	55	47	109	110	TRUE	TRUE	TRUE	1	TRUE	TRUE	1	1
FBgn0035710	327	332	306	289	633	621	TRUE	TRUE	TRUE	1	TRUE	TRUE	1	1
FBgn0035711	81	90	78	91	159	181	TRUE	TRUE	TRUE	1	TRUE	TRUE	1	1
FBgn0035713	351	384	307	292	658	676	TRUE	TRUE	TRUE	1	TRUE	TRUE	1	1
FBgn0035715	99	95	72	70	171	165	TRUE	TRUE	TRUE	1	TRUE	TRUE	1	1
FBgn0035718	103	106	99	96	202	202	TRUE	TRUE	TRUE	1	TRUE	TRUE	1	1
FBgn0035719	259	272	195	195	454	467	TRUE	TRUE	TRUE	1	TRUE	TRUE	1	1
FBgn0035720	394	415	289	306	683	721	TRUE	TRUE	TRUE	1	TRUE	TRUE	1	1
FBgn0035721	61	61	50	43	111	104	TRUE	TRUE	TRUE	1	TRUE	TRUE	1	1
FBgn0035722	64	42	51	52	115	94	FALSE	TRUE	TRUE	0	FALSE	TRUE	0	0
FBgn0035724	240	193	194	199	434	392	FALSE	TRUE	TRUE	0	TRUE	TRUE	1	0
FBgn0035725	98	90	104	88	202	178	TRUE	TRUE	TRUE	1	TRUE	TRUE	1	1
FBgn0035726	139	173	120	128	259	301	FALSE	TRUE	FALSE	0	TRUE	TRUE	1	0
FBgn0035727	56	61	60	53	116	114	TRUE	TRUE	TRUE	1	TRUE	TRUE	1	1
FBgn0035730	41	37	31	26	72	63	TRUE	TRUE	TRUE	1	TRUE	TRUE	1	1
FBgn0035733	310	299	252	281	562	580	TRUE	TRUE	TRUE	1	TRUE	TRUE	1	1
FBgn0035734	135	156	119	113	254	269	TRUE	TRUE	TRUE	1	TRUE	TRUE	1	1
FBgn0035735	44	41	45	36	89	77	TRUE	TRUE	TRUE	1	TRUE	TRUE	1	1
FBgn0035736	80	75	67	49	147	124	TRUE	TRUE	TRUE	1	TRUE	TRUE	1	1
FBgn0035737	45	63	49	39	94	102	TRUE	TRUE	TRUE	1	TRUE	TRUE	1	1
FBgn0035741	92	119	99	105	191	224	FALSE	TRUE	TRUE	0	TRUE	TRUE	1	0
FBgn0035743	101	84	82	89	183	173	TRUE	TRUE	TRUE	1	TRUE	TRUE	1	1
FBgn0035750	152	124	117	131	269	255	TRUE	TRUE	TRUE	1	TRUE	TRUE	1	1
FBgn0035751	125	114	128	106	253	220	TRUE	TRUE	TRUE	1	TRUE	TRUE	1	1
FBgn0035753	57	61	60	67	117	128	TRUE	TRUE	TRUE	1	TRUE	TRUE	1	1
FBgn0035754	70	73	60	59	130	132	TRUE	TRUE	TRUE	1	TRUE	TRUE	1	1
FBgn0035755	89	69	73	70	162	139	TRUE	TRUE	TRUE	1	TRUE	TRUE	1	1
FBgn0035756	753	819	635	616	1388	1435	TRUE	TRUE	TRUE	1	TRUE	TRUE	1	1
FBgn0035761	183	199	168	147	351	346	TRUE	TRUE	TRUE	1	TRUE	TRUE	1	1
FBgn0035762	142	140	124	135	266	275	TRUE	TRUE	TRUE	1	TRUE	TRUE	1	1
FBgn0035763	175	179	181	159	356	338	TRUE	TRUE	TRUE	1	TRUE	TRUE	1	1
FBgn0035766	259	250	227	212	486	462	TRUE	TRUE	TRUE	1	TRUE	TRUE	1	1
FBgn0035767	178	230	170	166	348	396	FALSE	TRUE	FALSE	0	TRUE	TRUE	1	0
FBgn0035768	64	53	56	53	120	106	TRUE	TRUE	TRUE	1	TRUE	TRUE	1	1
FBgn0035769	28	38	32	22	60	60	TRUE	TRUE	TRUE	1	TRUE	TRUE	1	1
FBgn0035770	183	167	139	125	322	292	TRUE	TRUE	TRUE	1	TRUE	TRUE	1	1
FBgn0035771	33	31	34	32	67	63	TRUE	TRUE	TRUE	1	TRUE	TRUE	1	1
FBgn0035772	196	199	179	148	375	347	TRUE	FALSE	TRUE	0	TRUE	TRUE	1	0
FBgn0035776	91	98	82	89	173	187	TRUE	TRUE	TRUE	1	TRUE	TRUE	1	1
FBgn0035777	229	297	222	197	451	494	FALSE	TRUE	TRUE	0	TRUE	TRUE	1	0
FBgn0035779	104	125	99	103	203	228	TRUE	TRUE	TRUE	1	TRUE	TRUE	1	1
FBgn0035780	82	109	63	84	145	193	FALSE	FALSE	FALSE	0	TRUE	TRUE	1	0
FBgn0035781	79	99	75	80	154	179	TRUE	TRUE	TRUE	1	TRUE	TRUE	1	1
FBgn0035782	59	54	48	47	107	101	TRUE	TRUE	TRUE	1	TRUE	TRUE	1	1
FBgn0035785	187	170	143	174	330	344	TRUE	FALSE	TRUE	0	TRUE	TRUE	1	0
FBgn0035787	87	74	66	74	153	148	TRUE	TRUE	TRUE	1	TRUE	TRUE	1	1
FBgn0035788	126	78	84	64	210	142	FALSE	TRUE	FALSE	0	FALSE	TRUE	0	0
FBgn0035789	209	217	180	154	389	371	TRUE	TRUE	TRUE	1	TRUE	TRUE	1	1
FBgn0035790	179	182	154	138	333	320	TRUE	TRUE	TRUE	1	TRUE	TRUE	1	1
FBgn0035791	123	131	101	126	224	257	TRUE	TRUE	TRUE	1	TRUE	TRUE	1	1
FBgn0035792	62	54	59	57	121	111	TRUE	TRUE	TRUE	1	TRUE	TRUE	1	1
FBgn0035793	210	213	150	154	360	367	TRUE	TRUE	TRUE	1	TRUE	TRUE	1	1
FBgn0035797	251	258	226	260	477	518	TRUE	TRUE	TRUE	1	TRUE	TRUE	1	1
FBgn0035798	343	336	278	284	621	620	TRUE	TRUE	TRUE	1	TRUE	TRUE	1	1
FBgn0035799	236	267	222	214	458	481	TRUE	TRUE	TRUE	1	TRUE	TRUE	1	1
FBgn0035800	191	213	187	155	378	368	TRUE	FALSE	TRUE	0	TRUE	TRUE	1	0
FBgn0035802	748	752	613	613	1361	1365	TRUE	TRUE	TRUE	1	TRUE	TRUE	1	1
FBgn0035805	97	84	91	85	188	169	TRUE	TRUE	TRUE	1	TRUE	TRUE	1	1
FBgn0035806	41	30	37	34	78	64	TRUE	TRUE	TRUE	1	TRUE	TRUE	1	1
FBgn0035807	93	88	64	65	157	153	TRUE	TRUE	TRUE	1	TRUE	TRUE	1	1
FBgn0035811	20	18	17	26	37	44	TRUE	TRUE	TRUE	1	TRUE	FALSE	0	0
FBgn0035812	422	454	397	388	819	842	TRUE	TRUE	TRUE	1	TRUE	TRUE	1	1
FBgn0035813	333	307	270	311	603	618	TRUE	FALSE	TRUE	0	TRUE	TRUE	1	0
FBgn0035815	277	294	252	245	529	539	TRUE	TRUE	TRUE	1	TRUE	TRUE	1	1
FBgn0035816	279	318	216	210	495	528	TRUE	TRUE	TRUE	1	TRUE	TRUE	1	1
FBgn0035817	61	78	60	57	121	135	TRUE	TRUE	TRUE	1	TRUE	TRUE	1	1
FBgn0035823	71	47	51	61	122	108	FALSE	TRUE	TRUE	0	FALSE	TRUE	0	0
FBgn0035824	35	37	35	30	70	67	TRUE	TRUE	TRUE	1	TRUE	TRUE	1	1
FBgn0035825	109	96	70	66	179	162	TRUE	TRUE	TRUE	1	TRUE	TRUE	1	1
FBgn0035827	89	78	54	63	143	141	TRUE	TRUE	TRUE	1	TRUE	TRUE	1	1
FBgn0035829	75	47	73	76	148	123	FALSE	TRUE	TRUE	0	FALSE	TRUE	0	0
FBgn0035830	71	94	62	63	133	157	FALSE	TRUE	TRUE	0	TRUE	TRUE	1	0
FBgn0035831	51	52	40	54	91	106	TRUE	TRUE	TRUE	1	TRUE	TRUE	1	1
FBgn0035833	367	366	332	319	699	685	TRUE	TRUE	TRUE	1	TRUE	TRUE	1	1
FBgn0035838	38	52	37	34	75	86	TRUE	TRUE	TRUE	1	TRUE	TRUE	1	1
FBgn0035839	30	38	37	35	67	73	TRUE	TRUE	TRUE	1	TRUE	TRUE	1	1
FBgn0035842	210	226	184	173	394	399	TRUE	TRUE	TRUE	1	TRUE	TRUE	1	1
FBgn0035844	326	369	298	303	624	672	TRUE	TRUE	TRUE	1	TRUE	TRUE	1	1
FBgn0035845	115	125	110	101	225	226	TRUE	TRUE	TRUE	1	TRUE	TRUE	1	1
FBgn0035847	202	192	153	194	355	386	TRUE	FALSE	TRUE	0	TRUE	TRUE	1	0
FBgn0035848	119	109	66	101	185	210	TRUE	FALSE	TRUE	0	TRUE	FALSE	0	0
FBgn0035849	68	56	57	58	125	114	TRUE	TRUE	TRUE	1	TRUE	TRUE	1	1
FBgn0035850	169	176	148	160	317	336	TRUE	TRUE	TRUE	1	TRUE	TRUE	1	1
FBgn0035851	163	144	116	127	279	271	TRUE	TRUE	TRUE	1	TRUE	TRUE	1	1
FBgn0035852	84	90	53	68	137	158	TRUE	TRUE	TRUE	1	TRUE	TRUE	1	1
FBgn0035853	54	62	62	47	116	109	TRUE	TRUE	TRUE	1	TRUE	TRUE	1	1
FBgn0035854	74	84	63	65	137	149	TRUE	TRUE	TRUE	1	TRUE	TRUE	1	1
FBgn0035855	63	87	56	49	119	136	FALSE	TRUE	TRUE	0	TRUE	TRUE	1	0
FBgn0035856	36	29	19	44	55	73	TRUE	FALSE	TRUE	0	TRUE	FALSE	0	0
FBgn0035857	110	104	85	86	195	190	TRUE	TRUE	TRUE	1	TRUE	TRUE	1	1
FBgn0035858	66	65	55	54	121	119	TRUE	TRUE	TRUE	1	TRUE	TRUE	1	1
FBgn0035859	59	53	45	41	104	94	TRUE	TRUE	TRUE	1	TRUE	TRUE	1	1
FBgn0035861	86	80	79	92	165	172	TRUE	TRUE	TRUE	1	TRUE	TRUE	1	1
FBgn0035865	169	166	127	135	296	301	TRUE	TRUE	TRUE	1	TRUE	TRUE	1	1
FBgn0035866	24	34	22	33	46	67	TRUE	TRUE	FALSE	0	TRUE	TRUE	1	0
FBgn0035867	76	81	52	62	128	143	TRUE	TRUE	TRUE	1	TRUE	TRUE	1	1
FBgn0035868	69	59	55	51	124	110	TRUE	TRUE	TRUE	1	TRUE	TRUE	1	1
FBgn0035870	77	80	72	70	149	150	TRUE	TRUE	TRUE	1	TRUE	TRUE	1	1
FBgn0035871	119	95	74	91	193	186	TRUE	TRUE	TRUE	1	TRUE	TRUE	1	1
FBgn0035872	171	177	153	155	324	332	TRUE	TRUE	TRUE	1	TRUE	TRUE	1	1
FBgn0035873	91	95	93	98	184	193	TRUE	TRUE	TRUE	1	TRUE	TRUE	1	1
FBgn0035875	129	132	105	100	234	232	TRUE	TRUE	TRUE	1	TRUE	TRUE	1	1
FBgn0035876	68	75	51	55	119	130	TRUE	TRUE	TRUE	1	TRUE	TRUE	1	1
FBgn0035877	105	96	86	77	191	173	TRUE	TRUE	TRUE	1	TRUE	TRUE	1	1
FBgn0035878	104	134	92	103	196	237	FALSE	TRUE	FALSE	0	TRUE	TRUE	1	0
FBgn0035879	270	289	201	230	471	519	TRUE	TRUE	TRUE	1	TRUE	TRUE	1	1
FBgn0035880	88	67	60	53	148	120	TRUE	TRUE	FALSE	0	TRUE	TRUE	1	0
FBgn0035886	63	64	53	51	116	115	TRUE	TRUE	TRUE	1	TRUE	TRUE	1	1
FBgn0035887	90	38	54	46	144	84	FALSE	TRUE	FALSE	0	FALSE	TRUE	0	0
FBgn0035888	221	193	162	181	383	374	TRUE	TRUE	TRUE	1	TRUE	TRUE	1	1
FBgn0035890	80	85	59	73	139	158	TRUE	TRUE	TRUE	1	TRUE	TRUE	1	1
FBgn0035896	178	166	141	148	319	314	TRUE	TRUE	TRUE	1	TRUE	TRUE	1	1
FBgn0035900	107	123	76	112	183	235	TRUE	FALSE	FALSE	0	TRUE	TRUE	1	0
FBgn0035901	181	168	162	159	343	327	TRUE	TRUE	TRUE	1	TRUE	TRUE	1	1
FBgn0035902	133	103	83	94	216	197	FALSE	TRUE	TRUE	0	TRUE	TRUE	1	0
FBgn0035903	298	270	207	190	505	460	TRUE	TRUE	TRUE	1	TRUE	TRUE	1	1
FBgn0035904	89	104	82	66	171	170	TRUE	TRUE	TRUE	1	TRUE	TRUE	1	1
FBgn0035906	109	129	88	86	197	215	TRUE	TRUE	TRUE	1	TRUE	TRUE	1	1
FBgn0035907	39	47	32	39	71	86	TRUE	TRUE	TRUE	1	TRUE	TRUE	1	1
FBgn0035909	212	231	171	179	383	410	TRUE	TRUE	TRUE	1	TRUE	TRUE	1	1
FBgn0035911	139	139	117	135	256	274	TRUE	TRUE	TRUE	1	TRUE	TRUE	1	1
FBgn0035914	407	408	343	361	750	769	TRUE	TRUE	TRUE	1	TRUE	TRUE	1	1
FBgn0035915	93	111	94	96	187	207	TRUE	TRUE	TRUE	1	TRUE	TRUE	1	1
FBgn0035916	189	164	142	122	331	286	TRUE	TRUE	FALSE	0	TRUE	TRUE	1	0
FBgn0035917	364	398	379	332	743	730	TRUE	FALSE	TRUE	0	TRUE	TRUE	1	0
FBgn0035918	222	208	141	158	363	366	TRUE	TRUE	TRUE	1	TRUE	TRUE	1	1
FBgn0035921	81	70	55	50	136	120	TRUE	TRUE	TRUE	1	TRUE	TRUE	1	1
FBgn0035922	70	76	60	85	130	161	TRUE	FALSE	FALSE	0	TRUE	TRUE	1	0
FBgn0035923	2816	2918	153	166	2969	3084	TRUE	TRUE	TRUE	1	TRUE	TRUE	1	1
FBgn0035924	225	215	83	54	308	269	TRUE	FALSE	TRUE	0	TRUE	FALSE	0	0
FBgn0035926	55	39	22	23	77	62	TRUE	TRUE	TRUE	1	TRUE	TRUE	1	1
FBgn0035928	172	150	114	91	286	241	TRUE	TRUE	FALSE	0	TRUE	TRUE	1	0
FBgn0035929	77	99	60	48	137	147	TRUE	TRUE	TRUE	1	TRUE	TRUE	1	1
FBgn0035931	85	94	57	80	142	174	TRUE	FALSE	FALSE	0	TRUE	TRUE	1	0
FBgn0035932	65	71	53	56	118	127	TRUE	TRUE	TRUE	1	TRUE	TRUE	1	1
FBgn0035933	108	108	89	74	197	182	TRUE	TRUE	TRUE	1	TRUE	TRUE	1	1
FBgn0035934	424	477	355	400	779	877	FALSE	TRUE	FALSE	0	TRUE	TRUE	1	0
FBgn0035936	167	186	152	164	319	350	TRUE	TRUE	TRUE	1	TRUE	TRUE	1	1
FBgn0035941	105	117	77	92	182	209	TRUE	TRUE	TRUE	1	TRUE	TRUE	1	1
FBgn0035942	198	219	205	154	403	373	TRUE	FALSE	TRUE	0	TRUE	TRUE	1	0
FBgn0035943	147	139	113	119	260	258	TRUE	TRUE	TRUE	1	TRUE	TRUE	1	1
FBgn0035944	120	111	98	81	218	192	TRUE	TRUE	TRUE	1	TRUE	TRUE	1	1
FBgn0035945	215	174	144	158	359	332	FALSE	TRUE	TRUE	0	TRUE	TRUE	1	0
FBgn0035947	114	111	86	78	200	189	TRUE	TRUE	TRUE	1	TRUE	TRUE	1	1
FBgn0035948	129	119	92	92	221	211	TRUE	TRUE	TRUE	1	TRUE	TRUE	1	1
FBgn0035949	30	21	26	30	56	51	TRUE	TRUE	TRUE	1	TRUE	TRUE	1	1
FBgn0035951	127	134	83	85	210	219	TRUE	TRUE	TRUE	1	TRUE	TRUE	1	1
FBgn0035952	49	62	59	51	108	113	TRUE	TRUE	TRUE	1	TRUE	TRUE	1	1
FBgn0035953	258	290	238	190	496	480	TRUE	FALSE	TRUE	0	TRUE	TRUE	1	0
FBgn0035954	153	158	149	113	302	271	TRUE	FALSE	TRUE	0	TRUE	TRUE	1	0
FBgn0035955	127	104	96	100	223	204	TRUE	TRUE	TRUE	1	TRUE	TRUE	1	1
FBgn0035956	199	246	194	218	393	464	FALSE	TRUE	FALSE	0	TRUE	TRUE	1	0
FBgn0035957	96	80	75	51	171	131	TRUE	FALSE	FALSE	0	TRUE	TRUE	1	0
FBgn0035959	331	369	287	294	618	663	TRUE	TRUE	TRUE	1	TRUE	TRUE	1	1
FBgn0035960	104	90	86	83	190	173	TRUE	TRUE	TRUE	1	TRUE	TRUE	1	1
FBgn0035964	77	60	56	53	133	113	TRUE	TRUE	TRUE	1	TRUE	TRUE	1	1
FBgn0035965	77	85	64	79	141	164	TRUE	TRUE	TRUE	1	TRUE	TRUE	1	1
FBgn0035968	269	265	232	220	501	485	TRUE	TRUE	TRUE	1	TRUE	TRUE	1	1
FBgn0035969	222	206	184	176	406	382	TRUE	TRUE	TRUE	1	TRUE	TRUE	1	1
FBgn0035970	142	151	115	106	257	257	TRUE	TRUE	TRUE	1	TRUE	TRUE	1	1
FBgn0035971	86	99	69	71	155	170	TRUE	TRUE	TRUE	1	TRUE	TRUE	1	1
FBgn0035975	220	209	166	164	386	373	TRUE	TRUE	TRUE	1	TRUE	TRUE	1	1
FBgn0035976	428	477	369	357	797	834	TRUE	TRUE	TRUE	1	TRUE	TRUE	1	1
FBgn0035977	94	87	87	89	181	176	TRUE	TRUE	TRUE	1	TRUE	TRUE	1	1
FBgn0035978	204	196	152	174	356	370	TRUE	TRUE	TRUE	1	TRUE	TRUE	1	1
FBgn0035980	67	73	84	86	151	159	TRUE	TRUE	TRUE	1	TRUE	TRUE	1	1
FBgn0035981	152	151	110	102	262	253	TRUE	TRUE	TRUE	1	TRUE	TRUE	1	1
FBgn0035982	55	61	48	39	103	100	TRUE	TRUE	TRUE	1	TRUE	TRUE	1	1
FBgn0035983	164	141	132	138	296	279	TRUE	TRUE	TRUE	1	TRUE	TRUE	1	1
FBgn0035985	95	94	62	70	157	164	TRUE	TRUE	TRUE	1	TRUE	TRUE	1	1
FBgn0035986	264	299	224	211	488	510	TRUE	TRUE	TRUE	1	TRUE	TRUE	1	1
FBgn0035988	125	94	83	73	208	167	FALSE	TRUE	FALSE	0	TRUE	TRUE	1	0
FBgn0035989	118	109	86	115	204	224	TRUE	FALSE	TRUE	0	TRUE	TRUE	1	0
FBgn0035995	104	80	69	63	173	143	FALSE	TRUE	TRUE	0	TRUE	TRUE	1	0
FBgn0035996	33	35	31	38	64	73	TRUE	TRUE	TRUE	1	TRUE	TRUE	1	1
FBgn0035997	95	105	85	79	180	184	TRUE	TRUE	TRUE	1	TRUE	TRUE	1	1
FBgn0035998	33	30	18	23	51	53	TRUE	TRUE	TRUE	1	TRUE	TRUE	1	1
FBgn0035999	82	75	85	74	167	149	TRUE	TRUE	TRUE	1	TRUE	TRUE	1	1
FBgn0036000	89	85	55	71	144	156	TRUE	TRUE	TRUE	1	TRUE	TRUE	1	1
FBgn0036004	498	472	386	399	884	871	TRUE	TRUE	TRUE	1	TRUE	TRUE	1	1
FBgn0036005	101	101	72	89	173	190	TRUE	TRUE	TRUE	1	TRUE	TRUE	1	1
FBgn0036007	379	367	314	347	693	714	TRUE	TRUE	TRUE	1	TRUE	TRUE	1	1
FBgn0036008	196	171	158	149	354	320	TRUE	TRUE	TRUE	1	TRUE	TRUE	1	1
FBgn0036009	197	207	161	149	358	356	TRUE	TRUE	TRUE	1	TRUE	TRUE	1	1
FBgn0036010	203	205	167	195	370	400	TRUE	TRUE	TRUE	1	TRUE	TRUE	1	1
FBgn0036014	109	95	66	68	175	163	TRUE	TRUE	TRUE	1	TRUE	TRUE	1	1
FBgn0036015	65	73	37	38	102	111	TRUE	TRUE	TRUE	1	TRUE	TRUE	1	1
FBgn0036016	93	93	65	88	158	181	TRUE	FALSE	TRUE	0	TRUE	TRUE	1	0
FBgn0036018	213	204	173	201	386	405	TRUE	TRUE	TRUE	1	TRUE	TRUE	1	1
FBgn0036019	142	132	119	115	261	247	TRUE	TRUE	TRUE	1	TRUE	TRUE	1	1
FBgn0036020	121	116	85	86	206	202	TRUE	TRUE	TRUE	1	TRUE	TRUE	1	1
FBgn0036022	93	66	60	77	153	143	FALSE	TRUE	TRUE	0	TRUE	TRUE	1	0
FBgn0036023	54	86	65	56	119	142	FALSE	TRUE	TRUE	0	FALSE	TRUE	0	0
FBgn0036024	94	85	64	64	158	149	TRUE	TRUE	TRUE	1	TRUE	TRUE	1	1
FBgn0036028	137	128	108	99	245	227	TRUE	TRUE	TRUE	1	TRUE	TRUE	1	1
FBgn0036029	77	68	57	54	134	122	TRUE	TRUE	TRUE	1	TRUE	TRUE	1	1
FBgn0036030	199	205	149	159	348	364	TRUE	TRUE	TRUE	1	TRUE	TRUE	1	1
FBgn0036031	203	184	166	155	369	339	TRUE	TRUE	TRUE	1	TRUE	TRUE	1	1
FBgn0036032	230	253	192	242	422	495	TRUE	FALSE	FALSE	0	TRUE	TRUE	1	0
FBgn0036035	109	122	83	98	192	220	TRUE	TRUE	TRUE	1	TRUE	TRUE	1	1
FBgn0036036	50	57	46	39	96	96	TRUE	TRUE	TRUE	1	TRUE	TRUE	1	1
FBgn0036038	231	201	188	178	419	379	TRUE	TRUE	TRUE	1	TRUE	TRUE	1	1
FBgn0036039	203	159	155	152	358	311	FALSE	TRUE	FALSE	0	TRUE	TRUE	1	0
FBgn0036040	146	172	153	153	299	325	TRUE	TRUE	TRUE	1	TRUE	TRUE	1	1
FBgn0036043	508	494	403	430	911	924	TRUE	TRUE	TRUE	1	TRUE	TRUE	1	1
FBgn0036044	329	319	243	256	572	575	TRUE	TRUE	TRUE	1	TRUE	TRUE	1	1
FBgn0036046	76	52	61	61	137	113	FALSE	TRUE	TRUE	0	TRUE	TRUE	1	0
FBgn0036052	82	75	53	55	135	130	TRUE	TRUE	TRUE	1	TRUE	TRUE	1	1
FBgn0036053	303	285	219	223	522	508	TRUE	TRUE	TRUE	1	TRUE	TRUE	1	1
FBgn0036058	132	175	140	140	272	315	FALSE	TRUE	FALSE	0	TRUE	TRUE	1	0
FBgn0036059	223	208	178	199	401	407	TRUE	TRUE	TRUE	1	TRUE	TRUE	1	1
FBgn0036062	72	72	68	84	140	156	TRUE	TRUE	TRUE	1	TRUE	TRUE	1	1
FBgn0036063	59	57	47	47	106	104	TRUE	TRUE	TRUE	1	TRUE	TRUE	1	1
FBgn0036066	213	243	198	166	411	409	TRUE	TRUE	TRUE	1	TRUE	TRUE	1	1
FBgn0036070	101	91	93	107	194	198	TRUE	TRUE	TRUE	1	TRUE	TRUE	1	1
FBgn0036072	108	112	116	92	224	204	TRUE	TRUE	TRUE	1	TRUE	TRUE	1	1
FBgn0036075	84	83	79	70	163	153	TRUE	TRUE	TRUE	1	TRUE	TRUE	1	1
FBgn0036078	145	135	110	118	255	253	TRUE	TRUE	TRUE	1	TRUE	TRUE	1	1
FBgn0036080	151	155	122	131	273	286	TRUE	TRUE	TRUE	1	TRUE	TRUE	1	1
FBgn0036082	100	82	69	75	169	157	TRUE	TRUE	TRUE	1	TRUE	TRUE	1	1
FBgn0036083	221	257	182	169	403	426	TRUE	TRUE	TRUE	1	TRUE	TRUE	1	1
FBgn0036085	155	135	140	125	295	260	TRUE	TRUE	TRUE	1	TRUE	TRUE	1	1
FBgn0036089	58	62	54	65	112	127	TRUE	TRUE	TRUE	1	TRUE	TRUE	1	1
FBgn0036090	64	83	57	56	121	139	TRUE	TRUE	TRUE	1	TRUE	TRUE	1	1
FBgn0036091	27	18	12	22	39	40	TRUE	TRUE	TRUE	1	TRUE	FALSE	0	0
FBgn0036093	79	103	76	86	155	189	FALSE	TRUE	FALSE	0	TRUE	TRUE	1	0
FBgn0036094	110	98	83	71	193	169	TRUE	TRUE	TRUE	1	TRUE	TRUE	1	1
FBgn0036096	160	186	144	114	304	300	TRUE	FALSE	TRUE	0	TRUE	TRUE	1	0
FBgn0036099	137	109	106	107	243	216	FALSE	TRUE	TRUE	0	TRUE	TRUE	1	0
FBgn0036101	180	217	144	177	324	394	FALSE	FALSE	FALSE	0	TRUE	TRUE	1	0
FBgn0036102	64	68	34	60	98	128	TRUE	FALSE	FALSE	0	TRUE	FALSE	0	0
FBgn0036104	168	158	116	127	284	285	TRUE	TRUE	TRUE	1	TRUE	TRUE	1	1
FBgn0036105	97	93	83	78	180	171	TRUE	TRUE	TRUE	1	TRUE	TRUE	1	1
FBgn0036106	149	140	122	126	271	266	TRUE	TRUE	TRUE	1	TRUE	TRUE	1	1
FBgn0036107	75	68	57	63	132	131	TRUE	TRUE	TRUE	1	TRUE	TRUE	1	1
FBgn0036108	83	66	64	61	147	127	TRUE	TRUE	TRUE	1	TRUE	TRUE	1	1
FBgn0036109	78	102	69	61	147	163	FALSE	TRUE	TRUE	0	TRUE	TRUE	1	0
FBgn0036111	156	145	137	133	293	278	TRUE	TRUE	TRUE	1	TRUE	TRUE	1	1
FBgn0036112	89	96	96	67	185	163	TRUE	FALSE	TRUE	0	TRUE	TRUE	1	0
FBgn0036116	292	331	232	227	524	558	TRUE	TRUE	TRUE	1	TRUE	TRUE	1	1
FBgn0036117	149	167	141	104	290	271	TRUE	FALSE	TRUE	0	TRUE	TRUE	1	0
FBgn0036118	44	46	43	34	87	80	TRUE	TRUE	TRUE	1	TRUE	TRUE	1	1
FBgn0036121	58	51	65	47	123	98	TRUE	TRUE	TRUE	1	TRUE	TRUE	1	1
FBgn0036124	325	349	291	284	616	633	TRUE	TRUE	TRUE	1	TRUE	TRUE	1	1
FBgn0036125	148	124	135	110	283	234	TRUE	TRUE	FALSE	0	TRUE	TRUE	1	0
FBgn0036128	98	89	69	77	167	166	TRUE	TRUE	TRUE	1	TRUE	TRUE	1	1
FBgn0036131	50	29	40	41	90	70	FALSE	TRUE	TRUE	0	FALSE	TRUE	0	0
FBgn0036133	204	195	133	153	337	348	TRUE	TRUE	TRUE	1	TRUE	TRUE	1	1
FBgn0036134	382	388	304	314	686	702	TRUE	TRUE	TRUE	1	TRUE	TRUE	1	1
FBgn0036135	74	70	71	53	145	123	TRUE	TRUE	TRUE	1	TRUE	TRUE	1	1
FBgn0036136	79	70	55	49	134	119	TRUE	TRUE	TRUE	1	TRUE	TRUE	1	1
FBgn0036138	55	77	61	71	116	148	FALSE	TRUE	FALSE	0	TRUE	TRUE	1	0
FBgn0036139	110	125	77	85	187	210	TRUE	TRUE	TRUE	1	TRUE	TRUE	1	1
FBgn0036141	102	91	77	106	179	197	TRUE	FALSE	TRUE	0	TRUE	TRUE	1	0
FBgn0036142	127	133	139	114	266	247	TRUE	TRUE	TRUE	1	TRUE	TRUE	1	1
FBgn0036143	252	251	221	210	473	461	TRUE	TRUE	TRUE	1	TRUE	TRUE	1	1
FBgn0036144	333	357	277	317	610	674	TRUE	TRUE	FALSE	0	TRUE	TRUE	1	0
FBgn0036145	77	121	84	88	161	209	FALSE	TRUE	FALSE	0	FALSE	TRUE	0	0
FBgn0036146	84	72	59	73	143	145	TRUE	TRUE	TRUE	1	TRUE	TRUE	1	1
FBgn0036147	334	296	265	244	599	540	TRUE	TRUE	FALSE	0	TRUE	TRUE	1	0
FBgn0036150	294	282	223	249	517	531	TRUE	TRUE	TRUE	1	TRUE	TRUE	1	1
FBgn0036152	180	141	134	146	314	287	FALSE	TRUE	TRUE	0	TRUE	TRUE	1	0
FBgn0036153	147	141	135	128	282	269	TRUE	TRUE	TRUE	1	TRUE	TRUE	1	1
FBgn0036154	162	174	99	134	261	308	TRUE	FALSE	FALSE	0	TRUE	TRUE	1	0
FBgn0036155	164	158	133	120	297	278	TRUE	TRUE	TRUE	1	TRUE	TRUE	1	1
FBgn0036156	71	50	53	63	124	113	FALSE	TRUE	TRUE	0	TRUE	TRUE	1	0
FBgn0036157	125	135	114	109	239	244	TRUE	TRUE	TRUE	1	TRUE	TRUE	1	1
FBgn0036158	91	72	86	89	177	161	TRUE	TRUE	TRUE	1	TRUE	TRUE	1	1
FBgn0036159	104	80	85	75	189	155	FALSE	TRUE	FALSE	0	TRUE	TRUE	1	0
FBgn0036160	124	110	112	87	236	197	TRUE	FALSE	FALSE	0	TRUE	TRUE	1	0
FBgn0036161	66	73	58	56	124	129	TRUE	TRUE	TRUE	1	TRUE	TRUE	1	1
FBgn0036162	210	200	182	160	392	360	TRUE	TRUE	TRUE	1	TRUE	TRUE	1	1
FBgn0036165	218	199	177	184	395	383	TRUE	TRUE	TRUE	1	TRUE	TRUE	1	1
FBgn0036168	152	195	130	156	282	351	FALSE	TRUE	FALSE	0	TRUE	TRUE	1	0
FBgn0036173	96	94	71	87	167	181	TRUE	TRUE	TRUE	1	TRUE	TRUE	1	1
FBgn0036176	32	23	26	25	58	48	TRUE	TRUE	TRUE	1	TRUE	TRUE	1	1
FBgn0036177	37	29	40	30	77	59	TRUE	TRUE	TRUE	1	TRUE	TRUE	1	1
FBgn0036179	220	227	164	205	384	432	TRUE	FALSE	FALSE	0	TRUE	TRUE	1	0
FBgn0036180	218	203	134	155	352	358	TRUE	TRUE	TRUE	1	TRUE	TRUE	1	1
FBgn0036181	565	603	444	479	1009	1082	TRUE	TRUE	TRUE	1	TRUE	TRUE	1	1
FBgn0036183	173	169	155	143	328	312	TRUE	TRUE	TRUE	1	TRUE	TRUE	1	1
FBgn0036184	101	104	96	92	197	196	TRUE	TRUE	TRUE	1	TRUE	TRUE	1	1
FBgn0036186	250	227	203	148	453	375	TRUE	FALSE	FALSE	0	TRUE	TRUE	1	0
FBgn0036187	161	150	111	123	272	273	TRUE	TRUE	TRUE	1	TRUE	TRUE	1	1
FBgn0036188	123	119	87	86	210	205	TRUE	TRUE	TRUE	1	TRUE	TRUE	1	1
FBgn0036191	133	126	104	105	237	231	TRUE	TRUE	TRUE	1	TRUE	TRUE	1	1
FBgn0036192	69	80	45	60	114	140	TRUE	TRUE	TRUE	1	TRUE	TRUE	1	1
FBgn0036193	149	152	127	118	276	270	TRUE	TRUE	TRUE	1	TRUE	TRUE	1	1
FBgn0036194	137	166	122	137	259	303	TRUE	TRUE	FALSE	0	TRUE	TRUE	1	0
FBgn0036195	191	211	129	147	320	358	TRUE	TRUE	TRUE	1	TRUE	TRUE	1	1
FBgn0036196	216	220	226	207	442	427	TRUE	TRUE	TRUE	1	TRUE	TRUE	1	1
FBgn0036198	60	61	39	38	99	99	TRUE	TRUE	TRUE	1	TRUE	TRUE	1	1
FBgn0036199	154	135	105	134	259	269	TRUE	FALSE	TRUE	0	TRUE	TRUE	1	0
FBgn0036202	409	402	363	340	772	742	TRUE	TRUE	TRUE	1	TRUE	TRUE	1	1
FBgn0036203	129	137	123	112	252	249	TRUE	TRUE	TRUE	1	TRUE	TRUE	1	1
FBgn0036204	52	40	24	41	76	81	TRUE	FALSE	TRUE	0	TRUE	FALSE	0	0
FBgn0036205	200	212	194	193	394	405	TRUE	TRUE	TRUE	1	TRUE	TRUE	1	1
FBgn0036206	238	212	179	183	417	395	TRUE	TRUE	TRUE	1	TRUE	TRUE	1	1
FBgn0036207	168	181	126	164	294	345	TRUE	FALSE	FALSE	0	TRUE	TRUE	1	0
FBgn0036208	69	97	82	71	151	168	FALSE	TRUE	TRUE	0	TRUE	TRUE	1	0
FBgn0036210	91	88	85	80	176	168	TRUE	TRUE	TRUE	1	TRUE	TRUE	1	1
FBgn0036211	114	99	85	98	199	197	TRUE	TRUE	TRUE	1	TRUE	TRUE	1	1
FBgn0036212	144	126	104	91	248	217	TRUE	TRUE	TRUE	1	TRUE	TRUE	1	1
FBgn0036213	47	69	48	32	95	101	FALSE	FALSE	TRUE	0	TRUE	TRUE	1	0
FBgn0036214	113	121	65	82	178	203	TRUE	TRUE	TRUE	1	TRUE	TRUE	1	1
FBgn0036217	77	66	76	66	153	132	TRUE	TRUE	TRUE	1	TRUE	TRUE	1	1
FBgn0036218	196	202	178	168	374	370	TRUE	TRUE	TRUE	1	TRUE	TRUE	1	1
FBgn0036219	114	115	103	121	217	236	TRUE	TRUE	TRUE	1	TRUE	TRUE	1	1
FBgn0036220	113	107	118	108	231	215	TRUE	TRUE	TRUE	1	TRUE	TRUE	1	1
FBgn0036221	92	86	82	72	174	158	TRUE	TRUE	TRUE	1	TRUE	TRUE	1	1
FBgn0036222	123	116	109	90	232	206	TRUE	TRUE	TRUE	1	TRUE	TRUE	1	1
FBgn0036224	141	132	114	120	255	252	TRUE	TRUE	TRUE	1	TRUE	TRUE	1	1
FBgn0036225	33	41	23	40	56	81	TRUE	FALSE	FALSE	0	TRUE	FALSE	0	0
FBgn0036226	109	93	101	88	210	181	TRUE	TRUE	TRUE	1	TRUE	TRUE	1	1
FBgn0036227	60	40	34	34	94	74	FALSE	TRUE	TRUE	0	TRUE	TRUE	1	0
FBgn0036228	47	51	48	52	95	103	TRUE	TRUE	TRUE	1	TRUE	TRUE	1	1
FBgn0036229	242	230	181	185	423	415	TRUE	TRUE	TRUE	1	TRUE	TRUE	1	1
FBgn0036230	48	61	58	49	106	110	TRUE	TRUE	TRUE	1	TRUE	TRUE	1	1
FBgn0036232	42	38	43	25	85	63	TRUE	FALSE	FALSE	0	TRUE	FALSE	0	0
FBgn0036235	375	325	326	299	701	624	FALSE	TRUE	FALSE	0	TRUE	TRUE	1	0
FBgn0036237	59	56	50	40	109	96	TRUE	TRUE	TRUE	1	TRUE	TRUE	1	1
FBgn0036239	145	155	121	118	266	273	TRUE	TRUE	TRUE	1	TRUE	TRUE	1	1
FBgn0036240	238	233	242	193	480	426	TRUE	FALSE	FALSE	0	TRUE	TRUE	1	0
FBgn0036242	136	148	130	117	266	265	TRUE	TRUE	TRUE	1	TRUE	TRUE	1	1
FBgn0036246	74	80	76	60	150	140	TRUE	TRUE	TRUE	1	TRUE	TRUE	1	1
FBgn0036248	79	72	54	58	133	130	TRUE	TRUE	TRUE	1	TRUE	TRUE	1	1
FBgn0036249	80	66	69	60	149	126	TRUE	TRUE	TRUE	1	TRUE	TRUE	1	1
FBgn0036250	153	120	122	117	275	237	FALSE	TRUE	TRUE	0	TRUE	TRUE	1	0
FBgn0036254	204	192	170	192	374	384	TRUE	TRUE	TRUE	1	TRUE	TRUE	1	1
FBgn0036257	179	156	146	153	325	309	TRUE	TRUE	TRUE	1	TRUE	TRUE	1	1
FBgn0036258	94	100	96	94	190	194	TRUE	TRUE	TRUE	1	TRUE	TRUE	1	1
FBgn0036259	395	140	306	147	701	287	FALSE	FALSE	FALSE	0	FALSE	FALSE	0	0
FBgn0036260	344	328	327	289	671	617	TRUE	TRUE	TRUE	1	TRUE	TRUE	1	1
FBgn0036262	224	202	183	165	407	367	TRUE	TRUE	TRUE	1	TRUE	TRUE	1	1
FBgn0036263	70	82	70	62	140	144	TRUE	TRUE	TRUE	1	TRUE	TRUE	1	1
FBgn0036264	94	109	73	84	167	193	TRUE	TRUE	TRUE	1	TRUE	TRUE	1	1
FBgn0036266	156	176	160	153	316	329	TRUE	TRUE	TRUE	1	TRUE	TRUE	1	1
FBgn0036271	74	74	62	54	136	128	TRUE	TRUE	TRUE	1	TRUE	TRUE	1	1
FBgn0036272	234	223	182	188	416	411	TRUE	TRUE	TRUE	1	TRUE	TRUE	1	1
FBgn0036273	261	256	204	201	465	457	TRUE	TRUE	TRUE	1	TRUE	TRUE	1	1
FBgn0036274	121	128	112	91	233	219	TRUE	TRUE	TRUE	1	TRUE	TRUE	1	1
FBgn0036277	60	61	38	36	98	97	TRUE	TRUE	TRUE	1	TRUE	TRUE	1	1
FBgn0036278	335	368	279	290	614	658	TRUE	TRUE	TRUE	1	TRUE	TRUE	1	1
FBgn0036279	535	564	480	481	1015	1045	TRUE	TRUE	TRUE	1	TRUE	TRUE	1	1
FBgn0036282	166	213	146	152	312	365	FALSE	TRUE	FALSE	0	TRUE	TRUE	1	0
FBgn0036285	218	214	167	160	385	374	TRUE	TRUE	TRUE	1	TRUE	TRUE	1	1
FBgn0036286	144	167	106	135	250	302	TRUE	FALSE	FALSE	0	TRUE	TRUE	1	0
FBgn0036287	331	362	276	276	607	638	TRUE	TRUE	TRUE	1	TRUE	TRUE	1	1
FBgn0036288	200	216	169	151	369	367	TRUE	TRUE	TRUE	1	TRUE	TRUE	1	1
FBgn0036289	24	24	16	19	40	43	TRUE	TRUE	TRUE	1	TRUE	TRUE	1	1
FBgn0036290	151	178	146	136	297	314	TRUE	TRUE	TRUE	1	TRUE	TRUE	1	1
FBgn0036291	50	59	46	55	96	114	TRUE	TRUE	TRUE	1	TRUE	TRUE	1	1
FBgn0036292	76	81	51	81	127	162	TRUE	FALSE	FALSE	0	TRUE	FALSE	0	0
FBgn0036294	97	102	105	92	202	194	TRUE	TRUE	TRUE	1	TRUE	TRUE	1	1
FBgn0036298	175	208	136	142	311	350	TRUE	TRUE	TRUE	1	TRUE	TRUE	1	1
FBgn0036299	260	279	229	251	489	530	TRUE	TRUE	TRUE	1	TRUE	TRUE	1	1
FBgn0036300	60	71	58	59	118	130	TRUE	TRUE	TRUE	1	TRUE	TRUE	1	1
FBgn0036301	138	125	84	120	222	245	TRUE	FALSE	TRUE	0	TRUE	TRUE	1	0
FBgn0036302	506	507	477	439	983	946	TRUE	TRUE	TRUE	1	TRUE	TRUE	1	1
FBgn0036305	156	149	127	127	283	276	TRUE	TRUE	TRUE	1	TRUE	TRUE	1	1
FBgn0036306	115	111	107	99	222	210	TRUE	TRUE	TRUE	1	TRUE	TRUE	1	1
FBgn0036309	340	308	258	273	598	581	TRUE	TRUE	TRUE	1	TRUE	TRUE	1	1
FBgn0036310	203	156	144	162	347	318	FALSE	TRUE	TRUE	0	TRUE	TRUE	1	0
FBgn0036311	97	99	96	90	193	189	TRUE	TRUE	TRUE	1	TRUE	TRUE	1	1
FBgn0036314	81	97	81	65	162	162	TRUE	TRUE	TRUE	1	TRUE	TRUE	1	1
FBgn0036316	448	405	357	351	805	756	TRUE	TRUE	TRUE	1	TRUE	TRUE	1	1
FBgn0036317	217	203	176	194	393	397	TRUE	TRUE	TRUE	1	TRUE	TRUE	1	1
FBgn0036318	292	309	216	191	508	500	TRUE	TRUE	TRUE	1	TRUE	TRUE	1	1
FBgn0036319	299	319	262	242	561	561	TRUE	TRUE	TRUE	1	TRUE	TRUE	1	1
FBgn0036320	141	148	137	116	278	264	TRUE	TRUE	TRUE	1	TRUE	TRUE	1	1
FBgn0036321	329	316	240	289	569	605	TRUE	FALSE	TRUE	0	TRUE	TRUE	1	0
FBgn0036323	86	92	75	83	161	175	TRUE	TRUE	TRUE	1	TRUE	TRUE	1	1
FBgn0036324	92	59	75	74	167	133	FALSE	TRUE	FALSE	0	FALSE	TRUE	0	0
FBgn0036325	113	138	109	95	222	233	TRUE	TRUE	TRUE	1	TRUE	TRUE	1	1
FBgn0036327	67	50	39	47	106	97	TRUE	TRUE	TRUE	1	TRUE	TRUE	1	1
FBgn0036328	72	86	58	73	130	159	TRUE	TRUE	FALSE	0	TRUE	TRUE	1	0
FBgn0036329	176	191	139	123	315	314	TRUE	TRUE	TRUE	1	TRUE	TRUE	1	1
FBgn0036330	59	48	57	45	116	93	TRUE	TRUE	TRUE	1	TRUE	TRUE	1	1
FBgn0036331	97	95	65	82	162	177	TRUE	TRUE	TRUE	1	TRUE	TRUE	1	1
FBgn0036332	160	164	135	113	295	277	TRUE	TRUE	TRUE	1	TRUE	TRUE	1	1
FBgn0036333	70	80	59	60	129	140	TRUE	TRUE	TRUE	1	TRUE	TRUE	1	1
FBgn0036334	38	36	21	30	59	66	TRUE	TRUE	TRUE	1	TRUE	TRUE	1	1
FBgn0036335	52	41	35	35	87	76	TRUE	TRUE	TRUE	1	TRUE	TRUE	1	1
FBgn0036337	145	155	121	115	266	270	TRUE	TRUE	TRUE	1	TRUE	TRUE	1	1
FBgn0036340	194	170	124	151	318	321	TRUE	TRUE	TRUE	1	TRUE	TRUE	1	1
FBgn0036341	108	101	89	74	197	175	TRUE	TRUE	TRUE	1	TRUE	TRUE	1	1
FBgn0036342	150	145	122	132	272	277	TRUE	TRUE	TRUE	1	TRUE	TRUE	1	1
FBgn0036343	135	121	106	97	241	218	TRUE	TRUE	TRUE	1	TRUE	TRUE	1	1
FBgn0036345	103	96	77	75	180	171	TRUE	TRUE	TRUE	1	TRUE	TRUE	1	1
FBgn0036346	58	81	64	63	122	144	FALSE	TRUE	TRUE	0	TRUE	TRUE	1	0
FBgn0036348	415	451	331	294	746	745	TRUE	TRUE	TRUE	1	TRUE	TRUE	1	1
FBgn0036349	53	32	41	41	94	73	FALSE	TRUE	TRUE	0	FALSE	TRUE	0	0
FBgn0036350	57	57	41	46	98	103	TRUE	TRUE	TRUE	1	TRUE	TRUE	1	1
FBgn0036351	85	78	66	61	151	139	TRUE	TRUE	TRUE	1	TRUE	TRUE	1	1
FBgn0036352	96	80	64	66	160	146	TRUE	TRUE	TRUE	1	TRUE	TRUE	1	1
FBgn0036353	172	148	142	118	314	266	TRUE	TRUE	FALSE	0	TRUE	TRUE	1	0
FBgn0036354	142	155	135	130	277	285	TRUE	TRUE	TRUE	1	TRUE	TRUE	1	1
FBgn0036356	101	107	82	76	183	183	TRUE	TRUE	TRUE	1	TRUE	TRUE	1	1
FBgn0036359	92	79	75	77	167	156	TRUE	TRUE	TRUE	1	TRUE	TRUE	1	1
FBgn0036360	155	187	159	192	314	379	FALSE	FALSE	FALSE	0	TRUE	TRUE	1	0
FBgn0036361	135	85	107	104	242	189	FALSE	TRUE	FALSE	0	FALSE	TRUE	0	0
FBgn0036362	122	108	87	106	209	214	TRUE	TRUE	TRUE	1	TRUE	TRUE	1	1
FBgn0036363	91	85	74	71	165	156	TRUE	TRUE	TRUE	1	TRUE	TRUE	1	1
FBgn0036364	101	97	90	80	191	177	TRUE	TRUE	TRUE	1	TRUE	TRUE	1	1
FBgn0036365	367	315	258	294	625	609	FALSE	TRUE	TRUE	0	TRUE	TRUE	1	0
FBgn0036366	43	60	47	43	90	103	TRUE	TRUE	TRUE	1	TRUE	TRUE	1	1
FBgn0036367	94	114	80	93	174	207	TRUE	TRUE	TRUE	1	TRUE	TRUE	1	1
FBgn0036368	365	373	318	318	683	691	TRUE	TRUE	TRUE	1	TRUE	TRUE	1	1
FBgn0036369	296	323	243	262	539	585	TRUE	TRUE	TRUE	1	TRUE	TRUE	1	1
FBgn0036372	147	189	145	133	292	322	FALSE	TRUE	TRUE	0	TRUE	TRUE	1	0
FBgn0036373	226	206	155	159	381	365	TRUE	TRUE	TRUE	1	TRUE	TRUE	1	1
FBgn0036374	470	472	386	367	856	839	TRUE	TRUE	TRUE	1	TRUE	TRUE	1	1
FBgn0036376	67	81	74	56	141	137	TRUE	TRUE	TRUE	1	TRUE	TRUE	1	1
FBgn0036377	207	208	164	160	371	368	TRUE	TRUE	TRUE	1	TRUE	TRUE	1	1
FBgn0036380	31	36	20	19	51	55	TRUE	TRUE	TRUE	1	TRUE	TRUE	1	1
FBgn0036381	274	266	225	209	499	475	TRUE	TRUE	TRUE	1	TRUE	TRUE	1	1
FBgn0036382	105	96	101	93	206	189	TRUE	TRUE	TRUE	1	TRUE	TRUE	1	1
FBgn0036386	297	291	264	239	561	530	TRUE	TRUE	TRUE	1	TRUE	TRUE	1	1
FBgn0036390	33	42	25	16	58	58	TRUE	TRUE	TRUE	1	TRUE	FALSE	0	0
FBgn0036391	427	416	361	365	788	781	TRUE	TRUE	TRUE	1	TRUE	TRUE	1	1
FBgn0036393	38	31	38	31	76	62	TRUE	TRUE	TRUE	1	TRUE	TRUE	1	1
FBgn0036394	76	73	66	62	142	135	TRUE	TRUE	TRUE	1	TRUE	TRUE	1	1
FBgn0036395	44	55	47	45	91	100	TRUE	TRUE	TRUE	1	TRUE	TRUE	1	1
FBgn0036396	47	43	34	29	81	72	TRUE	TRUE	TRUE	1	TRUE	TRUE	1	1
FBgn0036397	73	69	53	63	126	132	TRUE	TRUE	TRUE	1	TRUE	TRUE	1	1
FBgn0036398	419	433	361	367	780	800	TRUE	TRUE	TRUE	1	TRUE	TRUE	1	1
FBgn0036402	144	135	100	114	244	249	TRUE	TRUE	TRUE	1	TRUE	TRUE	1	1
FBgn0036405	72	47	39	50	111	97	FALSE	TRUE	TRUE	0	FALSE	TRUE	0	0
FBgn0036406	33	28	27	22	60	50	TRUE	TRUE	TRUE	1	TRUE	TRUE	1	1
FBgn0036410	305	274	251	243	556	517	TRUE	TRUE	TRUE	1	TRUE	TRUE	1	1
FBgn0036411	163	143	144	126	307	269	TRUE	TRUE	TRUE	1	TRUE	TRUE	1	1
FBgn0036414	118	120	97	95	215	215	TRUE	TRUE	TRUE	1	TRUE	TRUE	1	1
FBgn0036415	34	38	30	24	64	62	TRUE	TRUE	TRUE	1	TRUE	TRUE	1	1
FBgn0036416	94	105	105	93	199	198	TRUE	TRUE	TRUE	1	TRUE	TRUE	1	1
FBgn0036417	62	66	52	43	114	109	TRUE	TRUE	TRUE	1	TRUE	TRUE	1	1
FBgn0036419	55	48	55	58	110	106	TRUE	TRUE	TRUE	1	TRUE	TRUE	1	1
FBgn0036421	39	64	52	37	91	101	FALSE	TRUE	TRUE	0	FALSE	TRUE	0	0
FBgn0036422	148	172	112	98	260	270	TRUE	TRUE	TRUE	1	TRUE	TRUE	1	1
FBgn0036423	133	126	116	121	249	247	TRUE	TRUE	TRUE	1	TRUE	TRUE	1	1
FBgn0036426	50	66	49	56	99	122	TRUE	TRUE	TRUE	1	TRUE	TRUE	1	1
FBgn0036427	129	139	108	114	237	253	TRUE	TRUE	TRUE	1	TRUE	TRUE	1	1
FBgn0036428	252	225	200	218	452	443	TRUE	TRUE	TRUE	1	TRUE	TRUE	1	1
FBgn0036433	69	47	50	43	119	90	FALSE	TRUE	FALSE	0	TRUE	TRUE	1	0
FBgn0036436	86	105	66	63	152	168	TRUE	TRUE	TRUE	1	TRUE	TRUE	1	1
FBgn0036437	112	75	90	94	202	169	FALSE	TRUE	FALSE	0	TRUE	TRUE	1	0
FBgn0036438	75	66	38	42	113	108	TRUE	TRUE	TRUE	1	TRUE	TRUE	1	1
FBgn0036439	27	26	19	26	46	52	TRUE	TRUE	TRUE	1	TRUE	TRUE	1	1
FBgn0036440	224	237	190	219	414	456	TRUE	TRUE	TRUE	1	TRUE	TRUE	1	1
FBgn0036441	40	50	41	37	81	87	TRUE	TRUE	TRUE	1	TRUE	TRUE	1	1
FBgn0036442	47	48	42	34	89	82	TRUE	TRUE	TRUE	1	TRUE	TRUE	1	1
FBgn0036443	55	59	29	38	84	97	TRUE	TRUE	TRUE	1	TRUE	TRUE	1	1
FBgn0036446	325	302	257	265	582	567	TRUE	TRUE	TRUE	1	TRUE	TRUE	1	1
FBgn0036447	85	92	85	70	170	162	TRUE	TRUE	TRUE	1	TRUE	TRUE	1	1
FBgn0036448	486	475	403	389	889	864	TRUE	TRUE	TRUE	1	TRUE	TRUE	1	1
FBgn0036449	203	217	182	183	385	400	TRUE	TRUE	TRUE	1	TRUE	TRUE	1	1
FBgn0036450	192	190	159	134	351	324	TRUE	TRUE	TRUE	1	TRUE	TRUE	1	1
FBgn0036451	490	423	376	313	866	736	FALSE	FALSE	FALSE	0	TRUE	TRUE	1	0
FBgn0036454	371	364	296	269	667	633	TRUE	TRUE	TRUE	1	TRUE	TRUE	1	1
FBgn0036459	182	174	168	149	350	323	TRUE	TRUE	TRUE	1	TRUE	TRUE	1	1
FBgn0036460	117	108	110	107	227	215	TRUE	TRUE	TRUE	1	TRUE	TRUE	1	1
FBgn0036461	163	165	148	127	311	292	TRUE	TRUE	TRUE	1	TRUE	TRUE	1	1
FBgn0036462	58	61	55	52	113	113	TRUE	TRUE	TRUE	1	TRUE	TRUE	1	1
FBgn0036463	450	431	318	370	768	801	TRUE	FALSE	TRUE	0	TRUE	TRUE	1	0
FBgn0036465	93	74	71	68	164	142	TRUE	TRUE	TRUE	1	TRUE	TRUE	1	1
FBgn0036466	33	28	27	28	60	56	TRUE	TRUE	TRUE	1	TRUE	TRUE	1	1
FBgn0036467	35	31	25	20	60	51	TRUE	TRUE	TRUE	1	TRUE	TRUE	1	1
FBgn0036468	72	64	56	63	128	127	TRUE	TRUE	TRUE	1	TRUE	TRUE	1	1
FBgn0036469	73	94	66	61	139	155	TRUE	TRUE	TRUE	1	TRUE	TRUE	1	1
FBgn0036470	59	62	65	41	124	103	TRUE	FALSE	TRUE	0	TRUE	FALSE	0	0
FBgn0036471	94	90	77	77	171	167	TRUE	TRUE	TRUE	1	TRUE	TRUE	1	1
FBgn0036474	132	141	86	101	218	242	TRUE	TRUE	TRUE	1	TRUE	TRUE	1	1
FBgn0036476	148	150	114	98	262	248	TRUE	TRUE	TRUE	1	TRUE	TRUE	1	1
FBgn0036479	87	100	69	75	156	175	TRUE	TRUE	TRUE	1	TRUE	TRUE	1	1
FBgn0036481	95	103	72	86	167	189	TRUE	TRUE	TRUE	1	TRUE	TRUE	1	1
FBgn0036482	81	84	69	65	150	149	TRUE	TRUE	TRUE	1	TRUE	TRUE	1	1
FBgn0036483	78	84	71	66	149	150	TRUE	TRUE	TRUE	1	TRUE	TRUE	1	1
FBgn0036484	79	96	80	74	159	170	TRUE	TRUE	TRUE	1	TRUE	TRUE	1	1
FBgn0036485	228	208	169	164	397	372	TRUE	TRUE	TRUE	1	TRUE	TRUE	1	1
FBgn0036486	126	129	81	102	207	231	TRUE	TRUE	TRUE	1	TRUE	TRUE	1	1
FBgn0036487	42	57	30	33	72	90	TRUE	TRUE	TRUE	1	TRUE	TRUE	1	1
FBgn0036488	41	23	20	20	61	43	FALSE	TRUE	FALSE	0	FALSE	TRUE	0	0
FBgn0036489	91	98	66	77	157	175	TRUE	TRUE	TRUE	1	TRUE	TRUE	1	1
FBgn0036490	26	23	28	28	54	51	TRUE	TRUE	TRUE	1	TRUE	TRUE	1	1
FBgn0036491	102	112	64	100	166	212	TRUE	FALSE	FALSE	0	TRUE	FALSE	0	0
FBgn0036492	51	89	61	61	112	150	FALSE	TRUE	FALSE	0	FALSE	TRUE	0	0
FBgn0036493	396	417	360	341	756	758	TRUE	TRUE	TRUE	1	TRUE	TRUE	1	1
FBgn0036494	209	200	187	166	396	366	TRUE	TRUE	TRUE	1	TRUE	TRUE	1	1
FBgn0036495	39	30	23	42	62	72	TRUE	FALSE	TRUE	0	TRUE	FALSE	0	0
FBgn0036496	96	94	95	71	191	165	TRUE	FALSE	TRUE	0	TRUE	TRUE	1	0
FBgn0036497	37	42	24	32	61	74	TRUE	TRUE	TRUE	1	TRUE	TRUE	1	1
FBgn0036498	40	29	48	38	88	67	TRUE	TRUE	TRUE	1	TRUE	TRUE	1	1
FBgn0036499	35	37	26	27	61	64	TRUE	TRUE	TRUE	1	TRUE	TRUE	1	1
FBgn0036500	69	63	52	58	121	121	TRUE	TRUE	TRUE	1	TRUE	TRUE	1	1
FBgn0036501	75	93	65	78	140	171	TRUE	TRUE	FALSE	0	TRUE	TRUE	1	0
FBgn0036502	60	55	50	45	110	100	TRUE	TRUE	TRUE	1	TRUE	TRUE	1	1
FBgn0036503	45	39	44	32	89	71	TRUE	TRUE	TRUE	1	TRUE	TRUE	1	1
FBgn0036505	16	24	25	19	41	43	TRUE	TRUE	TRUE	1	TRUE	TRUE	1	1
FBgn0036509	63	68	58	59	121	127	TRUE	TRUE	TRUE	1	TRUE	TRUE	1	1
FBgn0036510	74	116	91	67	165	183	FALSE	FALSE	TRUE	0	FALSE	TRUE	0	0
FBgn0036512	33	36	48	40	81	76	TRUE	TRUE	TRUE	1	TRUE	TRUE	1	1
FBgn0036514	100	115	85	73	185	188	TRUE	TRUE	TRUE	1	TRUE	TRUE	1	1
FBgn0036516	69	86	82	52	151	138	TRUE	FALSE	TRUE	0	TRUE	FALSE	0	0
FBgn0036518	311	297	267	253	578	550	TRUE	TRUE	TRUE	1	TRUE	TRUE	1	1
FBgn0036519	36	49	37	28	73	77	TRUE	TRUE	TRUE	1	TRUE	TRUE	1	1
FBgn0036520	199	259	163	181	362	440	FALSE	TRUE	FALSE	0	TRUE	TRUE	1	0
FBgn0036522	244	266	195	195	439	461	TRUE	TRUE	TRUE	1	TRUE	TRUE	1	1
FBgn0036527	196	173	137	153	333	326	TRUE	TRUE	TRUE	1	TRUE	TRUE	1	1
FBgn0036528	95	79	72	81	167	160	TRUE	TRUE	TRUE	1	TRUE	TRUE	1	1
FBgn0036529	203	214	168	161	371	375	TRUE	TRUE	TRUE	1	TRUE	TRUE	1	1
FBgn0036531	41	32	38	40	79	72	TRUE	TRUE	TRUE	1	TRUE	TRUE	1	1
FBgn0036532	22	27	22	18	44	45	TRUE	TRUE	TRUE	1	TRUE	TRUE	1	1
FBgn0036534	271	279	230	239	501	518	TRUE	TRUE	TRUE	1	TRUE	TRUE	1	1
FBgn0036536	29	31	34	25	63	56	TRUE	TRUE	TRUE	1	TRUE	TRUE	1	1
FBgn0036537	86	78	74	57	160	135	TRUE	TRUE	TRUE	1	TRUE	TRUE	1	1
FBgn0036538	101	82	78	77	179	159	TRUE	TRUE	TRUE	1	TRUE	TRUE	1	1
FBgn0036544	378	338	318	336	696	674	TRUE	TRUE	TRUE	1	TRUE	TRUE	1	1
FBgn0036545	53	48	67	41	120	89	TRUE	FALSE	FALSE	0	TRUE	FALSE	0	0
FBgn0036547	138	119	89	91	227	210	TRUE	TRUE	TRUE	1	TRUE	TRUE	1	1
FBgn0036549	97	95	93	86	190	181	TRUE	TRUE	TRUE	1	TRUE	TRUE	1	1
FBgn0036550	69	58	66	64	135	122	TRUE	TRUE	TRUE	1	TRUE	TRUE	1	1
FBgn0036551	70	58	51	55	121	113	TRUE	TRUE	TRUE	1	TRUE	TRUE	1	1
FBgn0036552	72	73	51	45	123	118	TRUE	TRUE	TRUE	1	TRUE	TRUE	1	1
FBgn0036553	102	86	76	71	178	157	TRUE	TRUE	TRUE	1	TRUE	TRUE	1	1
FBgn0036556	247	264	170	192	417	456	TRUE	TRUE	TRUE	1	TRUE	TRUE	1	1
FBgn0036557	48	38	49	47	97	85	TRUE	TRUE	TRUE	1	TRUE	TRUE	1	1
FBgn0036560	157	163	111	124	268	287	TRUE	TRUE	TRUE	1	TRUE	TRUE	1	1
FBgn0036563	58	58	48	63	106	121	TRUE	TRUE	TRUE	1	TRUE	TRUE	1	1
FBgn0036565	173	188	152	134	325	322	TRUE	TRUE	TRUE	1	TRUE	TRUE	1	1
FBgn0036566	107	103	91	90	198	193	TRUE	TRUE	TRUE	1	TRUE	TRUE	1	1
FBgn0036568	92	74	63	57	155	131	TRUE	TRUE	TRUE	1	TRUE	TRUE	1	1
FBgn0036569	111	117	94	89	205	206	TRUE	TRUE	TRUE	1	TRUE	TRUE	1	1
FBgn0036570	92	98	75	61	167	159	TRUE	TRUE	TRUE	1	TRUE	TRUE	1	1
FBgn0036571	106	150	102	106	208	256	FALSE	TRUE	FALSE	0	TRUE	TRUE	1	0
FBgn0036574	93	102	81	80	174	182	TRUE	TRUE	TRUE	1	TRUE	TRUE	1	1
FBgn0036575	38	45	42	46	80	91	TRUE	TRUE	TRUE	1	TRUE	TRUE	1	1
FBgn0036576	134	142	125	121	259	263	TRUE	TRUE	TRUE	1	TRUE	TRUE	1	1
FBgn0036577	49	46	39	48	88	94	TRUE	TRUE	TRUE	1	TRUE	TRUE	1	1
FBgn0036579	150	146	118	109	268	255	TRUE	TRUE	TRUE	1	TRUE	TRUE	1	1
FBgn0036580	57	48	34	34	91	82	TRUE	TRUE	TRUE	1	TRUE	TRUE	1	1
FBgn0036581	81	82	59	68	140	150	TRUE	TRUE	TRUE	1	TRUE	TRUE	1	1
FBgn0036583	143	164	154	119	297	283	TRUE	FALSE	TRUE	0	TRUE	TRUE	1	0
FBgn0036584	128	92	97	95	225	187	FALSE	TRUE	FALSE	0	TRUE	TRUE	1	0
FBgn0036585	59	47	35	42	94	89	TRUE	TRUE	TRUE	1	TRUE	TRUE	1	1
FBgn0036586	45	58	39	47	84	105	TRUE	TRUE	TRUE	1	TRUE	TRUE	1	1
FBgn0036587	182	200	174	189	356	389	TRUE	TRUE	TRUE	1	TRUE	TRUE	1	1
FBgn0036588	47	50	50	47	97	97	TRUE	TRUE	TRUE	1	TRUE	TRUE	1	1
FBgn0036589	74	77	75	66	149	143	TRUE	TRUE	TRUE	1	TRUE	TRUE	1	1
FBgn0036590	73	78	61	68	134	146	TRUE	TRUE	TRUE	1	TRUE	TRUE	1	1
FBgn0036591	86	96	80	78	166	174	TRUE	TRUE	TRUE	1	TRUE	TRUE	1	1
FBgn0036592	67	67	55	43	122	110	TRUE	TRUE	TRUE	1	TRUE	TRUE	1	1
FBgn0036593	125	121	94	102	219	223	TRUE	TRUE	TRUE	1	TRUE	TRUE	1	1
FBgn0036594	54	60	46	50	100	110	TRUE	TRUE	TRUE	1	TRUE	TRUE	1	1
FBgn0036595	35	36	30	27	65	63	TRUE	TRUE	TRUE	1	TRUE	TRUE	1	1
FBgn0036596	101	110	62	105	163	215	TRUE	FALSE	FALSE	0	TRUE	FALSE	0	0
FBgn0036597	66	95	65	61	131	156	FALSE	TRUE	TRUE	0	TRUE	TRUE	1	0
FBgn0036598	52	55	48	53	100	108	TRUE	TRUE	TRUE	1	TRUE	TRUE	1	1
FBgn0036600	55	56	51	53	106	109	TRUE	TRUE	TRUE	1	TRUE	TRUE	1	1
FBgn0036601	58	64	62	55	120	119	TRUE	TRUE	TRUE	1	TRUE	TRUE	1	1
FBgn0036602	56	57	35	60	91	117	TRUE	FALSE	FALSE	0	TRUE	FALSE	0	0
FBgn0036603	73	95	80	48	153	143	TRUE	FALSE	TRUE	0	TRUE	FALSE	0	0
FBgn0036606	53	24	51	44	104	68	FALSE	TRUE	FALSE	0	FALSE	TRUE	0	0
FBgn0036607	70	68	74	49	144	117	TRUE	FALSE	TRUE	0	TRUE	FALSE	0	0
FBgn0036608	90	72	67	50	157	122	TRUE	TRUE	FALSE	0	TRUE	TRUE	1	0
FBgn0036610	48	66	35	45	83	111	TRUE	TRUE	FALSE	0	TRUE	TRUE	1	0
FBgn0036612	178	182	158	132	336	314	TRUE	TRUE	TRUE	1	TRUE	TRUE	1	1
FBgn0036614	57	53	36	59	93	112	TRUE	FALSE	TRUE	0	TRUE	FALSE	0	0
FBgn0036617	103	86	69	47	172	133	TRUE	FALSE	FALSE	0	TRUE	TRUE	1	0
FBgn0036618	88	83	74	94	162	177	TRUE	TRUE	TRUE	1	TRUE	TRUE	1	1
FBgn0036619	87	89	83	70	170	159	TRUE	TRUE	TRUE	1	TRUE	TRUE	1	1
FBgn0036620	94	89	99	89	193	178	TRUE	TRUE	TRUE	1	TRUE	TRUE	1	1
FBgn0036621	285	354	281	290	566	644	FALSE	TRUE	FALSE	0	TRUE	TRUE	1	0
FBgn0036622	111	102	113	109	224	211	TRUE	TRUE	TRUE	1	TRUE	TRUE	1	1
FBgn0036623	159	181	153	154	312	335	TRUE	TRUE	TRUE	1	TRUE	TRUE	1	1
FBgn0036624	237	257	195	185	432	442	TRUE	TRUE	TRUE	1	TRUE	TRUE	1	1
FBgn0036627	142	170	126	138	268	308	TRUE	TRUE	TRUE	1	TRUE	TRUE	1	1
FBgn0036629	127	142	96	108	223	250	TRUE	TRUE	TRUE	1	TRUE	TRUE	1	1
FBgn0036638	114	105	63	70	177	175	TRUE	TRUE	TRUE	1	TRUE	TRUE	1	1
FBgn0036639	93	110	77	85	170	195	TRUE	TRUE	TRUE	1	TRUE	TRUE	1	1
FBgn0036640	39	51	39	39	78	90	TRUE	TRUE	TRUE	1	TRUE	TRUE	1	1
FBgn0036646	81	37	63	34	144	71	FALSE	FALSE	FALSE	0	FALSE	FALSE	0	0
FBgn0036652	119	122	109	105	228	227	TRUE	TRUE	TRUE	1	TRUE	TRUE	1	1
FBgn0036654	77	73	54	67	131	140	TRUE	TRUE	TRUE	1	TRUE	TRUE	1	1
FBgn0036656	47	38	26	24	73	62	TRUE	TRUE	TRUE	1	TRUE	TRUE	1	1
FBgn0036659	200	193	146	125	346	318	TRUE	TRUE	TRUE	1	TRUE	TRUE	1	1
FBgn0036660	105	111	74	91	179	202	TRUE	TRUE	TRUE	1	TRUE	TRUE	1	1
FBgn0036661	121	100	113	125	234	225	TRUE	TRUE	TRUE	1	TRUE	TRUE	1	1
FBgn0036662	61	77	50	51	111	128	TRUE	TRUE	TRUE	1	TRUE	TRUE	1	1
FBgn0036663	445	479	415	400	860	879	TRUE	TRUE	TRUE	1	TRUE	TRUE	1	1
FBgn0036665	206	183	164	183	370	366	TRUE	TRUE	TRUE	1	TRUE	TRUE	1	1
FBgn0036666	145	152	131	86	276	238	TRUE	FALSE	TRUE	0	TRUE	FALSE	0	0
FBgn0036668	234	209	164	185	398	394	TRUE	TRUE	TRUE	1	TRUE	TRUE	1	1
FBgn0036670	21	24	14	25	35	49	TRUE	TRUE	TRUE	1	TRUE	FALSE	0	0
FBgn0036671	59	66	52	41	111	107	TRUE	TRUE	TRUE	1	TRUE	TRUE	1	1
FBgn0036677	127	123	103	107	230	230	TRUE	TRUE	TRUE	1	TRUE	TRUE	1	1
FBgn0036678	510	466	344	387	854	853	TRUE	TRUE	TRUE	1	TRUE	TRUE	1	1
FBgn0036679	69	67	52	60	121	127	TRUE	TRUE	TRUE	1	TRUE	TRUE	1	1
FBgn0036680	173	192	172	131	345	323	TRUE	FALSE	TRUE	0	TRUE	TRUE	1	0
FBgn0036681	95	87	73	97	168	184	TRUE	FALSE	TRUE	0	TRUE	TRUE	1	0
FBgn0036684	370	371	314	286	684	657	TRUE	TRUE	TRUE	1	TRUE	TRUE	1	1
FBgn0036685	79	66	65	70	144	136	TRUE	TRUE	TRUE	1	TRUE	TRUE	1	1
FBgn0036686	108	131	88	84	196	215	TRUE	TRUE	TRUE	1	TRUE	TRUE	1	1
FBgn0036687	97	118	92	93	189	211	TRUE	TRUE	TRUE	1	TRUE	TRUE	1	1
FBgn0036688	139	131	113	100	252	231	TRUE	TRUE	TRUE	1	TRUE	TRUE	1	1
FBgn0036689	105	107	73	104	178	211	TRUE	FALSE	TRUE	0	TRUE	TRUE	1	0
FBgn0036690	33	47	34	47	67	94	TRUE	TRUE	FALSE	0	TRUE	TRUE	1	0
FBgn0036691	51	45	39	27	90	72	TRUE	TRUE	TRUE	1	TRUE	TRUE	1	1
FBgn0036695	59	76	53	50	112	126	TRUE	TRUE	TRUE	1	TRUE	TRUE	1	1
FBgn0036696	43	60	60	45	103	105	TRUE	TRUE	TRUE	1	TRUE	TRUE	1	1
FBgn0036697	241	260	229	195	470	455	TRUE	TRUE	TRUE	1	TRUE	TRUE	1	1
FBgn0036698	115	126	82	89	197	215	TRUE	TRUE	TRUE	1	TRUE	TRUE	1	1
FBgn0036702	72	86	47	48	119	134	TRUE	TRUE	TRUE	1	TRUE	TRUE	1	1
FBgn0036703	52	53	54	50	106	103	TRUE	TRUE	TRUE	1	TRUE	TRUE	1	1
FBgn0036704	82	107	79	67	161	174	FALSE	TRUE	TRUE	0	TRUE	TRUE	1	0
FBgn0036705	33	46	22	35	55	81	TRUE	TRUE	FALSE	0	TRUE	FALSE	0	0
FBgn0036706	40	43	37	36	77	79	TRUE	TRUE	TRUE	1	TRUE	TRUE	1	1
FBgn0036707	68	77	60	69	128	146	TRUE	TRUE	TRUE	1	TRUE	TRUE	1	1
FBgn0036708	49	28	29	28	78	56	FALSE	TRUE	FALSE	0	FALSE	TRUE	0	0
FBgn0036709	64	64	60	52	124	116	TRUE	TRUE	TRUE	1	TRUE	TRUE	1	1
FBgn0036710	126	123	102	93	228	216	TRUE	TRUE	TRUE	1	TRUE	TRUE	1	1
FBgn0036711	75	70	64	73	139	143	TRUE	TRUE	TRUE	1	TRUE	TRUE	1	1
FBgn0036712	224	190	187	174	411	364	TRUE	TRUE	FALSE	0	TRUE	TRUE	1	0
FBgn0036713	150	131	114	113	264	244	TRUE	TRUE	TRUE	1	TRUE	TRUE	1	1
FBgn0036714	269	235	246	216	515	451	TRUE	TRUE	FALSE	0	TRUE	TRUE	1	0
FBgn0036715	462	502	422	429	884	931	TRUE	TRUE	TRUE	1	TRUE	TRUE	1	1
FBgn0036716	152	139	105	107	257	246	TRUE	TRUE	TRUE	1	TRUE	TRUE	1	1
FBgn0036717	97	90	65	69	162	159	TRUE	TRUE	TRUE	1	TRUE	TRUE	1	1
FBgn0036723	66	65	68	84	134	149	TRUE	TRUE	TRUE	1	TRUE	TRUE	1	1
FBgn0036725	540	554	479	445	1019	999	TRUE	TRUE	TRUE	1	TRUE	TRUE	1	1
FBgn0036726	23	26	17	20	40	46	TRUE	TRUE	TRUE	1	TRUE	TRUE	1	1
FBgn0036727	139	122	110	95	249	217	TRUE	TRUE	TRUE	1	TRUE	TRUE	1	1
FBgn0036728	111	112	101	78	212	190	TRUE	FALSE	TRUE	0	TRUE	TRUE	1	0
FBgn0036729	62	86	40	52	102	138	FALSE	TRUE	FALSE	0	TRUE	TRUE	1	0
FBgn0036730	75	93	48	47	123	140	TRUE	TRUE	TRUE	1	TRUE	TRUE	1	1
FBgn0036731	148	157	113	127	261	284	TRUE	TRUE	TRUE	1	TRUE	TRUE	1	1
FBgn0036732	262	281	232	234	494	515	TRUE	TRUE	TRUE	1	TRUE	TRUE	1	1
FBgn0036733	87	88	89	69	176	157	TRUE	TRUE	TRUE	1	TRUE	TRUE	1	1
FBgn0036734	109	114	86	87	195	201	TRUE	TRUE	TRUE	1	TRUE	TRUE	1	1
FBgn0036735	129	123	111	96	240	219	TRUE	TRUE	TRUE	1	TRUE	TRUE	1	1
FBgn0036738	46	56	43	45	89	101	TRUE	TRUE	TRUE	1	TRUE	TRUE	1	1
FBgn0036740	82	86	83	93	165	179	TRUE	TRUE	TRUE	1	TRUE	TRUE	1	1
FBgn0036741	191	219	188	152	379	371	TRUE	FALSE	TRUE	0	TRUE	TRUE	1	0
FBgn0036742	140	160	98	126	238	286	TRUE	FALSE	FALSE	0	TRUE	TRUE	1	0
FBgn0036745	57	45	49	40	106	85	TRUE	TRUE	TRUE	1	TRUE	TRUE	1	1
FBgn0036746	209	229	155	182	364	411	TRUE	TRUE	FALSE	0	TRUE	TRUE	1	0
FBgn0036747	313	326	295	281	608	607	TRUE	TRUE	TRUE	1	TRUE	TRUE	1	1
FBgn0036749	141	122	123	104	264	226	TRUE	TRUE	FALSE	0	TRUE	TRUE	1	0
FBgn0036750	172	173	166	134	338	307	TRUE	FALSE	TRUE	0	TRUE	TRUE	1	0
FBgn0036751	118	102	81	70	199	172	TRUE	TRUE	TRUE	1	TRUE	TRUE	1	1
FBgn0036752	199	198	190	169	389	367	TRUE	TRUE	TRUE	1	TRUE	TRUE	1	1
FBgn0036754	142	137	102	104	244	241	TRUE	TRUE	TRUE	1	TRUE	TRUE	1	1
FBgn0036756	144	147	108	125	252	272	TRUE	TRUE	TRUE	1	TRUE	TRUE	1	1
FBgn0036757	157	167	148	125	305	292	TRUE	TRUE	TRUE	1	TRUE	TRUE	1	1
FBgn0036759	36	49	23	23	59	72	TRUE	TRUE	TRUE	1	TRUE	TRUE	1	1
FBgn0036761	72	52	46	36	118	88	FALSE	TRUE	FALSE	0	TRUE	TRUE	1	0
FBgn0036762	114	96	100	95	214	191	TRUE	TRUE	TRUE	1	TRUE	TRUE	1	1
FBgn0036763	99	86	83	68	182	154	TRUE	TRUE	TRUE	1	TRUE	TRUE	1	1
FBgn0036764	78	89	62	52	140	141	TRUE	TRUE	TRUE	1	TRUE	TRUE	1	1
FBgn0036765	206	251	164	178	370	429	FALSE	TRUE	FALSE	0	TRUE	TRUE	1	0
FBgn0036766	66	60	50	45	116	105	TRUE	TRUE	TRUE	1	TRUE	TRUE	1	1
FBgn0036767	67	66	63	63	130	129	TRUE	TRUE	TRUE	1	TRUE	TRUE	1	1
FBgn0036768	222	207	156	164	378	371	TRUE	TRUE	TRUE	1	TRUE	TRUE	1	1
FBgn0036769	170	146	123	129	293	275	TRUE	TRUE	TRUE	1	TRUE	TRUE	1	1
FBgn0036770	299	277	254	231	553	508	TRUE	TRUE	TRUE	1	TRUE	TRUE	1	1
FBgn0036771	66	97	51	62	117	159	FALSE	TRUE	FALSE	0	TRUE	TRUE	1	0
FBgn0036772	150	159	138	151	288	310	TRUE	TRUE	TRUE	1	TRUE	TRUE	1	1
FBgn0036773	198	181	179	162	377	343	TRUE	TRUE	TRUE	1	TRUE	TRUE	1	1
FBgn0036774	72	63	75	73	147	136	TRUE	TRUE	TRUE	1	TRUE	TRUE	1	1
FBgn0036775	124	141	111	114	235	255	TRUE	TRUE	TRUE	1	TRUE	TRUE	1	1
FBgn0036777	93	93	76	73	169	166	TRUE	TRUE	TRUE	1	TRUE	TRUE	1	1
FBgn0036778	267	308	231	253	498	561	FALSE	TRUE	FALSE	0	TRUE	TRUE	1	0
FBgn0036780	132	157	129	122	261	279	TRUE	TRUE	TRUE	1	TRUE	TRUE	1	1
FBgn0036781	339	326	303	334	642	660	TRUE	TRUE	TRUE	1	TRUE	TRUE	1	1
FBgn0036782	180	173	134	189	314	362	TRUE	FALSE	FALSE	0	TRUE	TRUE	1	0
FBgn0036783	83	100	76	73	159	173	TRUE	TRUE	TRUE	1	TRUE	TRUE	1	1
FBgn0036784	113	125	113	101	226	226	TRUE	TRUE	TRUE	1	TRUE	TRUE	1	1
FBgn0036785	192	183	199	144	391	327	TRUE	FALSE	FALSE	0	TRUE	TRUE	1	0
FBgn0036786	89	67	73	77	162	144	FALSE	TRUE	TRUE	0	TRUE	TRUE	1	0
FBgn0036787	38	50	28	31	66	81	TRUE	TRUE	TRUE	1	TRUE	TRUE	1	1
FBgn0036789	341	339	327	326	668	665	TRUE	TRUE	TRUE	1	TRUE	TRUE	1	1
FBgn0036790	274	256	220	204	494	460	TRUE	TRUE	TRUE	1	TRUE	TRUE	1	1
FBgn0036791	18	24	22	15	40	39	TRUE	TRUE	TRUE	1	TRUE	TRUE	1	1
FBgn0036795	63	75	52	47	115	122	TRUE	TRUE	TRUE	1	TRUE	TRUE	1	1
FBgn0036796	202	176	184	170	386	346	TRUE	TRUE	TRUE	1	TRUE	TRUE	1	1
FBgn0036801	317	330	293	294	610	624	TRUE	TRUE	TRUE	1	TRUE	TRUE	1	1
FBgn0036804	58	38	47	38	105	76	FALSE	TRUE	FALSE	0	FALSE	TRUE	0	0
FBgn0036805	22	34	20	11	42	45	TRUE	TRUE	TRUE	1	FALSE	FALSE	0	0
FBgn0036806	117	91	72	95	189	186	FALSE	FALSE	TRUE	0	TRUE	TRUE	1	0
FBgn0036807	88	89	68	86	156	175	TRUE	TRUE	TRUE	1	TRUE	TRUE	1	1
FBgn0036808	135	164	136	108	271	272	TRUE	FALSE	TRUE	0	TRUE	TRUE	1	0
FBgn0036809	51	79	59	51	110	130	FALSE	TRUE	TRUE	0	FALSE	TRUE	0	0
FBgn0036810	31	52	35	32	66	84	FALSE	TRUE	TRUE	0	FALSE	TRUE	0	0
FBgn0036811	52	34	37	31	89	65	FALSE	TRUE	FALSE	0	FALSE	TRUE	0	0
FBgn0036812	159	141	137	143	296	284	TRUE	TRUE	TRUE	1	TRUE	TRUE	1	1
FBgn0036813	54	51	50	46	104	97	TRUE	TRUE	TRUE	1	TRUE	TRUE	1	1
FBgn0036814	140	149	121	133	261	282	TRUE	TRUE	TRUE	1	TRUE	TRUE	1	1
FBgn0036816	77	71	63	56	140	127	TRUE	TRUE	TRUE	1	TRUE	TRUE	1	1
FBgn0036818	86	107	88	85	174	192	TRUE	TRUE	TRUE	1	TRUE	TRUE	1	1
FBgn0036819	64	93	51	51	115	144	FALSE	TRUE	FALSE	0	TRUE	TRUE	1	0
FBgn0036821	152	158	124	111	276	269	TRUE	TRUE	TRUE	1	TRUE	TRUE	1	1
FBgn0036822	37	53	41	46	78	99	TRUE	TRUE	TRUE	1	TRUE	TRUE	1	1
FBgn0036824	69	63	60	71	129	134	TRUE	TRUE	TRUE	1	TRUE	TRUE	1	1
FBgn0036825	38	37	56	60	94	97	TRUE	TRUE	TRUE	1	TRUE	TRUE	1	1
FBgn0036826	78	64	63	64	141	128	TRUE	TRUE	TRUE	1	TRUE	TRUE	1	1
FBgn0036827	48	60	40	40	88	100	TRUE	TRUE	TRUE	1	TRUE	TRUE	1	1
FBgn0036828	125	122	132	124	257	246	TRUE	TRUE	TRUE	1	TRUE	TRUE	1	1
FBgn0036830	46	58	53	63	99	121	TRUE	TRUE	TRUE	1	TRUE	TRUE	1	1
FBgn0036831	49	60	33	49	82	109	TRUE	FALSE	FALSE	0	TRUE	TRUE	1	0
FBgn0036832	42	35	39	46	81	81	TRUE	TRUE	TRUE	1	TRUE	TRUE	1	1
FBgn0036833	71	67	56	66	127	133	TRUE	TRUE	TRUE	1	TRUE	TRUE	1	1
FBgn0036834	146	151	138	136	284	287	TRUE	TRUE	TRUE	1	TRUE	TRUE	1	1
FBgn0036835	42	46	28	36	70	82	TRUE	TRUE	TRUE	1	TRUE	TRUE	1	1
FBgn0036836	229	220	190	195	419	415	TRUE	TRUE	TRUE	1	TRUE	TRUE	1	1
FBgn0036837	202	198	186	167	388	365	TRUE	TRUE	TRUE	1	TRUE	TRUE	1	1
FBgn0036838	133	172	133	136	266	308	FALSE	TRUE	FALSE	0	TRUE	TRUE	1	0
FBgn0036839	189	176	148	175	337	351	TRUE	TRUE	TRUE	1	TRUE	TRUE	1	1
FBgn0036842	212	220	180	174	392	394	TRUE	TRUE	TRUE	1	TRUE	TRUE	1	1
FBgn0036843	68	67	36	49	104	116	TRUE	TRUE	TRUE	1	TRUE	TRUE	1	1
FBgn0036844	281	304	220	207	501	511	TRUE	TRUE	TRUE	1	TRUE	TRUE	1	1
FBgn0036846	82	104	61	83	143	187	TRUE	FALSE	FALSE	0	TRUE	TRUE	1	0
FBgn0036847	89	82	64	58	153	140	TRUE	TRUE	TRUE	1	TRUE	TRUE	1	1
FBgn0036848	121	128	93	94	214	222	TRUE	TRUE	TRUE	1	TRUE	TRUE	1	1
FBgn0036849	76	65	68	74	144	139	TRUE	TRUE	TRUE	1	TRUE	TRUE	1	1
FBgn0036850	99	95	84	70	183	165	TRUE	TRUE	TRUE	1	TRUE	TRUE	1	1
FBgn0036851	236	252	171	179	407	431	TRUE	TRUE	TRUE	1	TRUE	TRUE	1	1
FBgn0036853	97	107	84	76	181	183	TRUE	TRUE	TRUE	1	TRUE	TRUE	1	1
FBgn0036857	95	109	64	72	159	181	TRUE	TRUE	TRUE	1	TRUE	TRUE	1	1
FBgn0036858	52	68	48	75	100	143	TRUE	FALSE	FALSE	0	TRUE	FALSE	0	0
FBgn0036859	192	230	188	168	380	398	FALSE	TRUE	TRUE	0	TRUE	TRUE	1	0
FBgn0036860	143	150	132	130	275	280	TRUE	TRUE	TRUE	1	TRUE	TRUE	1	1
FBgn0036861	71	65	55	60	126	125	TRUE	TRUE	TRUE	1	TRUE	TRUE	1	1
FBgn0036862	262	263	221	235	483	498	TRUE	TRUE	TRUE	1	TRUE	TRUE	1	1
FBgn0036868	126	117	91	95	217	212	TRUE	TRUE	TRUE	1	TRUE	TRUE	1	1
FBgn0036870	37	28	27	37	64	65	TRUE	TRUE	TRUE	1	TRUE	TRUE	1	1
FBgn0036871	54	56	28	24	82	80	TRUE	TRUE	TRUE	1	TRUE	TRUE	1	1
FBgn0036872	29	34	33	35	62	69	TRUE	TRUE	TRUE	1	TRUE	TRUE	1	1
FBgn0036874	107	90	71	72	178	162	TRUE	TRUE	TRUE	1	TRUE	TRUE	1	1
FBgn0036875	98	136	105	104	203	240	FALSE	TRUE	FALSE	0	TRUE	TRUE	1	0
FBgn0036876	74	83	59	55	133	138	TRUE	TRUE	TRUE	1	TRUE	TRUE	1	1
FBgn0036877	150	154	125	118	275	272	TRUE	TRUE	TRUE	1	TRUE	TRUE	1	1
FBgn0036878	59	56	46	43	105	99	TRUE	TRUE	TRUE	1	TRUE	TRUE	1	1
FBgn0036879	39	39	25	24	64	63	TRUE	TRUE	TRUE	1	TRUE	TRUE	1	1
FBgn0036880	120	124	110	108	230	232	TRUE	TRUE	TRUE	1	TRUE	TRUE	1	1
FBgn0036881	176	157	120	138	296	295	TRUE	TRUE	TRUE	1	TRUE	TRUE	1	1
FBgn0036888	35	28	23	26	58	54	TRUE	TRUE	TRUE	1	TRUE	TRUE	1	1
FBgn0036889	32	33	32	25	64	58	TRUE	TRUE	TRUE	1	TRUE	TRUE	1	1
FBgn0036890	77	82	62	58	139	140	TRUE	TRUE	TRUE	1	TRUE	TRUE	1	1
FBgn0036891	72	55	51	48	123	103	TRUE	TRUE	TRUE	1	TRUE	TRUE	1	1
FBgn0036892	97	105	87	91	184	196	TRUE	TRUE	TRUE	1	TRUE	TRUE	1	1
FBgn0036893	23	28	26	23	49	51	TRUE	TRUE	TRUE	1	TRUE	TRUE	1	1
FBgn0036895	98	103	86	86	184	189	TRUE	TRUE	TRUE	1	TRUE	TRUE	1	1
FBgn0036896	164	167	126	130	290	297	TRUE	TRUE	TRUE	1	TRUE	TRUE	1	1
FBgn0036897	197	191	176	160	373	351	TRUE	TRUE	TRUE	1	TRUE	TRUE	1	1
FBgn0036899	238	207	216	175	454	382	TRUE	FALSE	FALSE	0	TRUE	TRUE	1	0
FBgn0036900	107	119	82	71	189	190	TRUE	TRUE	TRUE	1	TRUE	TRUE	1	1
FBgn0036906	86	88	66	72	152	160	TRUE	TRUE	TRUE	1	TRUE	TRUE	1	1
FBgn0036908	22	20	22	24	44	44	TRUE	TRUE	TRUE	1	TRUE	TRUE	1	1
FBgn0036910	13	19	16	16	29	35	TRUE	TRUE	TRUE	1	TRUE	TRUE	1	1
FBgn0036911	72	64	68	61	140	125	TRUE	TRUE	TRUE	1	TRUE	TRUE	1	1
FBgn0036913	135	135	117	129	252	264	TRUE	TRUE	TRUE	1	TRUE	TRUE	1	1
FBgn0036918	82	100	80	80	162	180	TRUE	TRUE	TRUE	1	TRUE	TRUE	1	1
FBgn0036919	85	88	77	77	162	165	TRUE	TRUE	TRUE	1	TRUE	TRUE	1	1
FBgn0036921	33	36	31	26	64	62	TRUE	TRUE	TRUE	1	TRUE	TRUE	1	1
FBgn0036922	41	42	39	36	80	78	TRUE	TRUE	TRUE	1	TRUE	TRUE	1	1
FBgn0036923	34	26	30	27	64	53	TRUE	TRUE	TRUE	1	TRUE	TRUE	1	1
FBgn0036924	26	32	25	21	51	53	TRUE	TRUE	TRUE	1	TRUE	TRUE	1	1
FBgn0036925	45	54	36	35	81	89	TRUE	TRUE	TRUE	1	TRUE	TRUE	1	1
FBgn0036926	79	83	70	71	149	154	TRUE	TRUE	TRUE	1	TRUE	TRUE	1	1
FBgn0036927	46	36	40	30	86	66	TRUE	TRUE	TRUE	1	TRUE	TRUE	1	1
FBgn0036928	47	55	47	46	94	101	TRUE	TRUE	TRUE	1	TRUE	TRUE	1	1
FBgn0036929	83	81	67	82	150	163	TRUE	TRUE	TRUE	1	TRUE	TRUE	1	1
FBgn0036931	69	86	61	64	130	150	TRUE	TRUE	TRUE	1	TRUE	TRUE	1	1
FBgn0036932	29	29	25	20	54	49	TRUE	TRUE	TRUE	1	TRUE	TRUE	1	1
FBgn0036934	217	187	168	180	385	367	TRUE	TRUE	TRUE	1	TRUE	TRUE	1	1
FBgn0036935	164	133	95	128	259	261	FALSE	FALSE	TRUE	0	TRUE	TRUE	1	0
FBgn0036936	117	124	58	60	175	184	TRUE	TRUE	TRUE	1	TRUE	TRUE	1	1
FBgn0036937	60	48	45	39	105	87	TRUE	TRUE	TRUE	1	TRUE	TRUE	1	1
FBgn0036938	21	17	21	24	42	41	TRUE	TRUE	TRUE	1	TRUE	TRUE	1	1
FBgn0036939	107	104	72	74	179	178	TRUE	TRUE	TRUE	1	TRUE	TRUE	1	1
FBgn0036940	27	25	23	15	50	40	TRUE	TRUE	TRUE	1	TRUE	FALSE	0	0
FBgn0036942	52	53	37	40	89	93	TRUE	TRUE	TRUE	1	TRUE	TRUE	1	1
FBgn0036945	23	21	21	23	44	44	TRUE	TRUE	TRUE	1	TRUE	TRUE	1	1
FBgn0036948	84	70	55	52	139	122	TRUE	TRUE	TRUE	1	TRUE	TRUE	1	1
FBgn0036949	45	40	34	24	79	64	TRUE	TRUE	TRUE	1	TRUE	TRUE	1	1
FBgn0036951	53	63	44	42	97	105	TRUE	TRUE	TRUE	1	TRUE	TRUE	1	1
FBgn0036952	107	117	119	108	226	225	TRUE	TRUE	TRUE	1	TRUE	TRUE	1	1
FBgn0036953	53	52	43	45	96	97	TRUE	TRUE	TRUE	1	TRUE	TRUE	1	1
FBgn0036956	19	38	13	24	32	62	FALSE	FALSE	FALSE	0	FALSE	FALSE	0	0
FBgn0036958	91	114	93	95	184	209	TRUE	TRUE	TRUE	1	TRUE	TRUE	1	1
FBgn0036959	28	20	30	37	58	57	TRUE	TRUE	TRUE	1	TRUE	TRUE	1	1
FBgn0036962	51	52	39	35	90	87	TRUE	TRUE	TRUE	1	TRUE	TRUE	1	1
FBgn0036964	49	65	50	35	99	100	TRUE	TRUE	TRUE	1	TRUE	TRUE	1	1
FBgn0036967	79	93	69	55	148	148	TRUE	TRUE	TRUE	1	TRUE	TRUE	1	1
FBgn0036969	25	37	22	25	47	62	TRUE	TRUE	TRUE	1	TRUE	TRUE	1	1
FBgn0036970	47	48	32	38	79	86	TRUE	TRUE	TRUE	1	TRUE	TRUE	1	1
FBgn0036972	24	29	29	17	53	46	TRUE	TRUE	TRUE	1	TRUE	FALSE	0	0
FBgn0036974	45	34	21	15	66	49	TRUE	TRUE	TRUE	1	TRUE	TRUE	1	1
FBgn0036975	31	30	27	28	58	58	TRUE	TRUE	TRUE	1	TRUE	TRUE	1	1
FBgn0036978	141	153	128	105	269	258	TRUE	TRUE	TRUE	1	TRUE	TRUE	1	1
FBgn0036979	41	30	32	22	73	52	TRUE	TRUE	FALSE	0	TRUE	TRUE	1	0
FBgn0036980	82	78	71	72	153	150	TRUE	TRUE	TRUE	1	TRUE	TRUE	1	1
FBgn0036986	68	68	54	69	122	137	TRUE	TRUE	TRUE	1	TRUE	TRUE	1	1
FBgn0036987	23	19	23	14	46	33	TRUE	TRUE	TRUE	1	TRUE	FALSE	0	0
FBgn0036988	63	52	49	50	112	102	TRUE	TRUE	TRUE	1	TRUE	TRUE	1	1
FBgn0036990	28	18	15	24	43	42	TRUE	TRUE	TRUE	1	FALSE	FALSE	0	0
FBgn0036991	44	33	39	40	83	73	TRUE	TRUE	TRUE	1	TRUE	TRUE	1	1
FBgn0036993	23	25	24	16	47	41	TRUE	TRUE	TRUE	1	TRUE	TRUE	1	1
FBgn0036995	64	66	59	68	123	134	TRUE	TRUE	TRUE	1	TRUE	TRUE	1	1
FBgn0036996	20	21	20	19	40	40	TRUE	TRUE	TRUE	1	TRUE	TRUE	1	1
FBgn0036997	31	41	22	36	53	77	TRUE	FALSE	FALSE	0	TRUE	FALSE	0	0
FBgn0036999	41	50	38	41	79	91	TRUE	TRUE	TRUE	1	TRUE	TRUE	1	1
FBgn0037000	110	87	70	86	180	173	TRUE	TRUE	TRUE	1	TRUE	TRUE	1	1
FBgn0037001	41	33	52	55	93	88	TRUE	TRUE	TRUE	1	TRUE	TRUE	1	1
FBgn0037003	88	75	75	66	163	141	TRUE	TRUE	TRUE	1	TRUE	TRUE	1	1
FBgn0037004	32	16	27	18	59	34	FALSE	TRUE	FALSE	0	FALSE	TRUE	0	0
FBgn0037005	32	25	25	17	57	42	TRUE	TRUE	TRUE	1	TRUE	TRUE	1	1
FBgn0037007	68	62	47	69	115	131	TRUE	FALSE	TRUE	0	TRUE	TRUE	1	0
FBgn0037008	28	36	22	28	50	64	TRUE	TRUE	TRUE	1	TRUE	TRUE	1	1
FBgn0037009	46	44	43	44	89	88	TRUE	TRUE	TRUE	1	TRUE	TRUE	1	1
FBgn0037010	25	27	44	30	69	57	TRUE	TRUE	TRUE	1	TRUE	TRUE	1	1
FBgn0037014	30	63	38	43	68	106	FALSE	TRUE	FALSE	0	FALSE	TRUE	0	0
FBgn0037015	109	104	94	102	203	206	TRUE	TRUE	TRUE	1	TRUE	TRUE	1	1
FBgn0037016	135	133	128	119	263	252	TRUE	TRUE	TRUE	1	TRUE	TRUE	1	1
FBgn0037017	61	48	55	48	116	96	TRUE	TRUE	TRUE	1	TRUE	TRUE	1	1
FBgn0037019	55	54	42	52	97	106	TRUE	TRUE	TRUE	1	TRUE	TRUE	1	1
FBgn0037020	63	56	50	50	113	106	TRUE	TRUE	TRUE	1	TRUE	TRUE	1	1
FBgn0037021	73	64	78	58	151	122	TRUE	TRUE	FALSE	0	TRUE	TRUE	1	0
FBgn0037022	48	44	33	34	81	78	TRUE	TRUE	TRUE	1	TRUE	TRUE	1	1
FBgn0037023	66	49	76	53	142	102	TRUE	FALSE	FALSE	0	TRUE	TRUE	1	0
FBgn0037024	88	77	53	66	141	143	TRUE	TRUE	TRUE	1	TRUE	TRUE	1	1
FBgn0037025	154	148	127	146	281	294	TRUE	TRUE	TRUE	1	TRUE	TRUE	1	1
FBgn0037026	40	57	30	39	70	96	TRUE	TRUE	FALSE	0	TRUE	TRUE	1	0
FBgn0037027	75	110	88	66	163	176	FALSE	FALSE	TRUE	0	TRUE	TRUE	1	0
FBgn0037028	33	25	25	32	58	57	TRUE	TRUE	TRUE	1	TRUE	TRUE	1	1
FBgn0037031	12	20	19	18	31	38	TRUE	TRUE	TRUE	1	FALSE	TRUE	0	0
FBgn0037036	49	57	28	49	77	106	TRUE	FALSE	FALSE	0	TRUE	FALSE	0	0
FBgn0037037	115	124	82	89	197	213	TRUE	TRUE	TRUE	1	TRUE	TRUE	1	1
FBgn0037039	39	49	44	45	83	94	TRUE	TRUE	TRUE	1	TRUE	TRUE	1	1
FBgn0037040	135	139	110	128	245	267	TRUE	TRUE	TRUE	1	TRUE	TRUE	1	1
FBgn0037042	42	34	34	39	76	73	TRUE	TRUE	TRUE	1	TRUE	TRUE	1	1
FBgn0037044	36	35	22	29	58	64	TRUE	TRUE	TRUE	1	TRUE	TRUE	1	1
FBgn0037045	28	31	23	14	51	45	TRUE	TRUE	TRUE	1	TRUE	FALSE	0	0
FBgn0037060	49	49	42	45	91	94	TRUE	TRUE	TRUE	1	TRUE	TRUE	1	1
FBgn0037063	46	62	35	36	81	98	TRUE	TRUE	TRUE	1	TRUE	TRUE	1	1
FBgn0037064	51	49	30	33	81	82	TRUE	TRUE	TRUE	1	TRUE	TRUE	1	1
FBgn0037065	113	125	84	96	197	221	TRUE	TRUE	TRUE	1	TRUE	TRUE	1	1
FBgn0037068	63	62	54	68	117	130	TRUE	TRUE	TRUE	1	TRUE	TRUE	1	1
FBgn0037073	45	67	31	43	76	110	FALSE	TRUE	FALSE	0	TRUE	TRUE	1	0
FBgn0037074	104	89	89	67	193	156	TRUE	FALSE	FALSE	0	TRUE	TRUE	1	0
FBgn0037076	24	41	24	29	48	70	FALSE	TRUE	FALSE	0	FALSE	TRUE	0	0
FBgn0037078	71	102	76	87	147	189	FALSE	TRUE	FALSE	0	TRUE	TRUE	1	0
FBgn0037082	98	111	74	75	172	186	TRUE	TRUE	TRUE	1	TRUE	TRUE	1	1
FBgn0037084	183	180	136	169	319	349	TRUE	FALSE	TRUE	0	TRUE	TRUE	1	0
FBgn0037085	30	28	30	24	60	52	TRUE	TRUE	TRUE	1	TRUE	TRUE	1	1
FBgn0037086	22	26	20	17	42	43	TRUE	TRUE	TRUE	1	TRUE	TRUE	1	1
FBgn0037087	33	34	32	22	65	56	TRUE	TRUE	TRUE	1	TRUE	TRUE	1	1
FBgn0037090	56	56	41	37	97	93	TRUE	TRUE	TRUE	1	TRUE	TRUE	1	1
FBgn0037092	75	58	48	34	123	92	TRUE	TRUE	FALSE	0	TRUE	TRUE	1	0
FBgn0037093	63	49	36	43	99	92	TRUE	TRUE	TRUE	1	TRUE	TRUE	1	1
FBgn0037094	53	61	51	44	104	105	TRUE	TRUE	TRUE	1	TRUE	TRUE	1	1
FBgn0037098	161	190	161	138	322	328	TRUE	TRUE	TRUE	1	TRUE	TRUE	1	1
FBgn0037099	91	99	80	80	171	179	TRUE	TRUE	TRUE	1	TRUE	TRUE	1	1
FBgn0037100	82	77	47	63	129	140	TRUE	TRUE	TRUE	1	TRUE	TRUE	1	1
FBgn0037101	34	27	24	23	58	50	TRUE	TRUE	TRUE	1	TRUE	TRUE	1	1
FBgn0037102	35	32	30	34	65	66	TRUE	TRUE	TRUE	1	TRUE	TRUE	1	1
FBgn0037105	207	194	157	166	364	360	TRUE	TRUE	TRUE	1	TRUE	TRUE	1	1
FBgn0037106	90	78	85	74	175	152	TRUE	TRUE	TRUE	1	TRUE	TRUE	1	1
FBgn0037107	207	134	135	135	342	269	FALSE	TRUE	FALSE	0	FALSE	TRUE	0	0
FBgn0037108	96	92	77	92	173	184	TRUE	TRUE	TRUE	1	TRUE	TRUE	1	1
FBgn0037109	124	147	120	112	244	259	TRUE	TRUE	TRUE	1	TRUE	TRUE	1	1
FBgn0037110	16	20	15	16	31	36	TRUE	TRUE	TRUE	1	TRUE	TRUE	1	1
FBgn0037116	68	81	68	68	136	149	TRUE	TRUE	TRUE	1	TRUE	TRUE	1	1
FBgn0037117	109	124	112	92	221	216	TRUE	TRUE	TRUE	1	TRUE	TRUE	1	1
FBgn0037120	29	35	33	38	62	73	TRUE	TRUE	TRUE	1	TRUE	TRUE	1	1
FBgn0037121	18	22	12	19	30	41	TRUE	TRUE	TRUE	1	TRUE	FALSE	0	0
FBgn0037123	59	65	54	43	113	108	TRUE	TRUE	TRUE	1	TRUE	TRUE	1	1
FBgn0037124	39	24	24	18	63	42	FALSE	TRUE	FALSE	0	FALSE	TRUE	0	0
FBgn0037125	45	45	34	36	79	81	TRUE	TRUE	TRUE	1	TRUE	TRUE	1	1
FBgn0037126	33	32	27	13	60	45	TRUE	FALSE	TRUE	0	TRUE	FALSE	0	0
FBgn0037127	47	41	33	33	80	74	TRUE	TRUE	TRUE	1	TRUE	TRUE	1	1
FBgn0037128	80	74	52	57	132	131	TRUE	TRUE	TRUE	1	TRUE	TRUE	1	1
FBgn0037129	40	46	34	27	74	73	TRUE	TRUE	TRUE	1	TRUE	TRUE	1	1
FBgn0037130	216	209	180	154	396	363	TRUE	TRUE	TRUE	1	TRUE	TRUE	1	1
FBgn0037131	23	37	25	24	48	61	FALSE	TRUE	TRUE	0	FALSE	TRUE	0	0
FBgn0037135	66	51	59	46	125	97	TRUE	TRUE	FALSE	0	TRUE	TRUE	1	0
FBgn0037137	69	57	64	57	133	114	TRUE	TRUE	TRUE	1	TRUE	TRUE	1	1
FBgn0037138	83	75	60	68	143	143	TRUE	TRUE	TRUE	1	TRUE	TRUE	1	1
FBgn0037139	18	21	24	16	42	37	TRUE	TRUE	TRUE	1	TRUE	TRUE	1	1
FBgn0037140	56	64	59	56	115	120	TRUE	TRUE	TRUE	1	TRUE	TRUE	1	1
FBgn0037141	72	47	52	42	124	89	FALSE	TRUE	FALSE	0	FALSE	TRUE	0	0
FBgn0037142	63	47	42	30	105	77	TRUE	TRUE	FALSE	0	TRUE	TRUE	1	0
FBgn0037144	73	73	55	57	128	130	TRUE	TRUE	TRUE	1	TRUE	TRUE	1	1
FBgn0037146	235	221	189	161	424	382	TRUE	TRUE	TRUE	1	TRUE	TRUE	1	1
FBgn0037147	33	31	20	28	53	59	TRUE	TRUE	TRUE	1	TRUE	TRUE	1	1
FBgn0037149	31	41	31	22	62	63	TRUE	TRUE	TRUE	1	TRUE	TRUE	1	1
FBgn0037150	56	60	40	53	96	113	TRUE	TRUE	TRUE	1	TRUE	TRUE	1	1
FBgn0037153	364	359	341	359	705	718	TRUE	TRUE	TRUE	1	TRUE	TRUE	1	1
FBgn0037162	39	55	48	44	87	99	TRUE	TRUE	TRUE	1	TRUE	TRUE	1	1
FBgn0037163	77	71	47	64	124	135	TRUE	TRUE	TRUE	1	TRUE	TRUE	1	1
FBgn0037164	103	102	98	92	201	194	TRUE	TRUE	TRUE	1	TRUE	TRUE	1	1
FBgn0037165	27	15	17	20	44	35	FALSE	TRUE	TRUE	0	FALSE	TRUE	0	0
FBgn0037166	91	109	72	72	163	181	TRUE	TRUE	TRUE	1	TRUE	TRUE	1	1
FBgn0037167	52	44	30	37	82	81	TRUE	TRUE	TRUE	1	TRUE	TRUE	1	1
FBgn0037169	21	20	25	21	46	41	TRUE	TRUE	TRUE	1	TRUE	TRUE	1	1
FBgn0037170	36	35	29	20	65	55	TRUE	TRUE	TRUE	1	TRUE	TRUE	1	1
FBgn0037171	221	228	188	191	409	419	TRUE	TRUE	TRUE	1	TRUE	TRUE	1	1
FBgn0037172	47	54	34	39	81	93	TRUE	TRUE	TRUE	1	TRUE	TRUE	1	1
FBgn0037174	44	32	34	38	78	70	TRUE	TRUE	TRUE	1	TRUE	TRUE	1	1
FBgn0037179	52	54	39	28	91	82	TRUE	TRUE	TRUE	1	TRUE	TRUE	1	1
FBgn0037181	42	25	22	23	64	48	FALSE	TRUE	TRUE	0	FALSE	TRUE	0	0
FBgn0037182	66	55	62	54	128	109	TRUE	TRUE	TRUE	1	TRUE	TRUE	1	1
FBgn0037186	25	23	18	24	43	47	TRUE	TRUE	TRUE	1	TRUE	TRUE	1	1
FBgn0037188	99	82	72	65	171	147	TRUE	TRUE	TRUE	1	TRUE	TRUE	1	1
FBgn0037202	34	29	20	34	54	63	TRUE	FALSE	TRUE	0	TRUE	FALSE	0	0
FBgn0037203	64	68	67	46	131	114	TRUE	FALSE	TRUE	0	TRUE	TRUE	1	0
FBgn0037204	73	61	50	54	123	115	TRUE	TRUE	TRUE	1	TRUE	TRUE	1	1
FBgn0037205	64	57	40	43	104	100	TRUE	TRUE	TRUE	1	TRUE	TRUE	1	1
FBgn0037206	161	140	144	123	305	263	TRUE	TRUE	FALSE	0	TRUE	TRUE	1	0
FBgn0037213	72	58	76	92	148	150	TRUE	TRUE	TRUE	1	TRUE	TRUE	1	1
FBgn0037218	92	86	76	77	168	163	TRUE	TRUE	TRUE	1	TRUE	TRUE	1	1
FBgn0037220	60	69	49	42	109	111	TRUE	TRUE	TRUE	1	TRUE	TRUE	1	1
FBgn0037222	38	53	42	43	80	96	TRUE	TRUE	TRUE	1	TRUE	TRUE	1	1
FBgn0037223	52	50	48	42	100	92	TRUE	TRUE	TRUE	1	TRUE	TRUE	1	1
FBgn0037224	24	29	32	25	56	54	TRUE	TRUE	TRUE	1	TRUE	TRUE	1	1
FBgn0037225	48	43	46	34	94	77	TRUE	TRUE	TRUE	1	TRUE	TRUE	1	1
FBgn0037231	16	18	16	21	32	39	TRUE	TRUE	TRUE	1	TRUE	TRUE	1	1
FBgn0037234	94	94	84	67	178	161	TRUE	TRUE	TRUE	1	TRUE	TRUE	1	1
FBgn0037236	26	27	12	24	38	51	TRUE	FALSE	TRUE	0	TRUE	FALSE	0	0
FBgn0037238	78	69	46	46	124	115	TRUE	TRUE	TRUE	1	TRUE	TRUE	1	1
FBgn0037240	56	49	35	50	91	99	TRUE	TRUE	TRUE	1	TRUE	TRUE	1	1
FBgn0037248	163	154	139	122	302	276	TRUE	TRUE	TRUE	1	TRUE	TRUE	1	1
FBgn0037249	59	54	41	49	100	103	TRUE	TRUE	TRUE	1	TRUE	TRUE	1	1
FBgn0037254	92	84	91	90	183	174	TRUE	TRUE	TRUE	1	TRUE	TRUE	1	1
FBgn0037255	29	27	22	17	51	44	TRUE	TRUE	TRUE	1	TRUE	TRUE	1	1
FBgn0037261	20	22	20	25	40	47	TRUE	TRUE	TRUE	1	TRUE	TRUE	1	1
FBgn0037263	27	25	20	17	47	42	TRUE	TRUE	TRUE	1	TRUE	TRUE	1	1
FBgn0037265	59	68	55	50	114	118	TRUE	TRUE	TRUE	1	TRUE	TRUE	1	1
FBgn0037270	31	39	26	25	57	64	TRUE	TRUE	TRUE	1	TRUE	TRUE	1	1
FBgn0037275	98	97	77	70	175	167	TRUE	TRUE	TRUE	1	TRUE	TRUE	1	1
FBgn0037276	32	50	43	41	75	91	FALSE	TRUE	TRUE	0	FALSE	TRUE	0	0
FBgn0037279	92	77	73	71	165	148	TRUE	TRUE	TRUE	1	TRUE	TRUE	1	1
FBgn0037280	49	53	34	58	83	111	TRUE	FALSE	FALSE	0	TRUE	FALSE	0	0
FBgn0037282	133	115	85	106	218	221	TRUE	TRUE	TRUE	1	TRUE	TRUE	1	1
FBgn0037284	32	15	15	22	47	37	FALSE	TRUE	TRUE	0	FALSE	TRUE	0	0
FBgn0037288	30	23	17	27	47	50	TRUE	TRUE	TRUE	1	TRUE	FALSE	0	0
FBgn0037290	79	99	86	81	165	180	TRUE	TRUE	TRUE	1	TRUE	TRUE	1	1
FBgn0037292	54	39	24	55	78	94	TRUE	FALSE	TRUE	0	TRUE	FALSE	0	0
FBgn0037293	34	26	20	24	54	50	TRUE	TRUE	TRUE	1	TRUE	TRUE	1	1
FBgn0037294	27	36	36	29	63	65	TRUE	TRUE	TRUE	1	TRUE	TRUE	1	1
FBgn0037295	87	80	80	80	167	160	TRUE	TRUE	TRUE	1	TRUE	TRUE	1	1
FBgn0037296	38	46	45	40	83	86	TRUE	TRUE	TRUE	1	TRUE	TRUE	1	1
FBgn0037297	31	49	44	42	75	91	FALSE	TRUE	TRUE	0	FALSE	TRUE	0	0
FBgn0037298	74	86	60	68	134	154	TRUE	TRUE	TRUE	1	TRUE	TRUE	1	1
FBgn0037299	19	27	26	20	45	47	TRUE	TRUE	TRUE	1	TRUE	TRUE	1	1
FBgn0037301	108	108	86	90	194	198	TRUE	TRUE	TRUE	1	TRUE	TRUE	1	1
FBgn0037304	75	73	77	78	152	151	TRUE	TRUE	TRUE	1	TRUE	TRUE	1	1
FBgn0037307	22	31	21	23	43	54	TRUE	TRUE	TRUE	1	TRUE	TRUE	1	1
FBgn0037312	47	31	31	13	78	44	FALSE	FALSE	FALSE	0	FALSE	FALSE	0	0
FBgn0037313	41	41	35	38	76	79	TRUE	TRUE	TRUE	1	TRUE	TRUE	1	1
FBgn0037315	27	35	37	30	64	65	TRUE	TRUE	TRUE	1	TRUE	TRUE	1	1
FBgn0037320	16	15	11	20	27	35	TRUE	TRUE	TRUE	1	TRUE	FALSE	0	0
FBgn0037323	34	39	27	28	61	67	TRUE	TRUE	TRUE	1	TRUE	TRUE	1	1
FBgn0037324	99	84	64	80	163	164	TRUE	TRUE	TRUE	1	TRUE	TRUE	1	1
FBgn0037325	36	38	36	39	72	77	TRUE	TRUE	TRUE	1	TRUE	TRUE	1	1
FBgn0037326	203	219	182	171	385	390	TRUE	TRUE	TRUE	1	TRUE	TRUE	1	1
FBgn0037327	29	45	28	28	57	73	FALSE	TRUE	TRUE	0	FALSE	TRUE	0	0
FBgn0037328	53	61	43	38	96	99	TRUE	TRUE	TRUE	1	TRUE	TRUE	1	1
FBgn0037332	88	89	79	102	167	191	TRUE	TRUE	TRUE	1	TRUE	TRUE	1	1
FBgn0037336	160	131	99	92	259	223	TRUE	TRUE	TRUE	1	TRUE	TRUE	1	1
FBgn0037338	46	36	40	49	86	85	TRUE	TRUE	TRUE	1	TRUE	TRUE	1	1
FBgn0037339	69	58	74	66	143	124	TRUE	TRUE	TRUE	1	TRUE	TRUE	1	1
FBgn0037340	20	14	18	13	38	27	TRUE	TRUE	TRUE	1	TRUE	TRUE	1	1
FBgn0037341	30	33	27	30	57	63	TRUE	TRUE	TRUE	1	TRUE	TRUE	1	1
FBgn0037344	95	89	81	79	176	168	TRUE	TRUE	TRUE	1	TRUE	TRUE	1	1
FBgn0037347	51	30	28	25	79	55	FALSE	TRUE	FALSE	0	FALSE	TRUE	0	0
FBgn0037350	19	25	32	29	51	54	TRUE	TRUE	TRUE	1	TRUE	TRUE	1	1
FBgn0037358	44	44	29	44	73	88	TRUE	TRUE	TRUE	1	TRUE	FALSE	0	0
FBgn0037359	11	22	21	13	32	35	FALSE	TRUE	TRUE	0	FALSE	FALSE	0	0
FBgn0037360	57	60	34	40	91	100	TRUE	TRUE	TRUE	1	TRUE	TRUE	1	1
FBgn0037363	41	34	31	29	72	63	TRUE	TRUE	TRUE	1	TRUE	TRUE	1	1
FBgn0037372	45	51	47	50	92	101	TRUE	TRUE	TRUE	1	TRUE	TRUE	1	1
FBgn0037374	41	52	41	43	82	95	TRUE	TRUE	TRUE	1	TRUE	TRUE	1	1
FBgn0037375	93	83	58	76	151	159	TRUE	TRUE	TRUE	1	TRUE	TRUE	1	1
FBgn0037376	64	57	55	68	119	125	TRUE	TRUE	TRUE	1	TRUE	TRUE	1	1
FBgn0037377	38	44	23	45	61	89	TRUE	FALSE	FALSE	0	TRUE	FALSE	0	0
FBgn0037378	49	49	34	41	83	90	TRUE	TRUE	TRUE	1	TRUE	TRUE	1	1
FBgn0037379	79	64	74	47	153	111	TRUE	FALSE	FALSE	0	TRUE	FALSE	0	0
FBgn0037385	28	21	30	37	58	58	TRUE	TRUE	TRUE	1	TRUE	TRUE	1	1
FBgn0037386	68	49	46	53	114	102	FALSE	TRUE	TRUE	0	TRUE	TRUE	1	0
FBgn0037387	108	105	79	64	187	169	TRUE	TRUE	TRUE	1	TRUE	TRUE	1	1
FBgn0037389	29	46	34	36	63	82	FALSE	TRUE	TRUE	0	FALSE	TRUE	0	0
FBgn0037391	94	63	69	64	163	127	FALSE	TRUE	FALSE	0	TRUE	TRUE	1	0
FBgn0037397	35	40	35	30	70	70	TRUE	TRUE	TRUE	1	TRUE	TRUE	1	1
FBgn0037398	75	69	68	59	143	128	TRUE	TRUE	TRUE	1	TRUE	TRUE	1	1
FBgn0037399	76	79	89	78	165	157	TRUE	TRUE	TRUE	1	TRUE	TRUE	1	1
FBgn0037402	100	121	65	74	165	195	TRUE	TRUE	TRUE	1	TRUE	TRUE	1	1
FBgn0037405	39	54	33	46	72	100	TRUE	TRUE	FALSE	0	TRUE	TRUE	1	0
FBgn0037406	49	43	36	32	85	75	TRUE	TRUE	TRUE	1	TRUE	TRUE	1	1
FBgn0037408	126	150	127	114	253	264	TRUE	TRUE	TRUE	1	TRUE	TRUE	1	1
FBgn0037409	175	162	159	141	334	303	TRUE	TRUE	TRUE	1	TRUE	TRUE	1	1
FBgn0037410	99	95	78	90	177	185	TRUE	TRUE	TRUE	1	TRUE	TRUE	1	1
FBgn0037411	13	20	14	19	27	39	TRUE	TRUE	TRUE	1	FALSE	TRUE	0	0
FBgn0037412	20	17	30	19	50	36	TRUE	TRUE	TRUE	1	TRUE	FALSE	0	0
FBgn0037417	22	23	27	22	49	45	TRUE	TRUE	TRUE	1	TRUE	TRUE	1	1
FBgn0037422	52	36	36	35	88	71	TRUE	TRUE	TRUE	1	TRUE	TRUE	1	1
FBgn0037424	42	47	27	24	69	71	TRUE	TRUE	TRUE	1	TRUE	TRUE	1	1
FBgn0037427	156	158	150	139	306	297	TRUE	TRUE	TRUE	1	TRUE	TRUE	1	1
FBgn0037431	40	25	27	26	67	51	FALSE	TRUE	TRUE	0	FALSE	TRUE	0	0
FBgn0037432	48	62	52	47	100	109	TRUE	TRUE	TRUE	1	TRUE	TRUE	1	1
FBgn0037436	19	35	20	17	39	52	FALSE	TRUE	TRUE	0	FALSE	TRUE	0	0
FBgn0037439	51	52	48	34	99	86	TRUE	TRUE	TRUE	1	TRUE	TRUE	1	1
FBgn0037440	75	95	84	68	159	163	TRUE	TRUE	TRUE	1	TRUE	TRUE	1	1
FBgn0037442	150	185	143	121	293	306	FALSE	TRUE	TRUE	0	TRUE	TRUE	1	0
FBgn0037443	163	176	138	106	301	282	TRUE	FALSE	TRUE	0	TRUE	TRUE	1	0
FBgn0037445	42	47	41	40	83	87	TRUE	TRUE	TRUE	1	TRUE	TRUE	1	1
FBgn0037446	52	43	35	36	87	79	TRUE	TRUE	TRUE	1	TRUE	TRUE	1	1
FBgn0037447	16	21	18	13	34	34	TRUE	TRUE	TRUE	1	TRUE	TRUE	1	1
FBgn0037448	136	129	118	110	254	239	TRUE	TRUE	TRUE	1	TRUE	TRUE	1	1
FBgn0037449	96	103	99	76	195	179	TRUE	FALSE	TRUE	0	TRUE	TRUE	1	0
FBgn0037454	92	82	68	81	160	163	TRUE	TRUE	TRUE	1	TRUE	TRUE	1	1
FBgn0037455	29	62	54	48	83	110	FALSE	TRUE	FALSE	0	FALSE	TRUE	0	0
FBgn0037456	87	64	54	73	141	137	FALSE	TRUE	TRUE	0	TRUE	TRUE	1	0
FBgn0037460	63	70	54	62	117	132	TRUE	TRUE	TRUE	1	TRUE	TRUE	1	1
FBgn0037462	68	61	63	50	131	111	TRUE	TRUE	TRUE	1	TRUE	TRUE	1	1
FBgn0037463	62	57	51	50	113	107	TRUE	TRUE	TRUE	1	TRUE	TRUE	1	1
FBgn0037464	52	55	34	60	86	115	TRUE	FALSE	FALSE	0	TRUE	FALSE	0	0
FBgn0037465	106	94	70	82	176	176	TRUE	TRUE	TRUE	1	TRUE	TRUE	1	1
FBgn0037466	101	108	80	89	181	197	TRUE	TRUE	TRUE	1	TRUE	TRUE	1	1
FBgn0037467	97	85	77	64	174	149	TRUE	TRUE	TRUE	1	TRUE	TRUE	1	1
FBgn0037468	27	36	18	21	45	57	TRUE	TRUE	TRUE	1	TRUE	TRUE	1	1
FBgn0037469	46	30	24	30	70	60	FALSE	TRUE	TRUE	0	FALSE	TRUE	0	0
FBgn0037470	39	42	34	30	73	72	TRUE	TRUE	TRUE	1	TRUE	TRUE	1	1
FBgn0037472	18	23	19	22	37	45	TRUE	TRUE	TRUE	1	TRUE	TRUE	1	1
FBgn0037473	58	56	46	47	104	103	TRUE	TRUE	TRUE	1	TRUE	TRUE	1	1
FBgn0037475	59	67	55	47	114	114	TRUE	TRUE	TRUE	1	TRUE	TRUE	1	1
FBgn0037481	33	25	31	21	64	46	TRUE	TRUE	TRUE	1	TRUE	TRUE	1	1
FBgn0037482	66	35	57	47	123	82	FALSE	TRUE	FALSE	0	FALSE	TRUE	0	0
FBgn0037485	54	66	60	50	114	116	TRUE	TRUE	TRUE	1	TRUE	TRUE	1	1
FBgn0037486	23	18	17	14	40	32	TRUE	TRUE	TRUE	1	TRUE	TRUE	1	1
FBgn0037487	253	256	231	191	484	447	TRUE	FALSE	TRUE	0	TRUE	TRUE	1	0
FBgn0037488	100	92	83	80	183	172	TRUE	TRUE	TRUE	1	TRUE	TRUE	1	1
FBgn0037489	61	55	46	54	107	109	TRUE	TRUE	TRUE	1	TRUE	TRUE	1	1
FBgn0037490	28	23	19	18	47	41	TRUE	TRUE	TRUE	1	TRUE	TRUE	1	1
FBgn0037491	40	39	24	41	64	80	TRUE	FALSE	TRUE	0	TRUE	FALSE	0	0
FBgn0037493	77	71	61	71	138	142	TRUE	TRUE	TRUE	1	TRUE	TRUE	1	1
FBgn0037498	111	122	74	87	185	209	TRUE	TRUE	TRUE	1	TRUE	TRUE	1	1
FBgn0037500	44	38	29	36	73	74	TRUE	TRUE	TRUE	1	TRUE	TRUE	1	1
FBgn0037501	81	79	67	78	148	157	TRUE	TRUE	TRUE	1	TRUE	TRUE	1	1
FBgn0037502	137	150	135	136	272	286	TRUE	TRUE	TRUE	1	TRUE	TRUE	1	1
FBgn0037503	16	23	24	11	40	34	TRUE	FALSE	TRUE	0	TRUE	FALSE	0	0
FBgn0037506	93	87	65	69	158	156	TRUE	TRUE	TRUE	1	TRUE	TRUE	1	1
FBgn0037512	81	84	70	62	151	146	TRUE	TRUE	TRUE	1	TRUE	TRUE	1	1
FBgn0037513	27	21	17	34	44	55	TRUE	FALSE	TRUE	0	TRUE	FALSE	0	0
FBgn0037514	35	37	32	41	67	78	TRUE	TRUE	TRUE	1	TRUE	TRUE	1	1
FBgn0037515	151	157	105	113	256	270	TRUE	TRUE	TRUE	1	TRUE	TRUE	1	1
FBgn0037516	79	99	67	78	146	177	TRUE	TRUE	FALSE	0	TRUE	TRUE	1	0
FBgn0037517	119	145	127	109	246	254	TRUE	TRUE	TRUE	1	TRUE	TRUE	1	1
FBgn0037518	117	126	119	95	236	221	TRUE	TRUE	TRUE	1	TRUE	TRUE	1	1
FBgn0037519	128	131	119	87	247	218	TRUE	FALSE	TRUE	0	TRUE	TRUE	1	0
FBgn0037520	104	103	85	84	189	187	TRUE	TRUE	TRUE	1	TRUE	TRUE	1	1
FBgn0037521	247	286	223	214	470	500	FALSE	TRUE	TRUE	0	TRUE	TRUE	1	0
FBgn0037525	270	282	213	228	483	510	TRUE	TRUE	TRUE	1	TRUE	TRUE	1	1
FBgn0037526	20	42	32	25	52	67	FALSE	TRUE	TRUE	0	FALSE	TRUE	0	0
FBgn0037529	27	26	17	23	44	49	TRUE	TRUE	TRUE	1	TRUE	TRUE	1	1
FBgn0037530	79	86	94	70	173	156	TRUE	FALSE	TRUE	0	TRUE	TRUE	1	0
FBgn0037531	109	124	102	86	211	210	TRUE	TRUE	TRUE	1	TRUE	TRUE	1	1
FBgn0037533	58	53	48	42	106	95	TRUE	TRUE	TRUE	1	TRUE	TRUE	1	1
FBgn0037534	98	89	93	78	191	167	TRUE	TRUE	TRUE	1	TRUE	TRUE	1	1
FBgn0037535	23	20	21	18	44	38	TRUE	TRUE	TRUE	1	TRUE	TRUE	1	1
FBgn0037536	79	74	70	88	149	162	TRUE	TRUE	TRUE	1	TRUE	TRUE	1	1
FBgn0037537	37	36	24	34	61	70	TRUE	TRUE	TRUE	1	TRUE	TRUE	1	1
FBgn0037538	40	19	14	18	54	37	FALSE	TRUE	FALSE	0	FALSE	TRUE	0	0
FBgn0037539	47	35	31	29	78	64	TRUE	TRUE	TRUE	1	TRUE	TRUE	1	1
FBgn0037541	45	33	48	38	93	71	TRUE	TRUE	TRUE	1	TRUE	TRUE	1	1
FBgn0037544	57	49	39	42	96	91	TRUE	TRUE	TRUE	1	TRUE	TRUE	1	1
FBgn0037546	147	158	125	110	272	268	TRUE	TRUE	TRUE	1	TRUE	TRUE	1	1
FBgn0037548	25	19	23	33	48	52	TRUE	TRUE	TRUE	1	TRUE	TRUE	1	1
FBgn0037549	40	24	25	30	65	54	FALSE	TRUE	TRUE	0	FALSE	TRUE	0	0
FBgn0037551	72	49	43	36	115	85	FALSE	TRUE	FALSE	0	TRUE	TRUE	1	0
FBgn0037552	58	40	39	49	97	89	FALSE	TRUE	TRUE	0	TRUE	TRUE	1	0
FBgn0037553	101	96	91	93	192	189	TRUE	TRUE	TRUE	1	TRUE	TRUE	1	1
FBgn0037554	37	44	28	36	65	80	TRUE	TRUE	TRUE	1	TRUE	TRUE	1	1
FBgn0037555	71	81	59	61	130	142	TRUE	TRUE	TRUE	1	TRUE	TRUE	1	1
FBgn0037556	77	81	48	45	125	126	TRUE	TRUE	TRUE	1	TRUE	TRUE	1	1
FBgn0037560	43	34	42	37	85	71	TRUE	TRUE	TRUE	1	TRUE	TRUE	1	1
FBgn0037561	76	91	54	67	130	158	TRUE	TRUE	TRUE	1	TRUE	TRUE	1	1
FBgn0037562	37	42	28	41	65	83	TRUE	TRUE	TRUE	1	TRUE	TRUE	1	1
FBgn0037563	39	36	37	17	76	53	TRUE	FALSE	FALSE	0	TRUE	FALSE	0	0
FBgn0037565	78	74	69	76	147	150	TRUE	TRUE	TRUE	1	TRUE	TRUE	1	1
FBgn0037566	45	34	33	11	78	45	TRUE	FALSE	FALSE	0	TRUE	FALSE	0	0
FBgn0037570	53	55	32	37	85	92	TRUE	TRUE	TRUE	1	TRUE	TRUE	1	1
FBgn0037571	26	22	19	16	45	38	TRUE	TRUE	TRUE	1	TRUE	TRUE	1	1
FBgn0037574	37	40	34	48	71	88	TRUE	TRUE	TRUE	1	TRUE	TRUE	1	1
FBgn0037576	42	19	24	29	66	48	FALSE	TRUE	TRUE	0	FALSE	TRUE	0	0
FBgn0037590	25	48	34	31	59	79	FALSE	TRUE	TRUE	0	FALSE	TRUE	0	0
FBgn0037591	37	33	37	24	74	57	TRUE	TRUE	TRUE	1	TRUE	FALSE	0	0
FBgn0037592	130	160	123	124	253	284	FALSE	TRUE	TRUE	0	TRUE	TRUE	1	0
FBgn0037594	59	67	56	57	115	124	TRUE	TRUE	TRUE	1	TRUE	TRUE	1	1
FBgn0037601	92	69	85	74	177	143	FALSE	TRUE	FALSE	0	TRUE	TRUE	1	0
FBgn0037606	93	72	66	75	159	147	TRUE	TRUE	TRUE	1	TRUE	TRUE	1	1
FBgn0037607	72	64	43	62	115	126	TRUE	FALSE	TRUE	0	TRUE	TRUE	1	0
FBgn0037608	23	24	23	29	46	53	TRUE	TRUE	TRUE	1	TRUE	TRUE	1	1
FBgn0037610	29	43	39	31	68	74	TRUE	TRUE	TRUE	1	TRUE	TRUE	1	1
FBgn0037611	43	37	40	27	83	64	TRUE	TRUE	TRUE	1	TRUE	TRUE	1	1
FBgn0037614	50	54	46	40	96	94	TRUE	TRUE	TRUE	1	TRUE	TRUE	1	1
FBgn0037616	59	52	29	34	88	86	TRUE	TRUE	TRUE	1	TRUE	TRUE	1	1
FBgn0037617	105	107	82	67	187	174	TRUE	TRUE	TRUE	1	TRUE	TRUE	1	1
FBgn0037619	52	54	40	49	92	103	TRUE	TRUE	TRUE	1	TRUE	TRUE	1	1
FBgn0037622	111	107	84	71	195	178	TRUE	TRUE	TRUE	1	TRUE	TRUE	1	1
FBgn0037623	132	141	113	108	245	249	TRUE	TRUE	TRUE	1	TRUE	TRUE	1	1
FBgn0037626	108	100	87	76	195	176	TRUE	TRUE	TRUE	1	TRUE	TRUE	1	1
FBgn0037627	88	80	61	64	149	144	TRUE	TRUE	TRUE	1	TRUE	TRUE	1	1
FBgn0037630	63	50	50	42	113	92	TRUE	TRUE	TRUE	1	TRUE	TRUE	1	1
FBgn0037632	82	83	86	88	168	171	TRUE	TRUE	TRUE	1	TRUE	TRUE	1	1
FBgn0037633	57	46	33	35	90	81	TRUE	TRUE	TRUE	1	TRUE	TRUE	1	1
FBgn0037635	84	81	61	57	145	138	TRUE	TRUE	TRUE	1	TRUE	TRUE	1	1
FBgn0037637	47	54	50	40	97	94	TRUE	TRUE	TRUE	1	TRUE	TRUE	1	1
FBgn0037638	72	61	55	47	127	108	TRUE	TRUE	TRUE	1	TRUE	TRUE	1	1
FBgn0037643	120	100	83	91	203	191	TRUE	TRUE	TRUE	1	TRUE	TRUE	1	1
FBgn0037644	48	38	58	50	106	88	TRUE	TRUE	TRUE	1	TRUE	TRUE	1	1
FBgn0037646	55	38	43	40	98	78	FALSE	TRUE	TRUE	0	TRUE	TRUE	1	0
FBgn0037648	62	101	69	63	131	164	FALSE	TRUE	FALSE	0	FALSE	TRUE	0	0
FBgn0037650	29	38	22	32	51	70	TRUE	TRUE	TRUE	1	TRUE	TRUE	1	1
FBgn0037652	22	26	18	15	40	41	TRUE	TRUE	TRUE	1	TRUE	TRUE	1	1
FBgn0037653	60	54	44	39	104	93	TRUE	TRUE	TRUE	1	TRUE	TRUE	1	1
FBgn0037654	35	57	31	28	66	85	FALSE	TRUE	TRUE	0	FALSE	TRUE	0	0
FBgn0037655	81	78	67	70	148	148	TRUE	TRUE	TRUE	1	TRUE	TRUE	1	1
FBgn0037656	23	16	20	17	43	33	TRUE	TRUE	TRUE	1	TRUE	TRUE	1	1
FBgn0037657	71	62	62	51	133	113	TRUE	TRUE	TRUE	1	TRUE	TRUE	1	1
FBgn0037659	127	140	123	107	250	247	TRUE	TRUE	TRUE	1	TRUE	TRUE	1	1
FBgn0037660	21	24	29	14	50	38	TRUE	FALSE	TRUE	0	TRUE	FALSE	0	0
FBgn0037661	76	86	73	49	149	135	TRUE	FALSE	TRUE	0	TRUE	TRUE	1	0
FBgn0037662	59	80	63	59	122	139	FALSE	TRUE	TRUE	0	TRUE	TRUE	1	0
FBgn0037664	160	154	130	145	290	299	TRUE	TRUE	TRUE	1	TRUE	TRUE	1	1
FBgn0037665	66	50	36	35	102	85	TRUE	TRUE	TRUE	1	TRUE	TRUE	1	1
FBgn0037666	105	110	82	109	187	219	TRUE	FALSE	TRUE	0	TRUE	TRUE	1	0
FBgn0037667	28	47	37	37	65	84	FALSE	TRUE	TRUE	0	FALSE	TRUE	0	0
FBgn0037669	29	33	26	25	55	58	TRUE	TRUE	TRUE	1	TRUE	TRUE	1	1
FBgn0037671	32	50	41	36	73	86	FALSE	TRUE	TRUE	0	FALSE	TRUE	0	0
FBgn0037672	74	65	47	40	121	105	TRUE	TRUE	TRUE	1	TRUE	TRUE	1	1
FBgn0037675	71	58	49	44	120	102	TRUE	TRUE	TRUE	1	TRUE	TRUE	1	1
FBgn0037676	210	229	196	196	406	425	TRUE	TRUE	TRUE	1	TRUE	TRUE	1	1
FBgn0037677	103	117	76	87	179	204	TRUE	TRUE	TRUE	1	TRUE	TRUE	1	1
FBgn0037678	28	55	36	32	64	87	FALSE	TRUE	FALSE	0	FALSE	TRUE	0	0
FBgn0037679	108	114	92	89	200	203	TRUE	TRUE	TRUE	1	TRUE	TRUE	1	1
FBgn0037680	168	163	155	135	323	298	TRUE	TRUE	TRUE	1	TRUE	TRUE	1	1
FBgn0037683	37	45	47	42	84	87	TRUE	TRUE	TRUE	1	TRUE	TRUE	1	1
FBgn0037684	91	82	74	65	165	147	TRUE	TRUE	TRUE	1	TRUE	TRUE	1	1
FBgn0037685	59	71	58	64	117	135	TRUE	TRUE	TRUE	1	TRUE	TRUE	1	1
FBgn0037686	28	30	11	20	39	50	TRUE	TRUE	TRUE	1	TRUE	FALSE	0	0
FBgn0037687	30	21	29	21	59	42	TRUE	TRUE	TRUE	1	TRUE	TRUE	1	1
FBgn0037688	39	27	32	22	71	49	TRUE	TRUE	FALSE	0	TRUE	TRUE	1	0
FBgn0037690	124	124	110	82	234	206	TRUE	FALSE	TRUE	0	TRUE	TRUE	1	0
FBgn0037696	52	67	49	49	101	116	TRUE	TRUE	TRUE	1	TRUE	TRUE	1	1
FBgn0037697	151	134	122	116	273	250	TRUE	TRUE	TRUE	1	TRUE	TRUE	1	1
FBgn0037698	484	491	448	448	932	939	TRUE	TRUE	TRUE	1	TRUE	TRUE	1	1
FBgn0037702	171	160	136	124	307	284	TRUE	TRUE	TRUE	1	TRUE	TRUE	1	1
FBgn0037703	40	37	22	33	62	70	TRUE	TRUE	TRUE	1	TRUE	TRUE	1	1
FBgn0037705	186	197	150	156	336	353	TRUE	TRUE	TRUE	1	TRUE	TRUE	1	1
FBgn0037708	18	21	18	14	36	35	TRUE	TRUE	TRUE	1	TRUE	TRUE	1	1
FBgn0037710	38	35	30	31	68	66	TRUE	TRUE	TRUE	1	TRUE	TRUE	1	1
FBgn0037713	35	26	14	26	49	52	TRUE	FALSE	TRUE	0	TRUE	FALSE	0	0
FBgn0037714	41	45	38	40	79	85	TRUE	TRUE	TRUE	1	TRUE	TRUE	1	1
FBgn0037715	23	29	23	28	46	57	TRUE	TRUE	TRUE	1	TRUE	TRUE	1	1
FBgn0037716	48	32	22	47	70	79	FALSE	FALSE	TRUE	0	TRUE	FALSE	0	0
FBgn0037717	113	125	115	121	228	246	TRUE	TRUE	TRUE	1	TRUE	TRUE	1	1
FBgn0037718	46	63	44	51	90	114	TRUE	TRUE	TRUE	1	TRUE	TRUE	1	1
FBgn0037719	54	54	51	50	105	104	TRUE	TRUE	TRUE	1	TRUE	TRUE	1	1
FBgn0037720	163	158	144	154	307	312	TRUE	TRUE	TRUE	1	TRUE	TRUE	1	1
FBgn0037721	23	10	26	15	49	25	FALSE	TRUE	FALSE	0	FALSE	FALSE	0	0
FBgn0037723	39	35	34	24	73	59	TRUE	TRUE	TRUE	1	TRUE	TRUE	1	1
FBgn0037724	35	37	39	33	74	70	TRUE	TRUE	TRUE	1	TRUE	TRUE	1	1
FBgn0037726	597	588	441	467	1038	1055	TRUE	TRUE	TRUE	1	TRUE	TRUE	1	1
FBgn0037727	68	74	57	68	125	142	TRUE	TRUE	TRUE	1	TRUE	TRUE	1	1
FBgn0037734	81	79	79	49	160	128	TRUE	FALSE	FALSE	0	TRUE	FALSE	0	0
FBgn0037736	90	103	82	81	172	184	TRUE	TRUE	TRUE	1	TRUE	TRUE	1	1
FBgn0037746	36	28	15	23	51	51	TRUE	TRUE	TRUE	1	TRUE	FALSE	0	0
FBgn0037747	16	16	16	15	32	31	TRUE	TRUE	TRUE	1	TRUE	TRUE	1	1
FBgn0037750	60	70	48	57	108	127	TRUE	TRUE	TRUE	1	TRUE	TRUE	1	1
FBgn0037751	87	86	85	87	172	173	TRUE	TRUE	TRUE	1	TRUE	TRUE	1	1
FBgn0037759	26	26	18	19	44	45	TRUE	TRUE	TRUE	1	TRUE	TRUE	1	1
FBgn0037760	35	19	14	19	49	38	FALSE	TRUE	TRUE	0	FALSE	TRUE	0	0
FBgn0037762	30	49	29	34	59	83	FALSE	TRUE	FALSE	0	FALSE	TRUE	0	0
FBgn0037764	40	38	30	39	70	77	TRUE	TRUE	TRUE	1	TRUE	TRUE	1	1
FBgn0037765	40	66	38	33	78	99	FALSE	TRUE	TRUE	0	FALSE	TRUE	0	0
FBgn0037766	96	120	106	110	202	230	TRUE	TRUE	TRUE	1	TRUE	TRUE	1	1
FBgn0037770	76	67	70	57	146	124	TRUE	TRUE	TRUE	1	TRUE	TRUE	1	1
FBgn0037772	25	33	31	30	56	63	TRUE	TRUE	TRUE	1	TRUE	TRUE	1	1
FBgn0037778	33	28	24	31	57	59	TRUE	TRUE	TRUE	1	TRUE	TRUE	1	1
FBgn0037779	54	50	50	33	104	83	TRUE	FALSE	TRUE	0	TRUE	FALSE	0	0
FBgn0037780	44	39	25	24	69	63	TRUE	TRUE	TRUE	1	TRUE	TRUE	1	1
FBgn0037788	143	130	124	126	267	256	TRUE	TRUE	TRUE	1	TRUE	TRUE	1	1
FBgn0037792	195	166	178	143	373	309	TRUE	FALSE	FALSE	0	TRUE	TRUE	1	0
FBgn0037794	53	44	44	60	97	104	TRUE	TRUE	TRUE	1	TRUE	TRUE	1	1
FBgn0037796	65	62	64	57	129	119	TRUE	TRUE	TRUE	1	TRUE	TRUE	1	1
FBgn0037801	120	125	114	102	234	227	TRUE	TRUE	TRUE	1	TRUE	TRUE	1	1
FBgn0037802	29	26	34	36	63	62	TRUE	TRUE	TRUE	1	TRUE	TRUE	1	1
FBgn0037807	61	80	64	70	125	150	TRUE	TRUE	TRUE	1	TRUE	TRUE	1	1
FBgn0037809	43	54	40	36	83	90	TRUE	TRUE	TRUE	1	TRUE	TRUE	1	1
FBgn0037810	117	102	111	88	228	190	TRUE	TRUE	FALSE	0	TRUE	TRUE	1	0
FBgn0037811	32	33	35	43	67	76	TRUE	TRUE	TRUE	1	TRUE	TRUE	1	1
FBgn0037812	37	71	31	55	68	126	FALSE	FALSE	FALSE	0	FALSE	FALSE	0	0
FBgn0037814	99	102	90	92	189	194	TRUE	TRUE	TRUE	1	TRUE	TRUE	1	1
FBgn0037815	19	23	31	18	50	41	TRUE	FALSE	TRUE	0	TRUE	FALSE	0	0
FBgn0037816	155	146	94	126	249	272	TRUE	FALSE	TRUE	0	TRUE	TRUE	1	0
FBgn0037817	82	79	67	87	149	166	TRUE	TRUE	TRUE	1	TRUE	TRUE	1	1
FBgn0037818	138	133	117	111	255	244	TRUE	TRUE	TRUE	1	TRUE	TRUE	1	1
FBgn0037819	170	166	128	128	298	294	TRUE	TRUE	TRUE	1	TRUE	TRUE	1	1
FBgn0037822	45	55	31	37	76	92	TRUE	TRUE	TRUE	1	TRUE	TRUE	1	1
FBgn0037824	20	17	23	23	43	40	TRUE	TRUE	TRUE	1	TRUE	TRUE	1	1
FBgn0037826	106	102	58	53	164	155	TRUE	TRUE	TRUE	1	TRUE	TRUE	1	1
FBgn0037827	86	100	61	91	147	191	TRUE	FALSE	FALSE	0	TRUE	TRUE	1	0
FBgn0037828	37	28	32	35	69	63	TRUE	TRUE	TRUE	1	TRUE	TRUE	1	1
FBgn0037829	102	101	84	101	186	202	TRUE	TRUE	TRUE	1	TRUE	TRUE	1	1
FBgn0037831	188	187	194	161	382	348	TRUE	FALSE	TRUE	0	TRUE	TRUE	1	0
FBgn0037832	73	56	54	52	127	108	TRUE	TRUE	TRUE	1	TRUE	TRUE	1	1
FBgn0037834	30	30	25	25	55	55	TRUE	TRUE	TRUE	1	TRUE	TRUE	1	1
FBgn0037835	40	41	39	32	79	73	TRUE	TRUE	TRUE	1	TRUE	TRUE	1	1
FBgn0037836	657	660	572	528	1229	1188	TRUE	TRUE	TRUE	1	TRUE	TRUE	1	1
FBgn0037837	177	145	143	117	320	262	FALSE	TRUE	FALSE	0	TRUE	TRUE	1	0
FBgn0037838	154	133	110	108	264	241	TRUE	TRUE	TRUE	1	TRUE	TRUE	1	1
FBgn0037841	53	43	40	49	93	92	TRUE	TRUE	TRUE	1	TRUE	TRUE	1	1
FBgn0037842	25	30	31	23	56	53	TRUE	TRUE	TRUE	1	TRUE	TRUE	1	1
FBgn0037843	111	92	85	82	196	174	TRUE	TRUE	TRUE	1	TRUE	TRUE	1	1
FBgn0037844	74	64	47	59	121	123	TRUE	TRUE	TRUE	1	TRUE	TRUE	1	1
FBgn0037845	103	103	80	62	183	165	TRUE	TRUE	TRUE	1	TRUE	TRUE	1	1
FBgn0037846	125	135	91	84	216	219	TRUE	TRUE	TRUE	1	TRUE	TRUE	1	1
FBgn0037848	17	22	20	17	37	39	TRUE	TRUE	TRUE	1	TRUE	TRUE	1	1
FBgn0037849	66	103	61	58	127	161	FALSE	TRUE	FALSE	0	FALSE	TRUE	0	0
FBgn0037850	30	18	30	28	60	46	TRUE	TRUE	TRUE	1	FALSE	TRUE	0	0
FBgn0037852	78	98	57	66	135	164	TRUE	TRUE	TRUE	1	TRUE	TRUE	1	1
FBgn0037853	101	70	65	69	166	139	FALSE	TRUE	TRUE	0	TRUE	TRUE	1	0
FBgn0037855	108	123	81	89	189	212	TRUE	TRUE	TRUE	1	TRUE	TRUE	1	1
FBgn0037856	109	116	88	97	197	213	TRUE	TRUE	TRUE	1	TRUE	TRUE	1	1
FBgn0037860	75	87	80	83	155	170	TRUE	TRUE	TRUE	1	TRUE	TRUE	1	1
FBgn0037862	101	91	101	86	202	177	TRUE	TRUE	TRUE	1	TRUE	TRUE	1	1
FBgn0037870	68	88	64	93	132	181	TRUE	FALSE	FALSE	0	TRUE	TRUE	1	0
FBgn0037873	63	77	53	60	116	137	TRUE	TRUE	TRUE	1	TRUE	TRUE	1	1
FBgn0037874	57	60	57	54	114	114	TRUE	TRUE	TRUE	1	TRUE	TRUE	1	1
FBgn0037875	160	119	108	118	268	237	FALSE	TRUE	TRUE	0	TRUE	TRUE	1	0
FBgn0037876	33	42	21	23	54	65	TRUE	TRUE	TRUE	1	TRUE	TRUE	1	1
FBgn0037877	102	106	83	76	185	182	TRUE	TRUE	TRUE	1	TRUE	TRUE	1	1
FBgn0037878	52	43	39	34	91	77	TRUE	TRUE	TRUE	1	TRUE	TRUE	1	1
FBgn0037879	34	28	32	26	66	54	TRUE	TRUE	TRUE	1	TRUE	TRUE	1	1
FBgn0037880	68	79	82	70	150	149	TRUE	TRUE	TRUE	1	TRUE	TRUE	1	1
FBgn0037881	62	60	60	61	122	121	TRUE	TRUE	TRUE	1	TRUE	TRUE	1	1
FBgn0037882	70	87	51	60	121	147	TRUE	TRUE	TRUE	1	TRUE	TRUE	1	1
FBgn0037884	161	163	122	128	283	291	TRUE	TRUE	TRUE	1	TRUE	TRUE	1	1
FBgn0037885	67	58	54	44	121	102	TRUE	TRUE	TRUE	1	TRUE	TRUE	1	1
FBgn0037888	58	95	48	65	106	160	FALSE	TRUE	FALSE	0	FALSE	TRUE	0	0
FBgn0037889	58	41	43	29	101	70	TRUE	TRUE	FALSE	0	TRUE	TRUE	1	0
FBgn0037890	115	112	107	99	222	211	TRUE	TRUE	TRUE	1	TRUE	TRUE	1	1
FBgn0037891	129	167	98	99	227	266	FALSE	TRUE	FALSE	0	TRUE	TRUE	1	0
FBgn0037892	50	63	41	39	91	102	TRUE	TRUE	TRUE	1	TRUE	TRUE	1	1
FBgn0037894	91	87	86	73	177	160	TRUE	TRUE	TRUE	1	TRUE	TRUE	1	1
FBgn0037895	99	83	69	84	168	167	TRUE	TRUE	TRUE	1	TRUE	TRUE	1	1
FBgn0037896	172	139	104	94	276	233	FALSE	TRUE	FALSE	0	TRUE	TRUE	1	0
FBgn0037897	263	256	240	223	503	479	TRUE	TRUE	TRUE	1	TRUE	TRUE	1	1
FBgn0037898	31	16	23	15	54	31	FALSE	TRUE	FALSE	0	FALSE	FALSE	0	0
FBgn0037901	13	32	20	14	33	46	FALSE	TRUE	TRUE	0	FALSE	TRUE	0	0
FBgn0037906	45	30	29	40	74	70	TRUE	TRUE	TRUE	1	TRUE	TRUE	1	1
FBgn0037908	71	81	56	60	127	141	TRUE	TRUE	TRUE	1	TRUE	TRUE	1	1
FBgn0037910	71	94	60	74	131	168	FALSE	TRUE	FALSE	0	TRUE	TRUE	1	0
FBgn0037911	42	44	35	38	77	82	TRUE	TRUE	TRUE	1	TRUE	TRUE	1	1
FBgn0037912	50	35	59	34	109	69	TRUE	FALSE	FALSE	0	TRUE	FALSE	0	0
FBgn0037913	22	28	29	26	51	54	TRUE	TRUE	TRUE	1	TRUE	TRUE	1	1
FBgn0037915	99	134	100	90	199	224	FALSE	TRUE	TRUE	0	TRUE	TRUE	1	0
FBgn0037916	167	171	141	157	308	328	TRUE	TRUE	TRUE	1	TRUE	TRUE	1	1
FBgn0037917	113	98	92	88	205	186	TRUE	TRUE	TRUE	1	TRUE	TRUE	1	1
FBgn0037918	138	132	102	116	240	248	TRUE	TRUE	TRUE	1	TRUE	TRUE	1	1
FBgn0037920	58	47	45	43	103	90	TRUE	TRUE	TRUE	1	TRUE	TRUE	1	1
FBgn0037921	37	40	55	34	92	74	TRUE	FALSE	TRUE	0	TRUE	FALSE	0	0
FBgn0037923	98	64	46	50	144	114	FALSE	TRUE	FALSE	0	FALSE	TRUE	0	0
FBgn0037924	284	262	221	225	505	487	TRUE	TRUE	TRUE	1	TRUE	TRUE	1	1
FBgn0037926	211	179	142	166	353	345	TRUE	TRUE	TRUE	1	TRUE	TRUE	1	1
FBgn0037931	121	133	105	105	226	238	TRUE	TRUE	TRUE	1	TRUE	TRUE	1	1
FBgn0037933	79	66	64	55	143	121	TRUE	TRUE	TRUE	1	TRUE	TRUE	1	1
FBgn0037934	183	195	167	175	350	370	TRUE	TRUE	TRUE	1	TRUE	TRUE	1	1
FBgn0037935	221	214	191	187	412	401	TRUE	TRUE	TRUE	1	TRUE	TRUE	1	1
FBgn0037936	104	81	73	84	177	165	TRUE	TRUE	TRUE	1	TRUE	TRUE	1	1
FBgn0037937	41	55	42	43	83	98	TRUE	TRUE	TRUE	1	TRUE	TRUE	1	1
FBgn0037939	29	40	47	32	76	72	TRUE	TRUE	TRUE	1	TRUE	TRUE	1	1
FBgn0037940	32	39	29	26	61	65	TRUE	TRUE	TRUE	1	TRUE	TRUE	1	1
FBgn0037941	254	264	246	199	500	463	TRUE	FALSE	TRUE	0	TRUE	TRUE	1	0
FBgn0037942	24	16	15	18	39	34	TRUE	TRUE	TRUE	1	TRUE	TRUE	1	1
FBgn0037944	167	158	149	151	316	309	TRUE	TRUE	TRUE	1	TRUE	TRUE	1	1
FBgn0037949	132	137	110	116	242	253	TRUE	TRUE	TRUE	1	TRUE	TRUE	1	1
FBgn0037950	48	37	42	36	90	73	TRUE	TRUE	TRUE	1	TRUE	TRUE	1	1
FBgn0037955	126	143	111	122	237	265	TRUE	TRUE	TRUE	1	TRUE	TRUE	1	1
FBgn0037956	195	179	150	140	345	319	TRUE	TRUE	TRUE	1	TRUE	TRUE	1	1
FBgn0037958	180	179	155	159	335	338	TRUE	TRUE	TRUE	1	TRUE	TRUE	1	1
FBgn0037960	125	145	125	117	250	262	TRUE	TRUE	TRUE	1	TRUE	TRUE	1	1
FBgn0037963	362	396	355	316	717	712	TRUE	TRUE	TRUE	1	TRUE	TRUE	1	1
FBgn0037964	186	183	154	153	340	336	TRUE	TRUE	TRUE	1	TRUE	TRUE	1	1
FBgn0037972	91	67	66	71	157	138	FALSE	TRUE	TRUE	0	TRUE	TRUE	1	0
FBgn0037973	77	85	58	92	135	177	TRUE	FALSE	FALSE	0	TRUE	FALSE	0	0
FBgn0037974	104	112	96	97	200	209	TRUE	TRUE	TRUE	1	TRUE	TRUE	1	1
FBgn0037975	76	71	75	56	151	127	TRUE	TRUE	TRUE	1	TRUE	TRUE	1	1
FBgn0037976	198	206	167	152	365	358	TRUE	TRUE	TRUE	1	TRUE	TRUE	1	1
FBgn0037978	143	108	101	94	244	202	FALSE	TRUE	FALSE	0	TRUE	TRUE	1	0
FBgn0037979	80	73	54	58	134	131	TRUE	TRUE	TRUE	1	TRUE	TRUE	1	1
FBgn0037980	75	76	49	53	124	129	TRUE	TRUE	TRUE	1	TRUE	TRUE	1	1
FBgn0037981	48	56	46	51	94	107	TRUE	TRUE	TRUE	1	TRUE	TRUE	1	1
FBgn0037985	151	175	153	136	304	311	TRUE	TRUE	TRUE	1	TRUE	TRUE	1	1
FBgn0037986	198	207	172	163	370	370	TRUE	TRUE	TRUE	1	TRUE	TRUE	1	1
FBgn0037987	24	40	29	29	53	69	FALSE	TRUE	TRUE	0	FALSE	TRUE	0	0
FBgn0037988	62	67	55	51	117	118	TRUE	TRUE	TRUE	1	TRUE	TRUE	1	1
FBgn0037989	456	475	365	395	821	870	TRUE	TRUE	TRUE	1	TRUE	TRUE	1	1
FBgn0037992	198	165	120	129	318	294	FALSE	TRUE	TRUE	0	TRUE	TRUE	1	0
FBgn0037993	232	217	207	193	439	410	TRUE	TRUE	TRUE	1	TRUE	TRUE	1	1
FBgn0037994	141	142	117	104	258	246	TRUE	TRUE	TRUE	1	TRUE	TRUE	1	1
FBgn0037995	55	57	59	49	114	106	TRUE	TRUE	TRUE	1	TRUE	TRUE	1	1
FBgn0037996	106	120	106	104	212	224	TRUE	TRUE	TRUE	1	TRUE	TRUE	1	1
FBgn0037998	225	234	174	190	399	424	TRUE	TRUE	TRUE	1	TRUE	TRUE	1	1
FBgn0037999	74	74	54	81	128	155	TRUE	FALSE	TRUE	0	TRUE	TRUE	1	0
FBgn0038000	53	67	50	54	103	121	TRUE	TRUE	TRUE	1	TRUE	TRUE	1	1
FBgn0038001	29	39	28	32	57	71	TRUE	TRUE	TRUE	1	TRUE	TRUE	1	1
FBgn0038003	50	68	40	50	90	118	TRUE	TRUE	FALSE	0	TRUE	TRUE	1	0
FBgn0038005	98	89	100	93	198	182	TRUE	TRUE	TRUE	1	TRUE	TRUE	1	1
FBgn0038006	135	127	109	109	244	236	TRUE	TRUE	TRUE	1	TRUE	TRUE	1	1
FBgn0038007	181	167	154	149	335	316	TRUE	TRUE	TRUE	1	TRUE	TRUE	1	1
FBgn0038008	160	185	143	136	303	321	TRUE	TRUE	TRUE	1	TRUE	TRUE	1	1
FBgn0038009	46	41	34	34	80	75	TRUE	TRUE	TRUE	1	TRUE	TRUE	1	1
FBgn0038011	201	190	175	195	376	385	TRUE	TRUE	TRUE	1	TRUE	TRUE	1	1
FBgn0038012	54	66	42	46	96	112	TRUE	TRUE	TRUE	1	TRUE	TRUE	1	1
FBgn0038013	131	150	123	123	254	273	TRUE	TRUE	TRUE	1	TRUE	TRUE	1	1
FBgn0038014	109	95	115	88	224	183	TRUE	FALSE	FALSE	0	TRUE	TRUE	1	0
FBgn0038016	186	238	176	186	362	424	FALSE	TRUE	FALSE	0	TRUE	TRUE	1	0
FBgn0038017	82	85	65	67	147	152	TRUE	TRUE	TRUE	1	TRUE	TRUE	1	1
FBgn0038018	50	62	40	35	90	97	TRUE	TRUE	TRUE	1	TRUE	TRUE	1	1
FBgn0038020	66	64	62	76	128	140	TRUE	TRUE	TRUE	1	TRUE	TRUE	1	1
FBgn0038028	173	181	136	129	309	310	TRUE	TRUE	TRUE	1	TRUE	TRUE	1	1
FBgn0038029	103	116	88	85	191	201	TRUE	TRUE	TRUE	1	TRUE	TRUE	1	1
FBgn0038034	169	140	117	122	286	262	TRUE	TRUE	TRUE	1	TRUE	TRUE	1	1
FBgn0038037	59	55	65	59	124	114	TRUE	TRUE	TRUE	1	TRUE	TRUE	1	1
FBgn0038038	120	100	76	80	196	180	TRUE	TRUE	TRUE	1	TRUE	TRUE	1	1
FBgn0038039	168	159	118	136	286	295	TRUE	TRUE	TRUE	1	TRUE	TRUE	1	1
FBgn0038042	48	69	55	60	103	129	FALSE	TRUE	TRUE	0	TRUE	TRUE	1	0
FBgn0038043	48	46	28	47	76	93	TRUE	FALSE	TRUE	0	TRUE	FALSE	0	0
FBgn0038045	100	93	60	66	160	159	TRUE	TRUE	TRUE	1	TRUE	TRUE	1	1
FBgn0038046	47	51	51	52	98	103	TRUE	TRUE	TRUE	1	TRUE	TRUE	1	1
FBgn0038047	72	74	65	72	137	146	TRUE	TRUE	TRUE	1	TRUE	TRUE	1	1
FBgn0038049	53	64	48	50	101	114	TRUE	TRUE	TRUE	1	TRUE	TRUE	1	1
FBgn0038053	106	101	85	84	191	185	TRUE	TRUE	TRUE	1	TRUE	TRUE	1	1
FBgn0038054	56	67	41	53	97	120	TRUE	TRUE	TRUE	1	TRUE	TRUE	1	1
FBgn0038055	66	71	51	56	117	127	TRUE	TRUE	TRUE	1	TRUE	TRUE	1	1
FBgn0038056	155	131	89	119	244	250	TRUE	FALSE	TRUE	0	TRUE	TRUE	1	0
FBgn0038057	28	26	17	23	45	49	TRUE	TRUE	TRUE	1	TRUE	TRUE	1	1
FBgn0038058	50	51	38	47	88	98	TRUE	TRUE	TRUE	1	TRUE	TRUE	1	1
FBgn0038063	475	491	413	453	888	944	TRUE	TRUE	TRUE	1	TRUE	TRUE	1	1
FBgn0038065	97	93	87	82	184	175	TRUE	TRUE	TRUE	1	TRUE	TRUE	1	1
FBgn0038067	48	43	43	38	91	81	TRUE	TRUE	TRUE	1	TRUE	TRUE	1	1
FBgn0038068	94	99	80	89	174	188	TRUE	TRUE	TRUE	1	TRUE	TRUE	1	1
FBgn0038069	108	107	94	83	202	190	TRUE	TRUE	TRUE	1	TRUE	TRUE	1	1
FBgn0038070	67	51	46	46	113	97	TRUE	TRUE	TRUE	1	TRUE	TRUE	1	1
FBgn0038071	204	199	168	180	372	379	TRUE	TRUE	TRUE	1	TRUE	TRUE	1	1
FBgn0038072	209	212	183	228	392	440	TRUE	FALSE	TRUE	0	TRUE	TRUE	1	0
FBgn0038073	389	349	294	297	683	646	TRUE	TRUE	TRUE	1	TRUE	TRUE	1	1
FBgn0038074	97	101	88	80	185	181	TRUE	TRUE	TRUE	1	TRUE	TRUE	1	1
FBgn0038076	105	127	82	93	187	220	TRUE	TRUE	TRUE	1	TRUE	TRUE	1	1
FBgn0038078	27	21	31	15	58	36	TRUE	FALSE	FALSE	0	TRUE	FALSE	0	0
FBgn0038079	116	118	106	100	222	218	TRUE	TRUE	TRUE	1	TRUE	TRUE	1	1
FBgn0038082	180	173	138	171	318	344	TRUE	FALSE	TRUE	0	TRUE	TRUE	1	0
FBgn0038083	141	132	101	119	242	251	TRUE	TRUE	TRUE	1	TRUE	TRUE	1	1
FBgn0038084	255	242	253	265	508	507	TRUE	TRUE	TRUE	1	TRUE	TRUE	1	1
FBgn0038087	207	205	201	181	408	386	TRUE	TRUE	TRUE	1	TRUE	TRUE	1	1
FBgn0038088	88	98	82	79	170	177	TRUE	TRUE	TRUE	1	TRUE	TRUE	1	1
FBgn0038089	36	27	28	25	64	52	TRUE	TRUE	TRUE	1	TRUE	TRUE	1	1
FBgn0038090	98	113	110	80	208	193	TRUE	FALSE	TRUE	0	TRUE	TRUE	1	0
FBgn0038092	175	168	151	156	326	324	TRUE	TRUE	TRUE	1	TRUE	TRUE	1	1
FBgn0038095	132	122	102	109	234	231	TRUE	TRUE	TRUE	1	TRUE	TRUE	1	1
FBgn0038098	243	247	217	173	460	420	TRUE	FALSE	TRUE	0	TRUE	TRUE	1	0
FBgn0038099	121	110	92	98	213	208	TRUE	TRUE	TRUE	1	TRUE	TRUE	1	1
FBgn0038100	132	135	114	116	246	251	TRUE	TRUE	TRUE	1	TRUE	TRUE	1	1
FBgn0038102	43	41	47	42	90	83	TRUE	TRUE	TRUE	1	TRUE	TRUE	1	1
FBgn0038105	104	92	79	76	183	168	TRUE	TRUE	TRUE	1	TRUE	TRUE	1	1
FBgn0038106	43	28	26	21	69	49	FALSE	TRUE	FALSE	0	FALSE	TRUE	0	0
FBgn0038108	342	312	244	240	586	552	TRUE	TRUE	TRUE	1	TRUE	TRUE	1	1
FBgn0038109	33	22	20	17	53	39	TRUE	TRUE	TRUE	1	TRUE	TRUE	1	1
FBgn0038110	64	60	42	60	106	120	TRUE	FALSE	TRUE	0	TRUE	TRUE	1	0
FBgn0038113	72	61	40	51	112	112	TRUE	TRUE	TRUE	1	TRUE	TRUE	1	1
FBgn0038114	124	128	120	112	244	240	TRUE	TRUE	TRUE	1	TRUE	TRUE	1	1
FBgn0038115	79	85	64	66	143	151	TRUE	TRUE	TRUE	1	TRUE	TRUE	1	1
FBgn0038118	168	186	135	144	303	330	TRUE	TRUE	TRUE	1	TRUE	TRUE	1	1
FBgn0038122	37	67	54	48	91	115	FALSE	TRUE	TRUE	0	FALSE	TRUE	0	0
FBgn0038123	116	131	82	99	198	230	TRUE	TRUE	TRUE	1	TRUE	TRUE	1	1
FBgn0038124	57	46	61	52	118	98	TRUE	TRUE	TRUE	1	TRUE	TRUE	1	1
FBgn0038125	119	112	97	77	216	189	TRUE	TRUE	TRUE	1	TRUE	TRUE	1	1
FBgn0038126	166	188	165	161	331	349	TRUE	TRUE	TRUE	1	TRUE	TRUE	1	1
FBgn0038127	57	71	60	54	117	125	TRUE	TRUE	TRUE	1	TRUE	TRUE	1	1
FBgn0038128	40	43	30	14	70	57	TRUE	FALSE	TRUE	0	TRUE	FALSE	0	0
FBgn0038129	32	29	29	20	61	49	TRUE	TRUE	TRUE	1	TRUE	TRUE	1	1
FBgn0038130	148	157	130	120	278	277	TRUE	TRUE	TRUE	1	TRUE	TRUE	1	1
FBgn0038131	76	70	65	68	141	138	TRUE	TRUE	TRUE	1	TRUE	TRUE	1	1
FBgn0038132	103	98	86	98	189	196	TRUE	TRUE	TRUE	1	TRUE	TRUE	1	1
FBgn0038133	53	45	46	60	99	105	TRUE	TRUE	TRUE	1	TRUE	TRUE	1	1
FBgn0038134	46	41	40	35	86	76	TRUE	TRUE	TRUE	1	TRUE	TRUE	1	1
FBgn0038135	209	187	154	152	363	339	TRUE	TRUE	TRUE	1	TRUE	TRUE	1	1
FBgn0038136	63	97	67	65	130	162	FALSE	TRUE	FALSE	0	FALSE	TRUE	0	0
FBgn0038139	261	271	224	241	485	512	TRUE	TRUE	TRUE	1	TRUE	TRUE	1	1
FBgn0038140	129	99	89	91	218	190	FALSE	TRUE	TRUE	0	TRUE	TRUE	1	0
FBgn0038143	57	46	42	41	99	87	TRUE	TRUE	TRUE	1	TRUE	TRUE	1	1
FBgn0038144	44	49	32	29	76	78	TRUE	TRUE	TRUE	1	TRUE	TRUE	1	1
FBgn0038145	54	41	23	33	77	74	TRUE	TRUE	TRUE	1	TRUE	TRUE	1	1
FBgn0038147	36	60	35	35	71	95	FALSE	TRUE	FALSE	0	FALSE	TRUE	0	0
FBgn0038148	50	44	36	41	86	85	TRUE	TRUE	TRUE	1	TRUE	TRUE	1	1
FBgn0038149	77	101	74	63	151	164	FALSE	TRUE	TRUE	0	TRUE	TRUE	1	0
FBgn0038150	112	97	74	79	186	176	TRUE	TRUE	TRUE	1	TRUE	TRUE	1	1
FBgn0038151	71	69	75	41	146	110	TRUE	FALSE	FALSE	0	TRUE	FALSE	0	0
FBgn0038157	28	24	25	20	53	44	TRUE	TRUE	TRUE	1	TRUE	TRUE	1	1
FBgn0038158	92	73	60	79	152	152	TRUE	TRUE	TRUE	1	TRUE	TRUE	1	1
FBgn0038159	43	46	39	29	82	75	TRUE	TRUE	TRUE	1	TRUE	TRUE	1	1
FBgn0038160	140	177	129	126	269	303	FALSE	TRUE	TRUE	0	TRUE	TRUE	1	0
FBgn0038161	15	22	13	18	28	40	TRUE	TRUE	TRUE	1	TRUE	TRUE	1	1
FBgn0038163	144	167	132	120	276	287	TRUE	TRUE	TRUE	1	TRUE	TRUE	1	1
FBgn0038165	307	287	256	239	563	526	TRUE	TRUE	TRUE	1	TRUE	TRUE	1	1
FBgn0038166	23	39	30	35	53	74	FALSE	TRUE	FALSE	0	FALSE	TRUE	0	0
FBgn0038167	104	100	71	72	175	172	TRUE	TRUE	TRUE	1	TRUE	TRUE	1	1
FBgn0038168	115	115	89	70	204	185	TRUE	TRUE	TRUE	1	TRUE	TRUE	1	1
FBgn0038170	43	48	44	43	87	91	TRUE	TRUE	TRUE	1	TRUE	TRUE	1	1
FBgn0038172	114	97	76	77	190	174	TRUE	TRUE	TRUE	1	TRUE	TRUE	1	1
FBgn0038173	116	111	135	98	251	209	TRUE	FALSE	FALSE	0	TRUE	TRUE	1	0
FBgn0038179	83	71	81	76	164	147	TRUE	TRUE	TRUE	1	TRUE	TRUE	1	1
FBgn0038180	149	158	105	117	254	275	TRUE	TRUE	TRUE	1	TRUE	TRUE	1	1
FBgn0038181	427	438	353	338	780	776	TRUE	TRUE	TRUE	1	TRUE	TRUE	1	1
FBgn0038183	91	92	103	86	194	178	TRUE	TRUE	TRUE	1	TRUE	TRUE	1	1
FBgn0038186	83	69	54	54	137	123	TRUE	TRUE	TRUE	1	TRUE	TRUE	1	1
FBgn0038189	97	108	87	110	184	218	TRUE	TRUE	FALSE	0	TRUE	TRUE	1	0
FBgn0038190	116	114	98	89	214	203	TRUE	TRUE	TRUE	1	TRUE	TRUE	1	1
FBgn0038191	126	141	116	119	242	260	TRUE	TRUE	TRUE	1	TRUE	TRUE	1	1
FBgn0038194	138	108	116	130	254	238	FALSE	TRUE	TRUE	0	TRUE	TRUE	1	0
FBgn0038195	110	108	103	105	213	213	TRUE	TRUE	TRUE	1	TRUE	TRUE	1	1
FBgn0038196	139	111	96	103	235	214	FALSE	TRUE	TRUE	0	TRUE	TRUE	1	0
FBgn0038197	322	343	274	300	596	643	TRUE	TRUE	TRUE	1	TRUE	TRUE	1	1
FBgn0038198	96	82	50	61	146	143	TRUE	TRUE	TRUE	1	TRUE	TRUE	1	1
FBgn0038199	59	56	45	41	104	97	TRUE	TRUE	TRUE	1	TRUE	TRUE	1	1
FBgn0038201	153	168	142	140	295	308	TRUE	TRUE	TRUE	1	TRUE	TRUE	1	1
FBgn0038202	166	141	132	115	298	256	TRUE	TRUE	FALSE	0	TRUE	TRUE	1	0
FBgn0038204	107	96	104	114	211	210	TRUE	TRUE	TRUE	1	TRUE	TRUE	1	1
FBgn0038205	144	127	119	130	263	257	TRUE	TRUE	TRUE	1	TRUE	TRUE	1	1
FBgn0038206	98	78	73	66	171	144	TRUE	TRUE	TRUE	1	TRUE	TRUE	1	1
FBgn0038207	96	91	91	77	187	168	TRUE	TRUE	TRUE	1	TRUE	TRUE	1	1
FBgn0038208	187	203	155	159	342	362	TRUE	TRUE	TRUE	1	TRUE	TRUE	1	1
FBgn0038209	109	88	83	81	192	169	TRUE	TRUE	TRUE	1	TRUE	TRUE	1	1
FBgn0038210	78	83	73	68	151	151	TRUE	TRUE	TRUE	1	TRUE	TRUE	1	1
FBgn0038211	138	122	105	117	243	239	TRUE	TRUE	TRUE	1	TRUE	TRUE	1	1
FBgn0038213	99	124	108	100	207	224	TRUE	TRUE	TRUE	1	TRUE	TRUE	1	1
FBgn0038214	31	43	26	41	57	84	TRUE	FALSE	FALSE	0	TRUE	FALSE	0	0
FBgn0038218	59	66	41	40	100	106	TRUE	TRUE	TRUE	1	TRUE	TRUE	1	1
FBgn0038219	41	35	37	28	78	63	TRUE	TRUE	TRUE	1	TRUE	TRUE	1	1
FBgn0038221	134	163	130	113	264	276	TRUE	TRUE	TRUE	1	TRUE	TRUE	1	1
FBgn0038223	299	268	225	290	524	558	TRUE	FALSE	TRUE	0	TRUE	TRUE	1	0
FBgn0038224	87	66	87	63	174	129	TRUE	FALSE	FALSE	0	TRUE	TRUE	1	0
FBgn0038225	48	51	30	37	78	88	TRUE	TRUE	TRUE	1	TRUE	TRUE	1	1
FBgn0038233	97	98	79	82	176	180	TRUE	TRUE	TRUE	1	TRUE	TRUE	1	1
FBgn0038234	39	53	34	29	73	82	TRUE	TRUE	TRUE	1	TRUE	TRUE	1	1
FBgn0038237	120	145	102	125	222	270	TRUE	TRUE	FALSE	0	TRUE	TRUE	1	0
FBgn0038239	21	38	23	32	44	70	FALSE	TRUE	FALSE	0	FALSE	TRUE	0	0
FBgn0038240	33	27	19	21	52	48	TRUE	TRUE	TRUE	1	TRUE	TRUE	1	1
FBgn0038243	95	94	83	69	178	163	TRUE	TRUE	TRUE	1	TRUE	TRUE	1	1
FBgn0038244	274	217	227	198	501	415	FALSE	TRUE	FALSE	0	TRUE	TRUE	1	0
FBgn0038246	119	90	95	91	214	181	FALSE	TRUE	TRUE	0	TRUE	TRUE	1	0
FBgn0038247	476	473	405	418	881	891	TRUE	TRUE	TRUE	1	TRUE	TRUE	1	1
FBgn0038248	171	186	144	137	315	323	TRUE	TRUE	TRUE	1	TRUE	TRUE	1	1
FBgn0038250	21	16	20	15	41	31	TRUE	TRUE	TRUE	1	TRUE	TRUE	1	1
FBgn0038256	126	153	144	122	270	275	TRUE	TRUE	TRUE	1	TRUE	TRUE	1	1
FBgn0038257	216	246	173	190	389	436	TRUE	TRUE	TRUE	1	TRUE	TRUE	1	1
FBgn0038258	259	281	248	239	507	520	TRUE	TRUE	TRUE	1	TRUE	TRUE	1	1
FBgn0038260	171	166	147	118	318	284	TRUE	FALSE	TRUE	0	TRUE	TRUE	1	0
FBgn0038261	154	172	138	115	292	287	TRUE	TRUE	TRUE	1	TRUE	TRUE	1	1
FBgn0038262	184	171	144	159	328	330	TRUE	TRUE	TRUE	1	TRUE	TRUE	1	1
FBgn0038269	78	68	63	53	141	121	TRUE	TRUE	TRUE	1	TRUE	TRUE	1	1
FBgn0038277	31	52	26	29	57	81	FALSE	TRUE	FALSE	0	FALSE	TRUE	0	0
FBgn0038279	60	53	65	54	125	107	TRUE	TRUE	TRUE	1	TRUE	TRUE	1	1
FBgn0038280	65	84	70	62	135	146	TRUE	TRUE	TRUE	1	TRUE	TRUE	1	1
FBgn0038281	62	67	46	55	108	122	TRUE	TRUE	TRUE	1	TRUE	TRUE	1	1
FBgn0038282	283	273	237	228	520	501	TRUE	TRUE	TRUE	1	TRUE	TRUE	1	1
FBgn0038285	49	56	31	30	80	86	TRUE	TRUE	TRUE	1	TRUE	TRUE	1	1
FBgn0038286	130	111	73	92	203	203	TRUE	TRUE	TRUE	1	TRUE	TRUE	1	1
FBgn0038290	90	101	88	94	178	195	TRUE	TRUE	TRUE	1	TRUE	TRUE	1	1
FBgn0038292	62	95	52	55	114	150	FALSE	TRUE	FALSE	0	FALSE	TRUE	0	0
FBgn0038294	425	437	339	330	764	767	TRUE	TRUE	TRUE	1	TRUE	TRUE	1	1
FBgn0038295	167	151	121	124	288	275	TRUE	TRUE	TRUE	1	TRUE	TRUE	1	1
FBgn0038299	47	70	51	41	98	111	FALSE	TRUE	TRUE	0	TRUE	TRUE	1	0
FBgn0038300	32	35	37	30	69	65	TRUE	TRUE	TRUE	1	TRUE	TRUE	1	1
FBgn0038302	21	32	23	16	44	48	TRUE	TRUE	TRUE	1	FALSE	TRUE	0	0
FBgn0038303	86	87	65	58	151	145	TRUE	TRUE	TRUE	1	TRUE	TRUE	1	1
FBgn0038309	57	58	53	38	110	96	TRUE	TRUE	TRUE	1	TRUE	TRUE	1	1
FBgn0038316	54	49	33	44	87	93	TRUE	TRUE	TRUE	1	TRUE	TRUE	1	1
FBgn0038320	136	103	108	85	244	188	FALSE	TRUE	FALSE	0	TRUE	TRUE	1	0
FBgn0038324	70	57	44	41	114	98	TRUE	TRUE	TRUE	1	TRUE	TRUE	1	1
FBgn0038325	59	59	62	49	121	108	TRUE	TRUE	TRUE	1	TRUE	TRUE	1	1
FBgn0038326	22	25	19	31	41	56	TRUE	TRUE	TRUE	1	TRUE	FALSE	0	0
FBgn0038330	102	102	71	86	173	188	TRUE	TRUE	TRUE	1	TRUE	TRUE	1	1
FBgn0038331	50	51	46	51	96	102	TRUE	TRUE	TRUE	1	TRUE	TRUE	1	1
FBgn0038334	43	47	34	18	77	65	TRUE	FALSE	TRUE	0	TRUE	FALSE	0	0
FBgn0038337	125	105	97	95	222	200	TRUE	TRUE	TRUE	1	TRUE	TRUE	1	1
FBgn0038339	275	265	204	196	479	461	TRUE	TRUE	TRUE	1	TRUE	TRUE	1	1
FBgn0038342	82	80	82	78	164	158	TRUE	TRUE	TRUE	1	TRUE	TRUE	1	1
FBgn0038343	29	30	33	29	62	59	TRUE	TRUE	TRUE	1	TRUE	TRUE	1	1
FBgn0038344	200	210	207	185	407	395	TRUE	TRUE	TRUE	1	TRUE	TRUE	1	1
FBgn0038345	20	29	18	23	38	52	TRUE	TRUE	TRUE	1	TRUE	TRUE	1	1
FBgn0038348	304	290	241	234	545	524	TRUE	TRUE	TRUE	1	TRUE	TRUE	1	1
FBgn0038349	278	304	272	263	550	567	TRUE	TRUE	TRUE	1	TRUE	TRUE	1	1
FBgn0038350	191	180	162	140	353	320	TRUE	TRUE	TRUE	1	TRUE	TRUE	1	1
FBgn0038353	29	31	27	26	56	57	TRUE	TRUE	TRUE	1	TRUE	TRUE	1	1
FBgn0038354	194	220	205	164	399	384	TRUE	FALSE	TRUE	0	TRUE	TRUE	1	0
FBgn0038355	80	75	55	65	135	140	TRUE	TRUE	TRUE	1	TRUE	TRUE	1	1
FBgn0038356	31	44	26	34	57	78	TRUE	TRUE	FALSE	0	TRUE	TRUE	1	0
FBgn0038357	74	50	79	75	153	125	FALSE	TRUE	TRUE	0	TRUE	TRUE	1	0
FBgn0038358	122	106	110	92	232	198	TRUE	TRUE	TRUE	1	TRUE	TRUE	1	1
FBgn0038359	99	126	98	105	197	231	FALSE	TRUE	TRUE	0	TRUE	TRUE	1	0
FBgn0038360	89	71	75	60	164	131	TRUE	TRUE	FALSE	0	TRUE	TRUE	1	0
FBgn0038361	76	55	42	45	118	100	FALSE	TRUE	TRUE	0	TRUE	TRUE	1	0
FBgn0038366	123	142	95	94	218	236	TRUE	TRUE	TRUE	1	TRUE	TRUE	1	1
FBgn0038369	17	22	16	25	33	47	TRUE	TRUE	TRUE	1	TRUE	FALSE	0	0
FBgn0038371	12	19	16	15	28	34	TRUE	TRUE	TRUE	1	FALSE	TRUE	0	0
FBgn0038373	16	28	27	23	43	51	FALSE	TRUE	TRUE	0	FALSE	TRUE	0	0
FBgn0038376	42	27	37	32	79	59	FALSE	TRUE	TRUE	0	FALSE	TRUE	0	0
FBgn0038377	41	58	54	45	95	103	TRUE	TRUE	TRUE	1	TRUE	TRUE	1	1
FBgn0038380	77	81	104	79	181	160	TRUE	FALSE	TRUE	0	TRUE	TRUE	1	0
FBgn0038381	87	76	77	63	164	139	TRUE	TRUE	TRUE	1	TRUE	TRUE	1	1
FBgn0038385	135	108	97	79	232	187	FALSE	TRUE	FALSE	0	TRUE	TRUE	1	0
FBgn0038386	54	45	35	33	89	78	TRUE	TRUE	TRUE	1	TRUE	TRUE	1	1
FBgn0038387	65	61	47	42	112	103	TRUE	TRUE	TRUE	1	TRUE	TRUE	1	1
FBgn0038388	109	110	90	76	199	186	TRUE	TRUE	TRUE	1	TRUE	TRUE	1	1
FBgn0038389	24	29	24	13	48	42	TRUE	FALSE	TRUE	0	TRUE	FALSE	0	0
FBgn0038390	149	178	136	127	285	305	TRUE	TRUE	TRUE	1	TRUE	TRUE	1	1
FBgn0038391	121	144	97	108	218	252	TRUE	TRUE	TRUE	1	TRUE	TRUE	1	1
FBgn0038394	32	39	38	25	70	64	TRUE	TRUE	TRUE	1	TRUE	FALSE	0	0
FBgn0038395	52	43	49	44	101	87	TRUE	TRUE	TRUE	1	TRUE	TRUE	1	1
FBgn0038396	31	34	22	18	53	52	TRUE	TRUE	TRUE	1	TRUE	TRUE	1	1
FBgn0038397	362	335	259	258	621	593	TRUE	TRUE	TRUE	1	TRUE	TRUE	1	1
FBgn0038398	103	104	100	101	203	205	TRUE	TRUE	TRUE	1	TRUE	TRUE	1	1
FBgn0038400	85	62	72	87	157	149	FALSE	TRUE	TRUE	0	TRUE	TRUE	1	0
FBgn0038401	132	113	116	115	248	228	TRUE	TRUE	TRUE	1	TRUE	TRUE	1	1
FBgn0038402	104	105	72	79	176	184	TRUE	TRUE	TRUE	1	TRUE	TRUE	1	1
FBgn0038404	230	247	188	199	418	446	TRUE	TRUE	TRUE	1	TRUE	TRUE	1	1
FBgn0038405	100	101	100	111	200	212	TRUE	TRUE	TRUE	1	TRUE	TRUE	1	1
FBgn0038407	232	220	202	191	434	411	TRUE	TRUE	TRUE	1	TRUE	TRUE	1	1
FBgn0038412	129	135	121	114	250	249	TRUE	TRUE	TRUE	1	TRUE	TRUE	1	1
FBgn0038414	118	110	79	105	197	215	TRUE	FALSE	TRUE	0	TRUE	TRUE	1	0
FBgn0038415	127	117	102	111	229	228	TRUE	TRUE	TRUE	1	TRUE	TRUE	1	1
FBgn0038416	65	79	49	73	114	152	TRUE	FALSE	FALSE	0	TRUE	TRUE	1	0
FBgn0038418	173	183	176	116	349	299	TRUE	FALSE	FALSE	0	TRUE	FALSE	0	0
FBgn0038419	141	147	141	136	282	283	TRUE	TRUE	TRUE	1	TRUE	TRUE	1	1
FBgn0038420	74	51	63	61	137	112	FALSE	TRUE	TRUE	0	TRUE	TRUE	1	0
FBgn0038421	45	56	38	22	83	78	TRUE	FALSE	TRUE	0	TRUE	FALSE	0	0
FBgn0038422	239	203	171	185	410	388	FALSE	TRUE	TRUE	0	TRUE	TRUE	1	0
FBgn0038423	105	130	109	136	214	266	TRUE	FALSE	FALSE	0	TRUE	TRUE	1	0
FBgn0038424	97	90	79	90	176	180	TRUE	TRUE	TRUE	1	TRUE	TRUE	1	1
FBgn0038425	99	98	84	64	183	162	TRUE	TRUE	TRUE	1	TRUE	TRUE	1	1
FBgn0038426	41	40	32	31	73	71	TRUE	TRUE	TRUE	1	TRUE	TRUE	1	1
FBgn0038427	272	271	238	217	510	488	TRUE	TRUE	TRUE	1	TRUE	TRUE	1	1
FBgn0038428	58	58	53	47	111	105	TRUE	TRUE	TRUE	1	TRUE	TRUE	1	1
FBgn0038429	102	120	71	84	173	204	TRUE	TRUE	TRUE	1	TRUE	TRUE	1	1
FBgn0038431	90	110	96	81	186	191	TRUE	TRUE	TRUE	1	TRUE	TRUE	1	1
FBgn0038432	43	55	39	45	82	100	TRUE	TRUE	TRUE	1	TRUE	TRUE	1	1
FBgn0038437	34	52	31	49	65	101	FALSE	FALSE	FALSE	0	FALSE	FALSE	0	0
FBgn0038438	90	128	72	80	162	208	FALSE	TRUE	FALSE	0	TRUE	TRUE	1	0
FBgn0038439	668	623	565	500	1233	1123	TRUE	FALSE	FALSE	0	TRUE	TRUE	1	0
FBgn0038440	79	79	53	56	132	135	TRUE	TRUE	TRUE	1	TRUE	TRUE	1	1
FBgn0038445	54	56	29	40	83	96	TRUE	TRUE	TRUE	1	TRUE	TRUE	1	1
FBgn0038446	32	40	21	33	53	73	TRUE	TRUE	FALSE	0	TRUE	FALSE	0	0
FBgn0038447	163	188	155	161	318	349	TRUE	TRUE	TRUE	1	TRUE	TRUE	1	1
FBgn0038448	71	57	55	51	126	108	TRUE	TRUE	TRUE	1	TRUE	TRUE	1	1
FBgn0038449	80	80	71	64	151	144	TRUE	TRUE	TRUE	1	TRUE	TRUE	1	1
FBgn0038450	123	100	98	91	221	191	TRUE	TRUE	TRUE	1	TRUE	TRUE	1	1
FBgn0038451	140	146	131	116	271	262	TRUE	TRUE	TRUE	1	TRUE	TRUE	1	1
FBgn0038452	88	100	70	86	158	186	TRUE	TRUE	TRUE	1	TRUE	TRUE	1	1
FBgn0038453	105	86	79	71	184	157	TRUE	TRUE	TRUE	1	TRUE	TRUE	1	1
FBgn0038454	70	74	45	55	115	129	TRUE	TRUE	TRUE	1	TRUE	TRUE	1	1
FBgn0038455	30	28	24	24	54	52	TRUE	TRUE	TRUE	1	TRUE	TRUE	1	1
FBgn0038460	86	96	88	74	174	170	TRUE	TRUE	TRUE	1	TRUE	TRUE	1	1
FBgn0038461	26	52	21	49	47	101	FALSE	FALSE	FALSE	0	FALSE	FALSE	0	0
FBgn0038462	96	29	94	33	190	62	FALSE	FALSE	FALSE	0	FALSE	FALSE	0	0
FBgn0038463	69	69	49	43	118	112	TRUE	TRUE	TRUE	1	TRUE	TRUE	1	1
FBgn0038465	263	216	188	195	451	411	FALSE	TRUE	TRUE	0	TRUE	TRUE	1	0
FBgn0038466	147	163	119	113	266	276	TRUE	TRUE	TRUE	1	TRUE	TRUE	1	1
FBgn0038467	79	101	78	68	157	169	TRUE	TRUE	TRUE	1	TRUE	TRUE	1	1
FBgn0038469	88	83	85	71	173	154	TRUE	TRUE	TRUE	1	TRUE	TRUE	1	1
FBgn0038470	56	83	56	61	112	144	FALSE	TRUE	FALSE	0	TRUE	TRUE	1	0
FBgn0038473	93	81	92	69	185	150	TRUE	FALSE	FALSE	0	TRUE	TRUE	1	0
FBgn0038474	37	41	41	39	78	80	TRUE	TRUE	TRUE	1	TRUE	TRUE	1	1
FBgn0038475	252	241	187	201	439	442	TRUE	TRUE	TRUE	1	TRUE	TRUE	1	1
FBgn0038476	222	202	145	178	367	380	TRUE	FALSE	TRUE	0	TRUE	TRUE	1	0
FBgn0038478	170	155	119	132	289	287	TRUE	TRUE	TRUE	1	TRUE	TRUE	1	1
FBgn0038479	59	56	55	50	114	106	TRUE	TRUE	TRUE	1	TRUE	TRUE	1	1
FBgn0038481	114	130	96	84	210	214	TRUE	TRUE	TRUE	1	TRUE	TRUE	1	1
FBgn0038482	98	101	83	80	181	181	TRUE	TRUE	TRUE	1	TRUE	TRUE	1	1
FBgn0038484	81	108	88	92	169	200	FALSE	TRUE	TRUE	0	TRUE	TRUE	1	0
FBgn0038485	108	89	79	88	187	177	TRUE	TRUE	TRUE	1	TRUE	TRUE	1	1
FBgn0038486	156	152	145	118	301	270	TRUE	TRUE	TRUE	1	TRUE	TRUE	1	1
FBgn0038487	76	68	61	70	137	138	TRUE	TRUE	TRUE	1	TRUE	TRUE	1	1
FBgn0038488	288	280	251	247	539	527	TRUE	TRUE	TRUE	1	TRUE	TRUE	1	1
FBgn0038490	89	109	84	85	173	194	TRUE	TRUE	TRUE	1	TRUE	TRUE	1	1
FBgn0038491	110	106	79	69	189	175	TRUE	TRUE	TRUE	1	TRUE	TRUE	1	1
FBgn0038492	528	461	420	490	948	951	FALSE	FALSE	TRUE	0	TRUE	TRUE	1	0
FBgn0038494	203	178	159	183	362	361	TRUE	TRUE	TRUE	1	TRUE	TRUE	1	1
FBgn0038498	284	231	250	280	534	511	FALSE	TRUE	TRUE	0	TRUE	TRUE	1	0
FBgn0038499	255	274	209	193	464	467	TRUE	TRUE	TRUE	1	TRUE	TRUE	1	1
FBgn0038504	270	288	235	235	505	523	TRUE	TRUE	TRUE	1	TRUE	TRUE	1	1
FBgn0038505	133	209	111	151	244	360	FALSE	FALSE	FALSE	0	FALSE	TRUE	0	0
FBgn0038506	112	222	105	159	217	381	FALSE	FALSE	FALSE	0	FALSE	FALSE	0	0
FBgn0038507	120	220	81	218	201	438	FALSE	FALSE	FALSE	0	FALSE	FALSE	0	0
FBgn0038508	60	132	54	109	114	241	FALSE	FALSE	FALSE	0	FALSE	FALSE	0	0
FBgn0038509	41	48	53	35	94	83	TRUE	FALSE	TRUE	0	TRUE	FALSE	0	0
FBgn0038510	163	123	143	108	306	231	FALSE	FALSE	FALSE	0	TRUE	TRUE	1	0
FBgn0038511	301	325	256	274	557	599	TRUE	TRUE	TRUE	1	TRUE	TRUE	1	1
FBgn0038512	90	92	67	87	157	179	TRUE	TRUE	TRUE	1	TRUE	TRUE	1	1
FBgn0038515	145	156	148	134	293	290	TRUE	TRUE	TRUE	1	TRUE	TRUE	1	1
FBgn0038516	36	34	36	30	72	64	TRUE	TRUE	TRUE	1	TRUE	TRUE	1	1
FBgn0038519	69	95	83	81	152	176	FALSE	TRUE	TRUE	0	TRUE	TRUE	1	0
FBgn0038523	62	69	56	44	118	113	TRUE	TRUE	TRUE	1	TRUE	TRUE	1	1
FBgn0038524	173	197	167	157	340	354	TRUE	TRUE	TRUE	1	TRUE	TRUE	1	1
FBgn0038525	115	134	109	118	224	252	TRUE	TRUE	TRUE	1	TRUE	TRUE	1	1
FBgn0038526	127	121	118	123	245	244	TRUE	TRUE	TRUE	1	TRUE	TRUE	1	1
FBgn0038527	57	56	53	60	110	116	TRUE	TRUE	TRUE	1	TRUE	TRUE	1	1
FBgn0038528	39	41	22	37	61	78	TRUE	FALSE	TRUE	0	TRUE	FALSE	0	0
FBgn0038529	104	116	83	104	187	220	TRUE	TRUE	TRUE	1	TRUE	TRUE	1	1
FBgn0038530	77	100	80	81	157	181	FALSE	TRUE	TRUE	0	TRUE	TRUE	1	0
FBgn0038531	144	123	83	108	227	231	TRUE	FALSE	TRUE	0	TRUE	TRUE	1	0
FBgn0038532	459	419	327	344	786	763	TRUE	TRUE	TRUE	1	TRUE	TRUE	1	1
FBgn0038533	67	70	56	64	123	134	TRUE	TRUE	TRUE	1	TRUE	TRUE	1	1
FBgn0038535	261	271	226	237	487	508	TRUE	TRUE	TRUE	1	TRUE	TRUE	1	1
FBgn0038536	55	43	40	40	95	83	TRUE	TRUE	TRUE	1	TRUE	TRUE	1	1
FBgn0038539	76	72	60	48	136	120	TRUE	TRUE	TRUE	1	TRUE	TRUE	1	1
FBgn0038540	108	124	86	93	194	217	TRUE	TRUE	TRUE	1	TRUE	TRUE	1	1
FBgn0038541	320	288	264	248	584	536	TRUE	TRUE	TRUE	1	TRUE	TRUE	1	1
FBgn0038542	440	396	379	343	819	739	TRUE	TRUE	FALSE	0	TRUE	TRUE	1	0
FBgn0038545	110	115	74	81	184	196	TRUE	TRUE	TRUE	1	TRUE	TRUE	1	1
FBgn0038546	79	104	74	77	153	181	FALSE	TRUE	TRUE	0	TRUE	TRUE	1	0
FBgn0038547	154	146	140	119	294	265	TRUE	TRUE	TRUE	1	TRUE	TRUE	1	1
FBgn0038548	70	86	57	69	127	155	TRUE	TRUE	TRUE	1	TRUE	TRUE	1	1
FBgn0038549	124	96	102	83	226	179	FALSE	TRUE	FALSE	0	TRUE	TRUE	1	0
FBgn0038550	125	134	95	120	220	254	TRUE	TRUE	TRUE	1	TRUE	TRUE	1	1
FBgn0038551	135	131	93	99	228	230	TRUE	TRUE	TRUE	1	TRUE	TRUE	1	1
FBgn0038552	124	133	106	112	230	245	TRUE	TRUE	TRUE	1	TRUE	TRUE	1	1
FBgn0038558	54	65	60	56	114	121	TRUE	TRUE	TRUE	1	TRUE	TRUE	1	1
FBgn0038564	157	152	139	148	296	300	TRUE	TRUE	TRUE	1	TRUE	TRUE	1	1
FBgn0038565	124	107	116	93	240	200	TRUE	TRUE	FALSE	0	TRUE	TRUE	1	0
FBgn0038566	119	132	99	76	218	208	TRUE	FALSE	TRUE	0	TRUE	TRUE	1	0
FBgn0038567	119	134	99	104	218	238	TRUE	TRUE	TRUE	1	TRUE	TRUE	1	1
FBgn0038569	142	140	98	100	240	240	TRUE	TRUE	TRUE	1	TRUE	TRUE	1	1
FBgn0038575	53	47	44	55	97	102	TRUE	TRUE	TRUE	1	TRUE	TRUE	1	1
FBgn0038576	47	46	44	35	91	81	TRUE	TRUE	TRUE	1	TRUE	TRUE	1	1
FBgn0038577	46	44	39	46	85	90	TRUE	TRUE	TRUE	1	TRUE	TRUE	1	1
FBgn0038578	140	141	138	112	278	253	TRUE	TRUE	TRUE	1	TRUE	TRUE	1	1
FBgn0038579	54	46	39	38	93	84	TRUE	TRUE	TRUE	1	TRUE	TRUE	1	1
FBgn0038581	137	119	108	120	245	239	TRUE	TRUE	TRUE	1	TRUE	TRUE	1	1
FBgn0038582	37	43	26	19	63	62	TRUE	TRUE	TRUE	1	TRUE	TRUE	1	1
FBgn0038583	121	102	107	78	228	180	TRUE	FALSE	FALSE	0	TRUE	TRUE	1	0
FBgn0038584	149	122	91	93	240	215	TRUE	TRUE	TRUE	1	TRUE	TRUE	1	1
FBgn0038585	42	49	24	41	66	90	TRUE	FALSE	FALSE	0	TRUE	FALSE	0	0
FBgn0038586	71	84	58	73	129	157	TRUE	TRUE	TRUE	1	TRUE	TRUE	1	1
FBgn0038588	210	213	174	157	384	370	TRUE	TRUE	TRUE	1	TRUE	TRUE	1	1
FBgn0038590	73	101	67	69	140	170	FALSE	TRUE	FALSE	0	TRUE	TRUE	1	0
FBgn0038592	129	125	101	90	230	215	TRUE	TRUE	TRUE	1	TRUE	TRUE	1	1
FBgn0038593	232	235	181	194	413	429	TRUE	TRUE	TRUE	1	TRUE	TRUE	1	1
FBgn0038595	119	108	72	77	191	185	TRUE	TRUE	TRUE	1	TRUE	TRUE	1	1
FBgn0038596	31	25	15	19	46	44	TRUE	TRUE	TRUE	1	TRUE	TRUE	1	1
FBgn0038597	242	235	175	200	417	435	TRUE	TRUE	TRUE	1	TRUE	TRUE	1	1
FBgn0038598	132	146	115	113	247	259	TRUE	TRUE	TRUE	1	TRUE	TRUE	1	1
FBgn0038601	213	124	139	78	352	202	FALSE	FALSE	FALSE	0	FALSE	FALSE	0	0
FBgn0038602	103	66	115	48	218	114	FALSE	FALSE	FALSE	0	FALSE	FALSE	0	0
FBgn0038603	399	435	322	318	721	753	TRUE	TRUE	TRUE	1	TRUE	TRUE	1	1
FBgn0038606	335	357	297	311	632	668	TRUE	TRUE	TRUE	1	TRUE	TRUE	1	1
FBgn0038607	146	108	122	137	268	245	FALSE	TRUE	TRUE	0	TRUE	TRUE	1	0
FBgn0038608	149	164	131	103	280	267	TRUE	FALSE	TRUE	0	TRUE	TRUE	1	0
FBgn0038609	101	86	80	83	181	169	TRUE	TRUE	TRUE	1	TRUE	TRUE	1	1
FBgn0038610	164	165	163	152	327	317	TRUE	TRUE	TRUE	1	TRUE	TRUE	1	1
FBgn0038611	243	263	245	230	488	493	TRUE	TRUE	TRUE	1	TRUE	TRUE	1	1
FBgn0038612	47	55	25	22	72	77	TRUE	TRUE	TRUE	1	TRUE	TRUE	1	1
FBgn0038613	237	207	142	165	379	372	TRUE	TRUE	TRUE	1	TRUE	TRUE	1	1
FBgn0038617	145	95	84	89	229	184	FALSE	TRUE	FALSE	0	FALSE	TRUE	0	0
FBgn0038619	69	85	66	86	135	171	TRUE	TRUE	FALSE	0	TRUE	TRUE	1	0
FBgn0038621	132	104	96	96	228	200	FALSE	TRUE	TRUE	0	TRUE	TRUE	1	0
FBgn0038626	87	125	79	77	166	202	FALSE	TRUE	FALSE	0	TRUE	TRUE	1	0
FBgn0038627	90	85	65	60	155	145	TRUE	TRUE	TRUE	1	TRUE	TRUE	1	1
FBgn0038629	391	367	313	319	704	686	TRUE	TRUE	TRUE	1	TRUE	TRUE	1	1
FBgn0038630	78	73	60	63	138	136	TRUE	TRUE	TRUE	1	TRUE	TRUE	1	1
FBgn0038631	85	108	69	92	154	200	TRUE	FALSE	FALSE	0	TRUE	TRUE	1	0
FBgn0038632	207	214	183	158	390	372	TRUE	TRUE	TRUE	1	TRUE	TRUE	1	1
FBgn0038638	171	178	122	112	293	290	TRUE	TRUE	TRUE	1	TRUE	TRUE	1	1
FBgn0038640	107	118	78	89	185	207	TRUE	TRUE	TRUE	1	TRUE	TRUE	1	1
FBgn0038641	85	86	68	62	153	148	TRUE	TRUE	TRUE	1	TRUE	TRUE	1	1
FBgn0038642	253	237	173	203	426	440	TRUE	TRUE	TRUE	1	TRUE	TRUE	1	1
FBgn0038643	38	36	32	38	70	74	TRUE	TRUE	TRUE	1	TRUE	TRUE	1	1
FBgn0038647	12	20	22	15	34	35	TRUE	TRUE	TRUE	1	FALSE	TRUE	0	0
FBgn0038649	94	125	80	90	174	215	FALSE	TRUE	FALSE	0	TRUE	TRUE	1	0
FBgn0038651	534	557	424	448	958	1005	TRUE	TRUE	TRUE	1	TRUE	TRUE	1	1
FBgn0038652	344	347	310	312	654	659	TRUE	TRUE	TRUE	1	TRUE	TRUE	1	1
FBgn0038653	558	577	446	449	1004	1026	TRUE	TRUE	TRUE	1	TRUE	TRUE	1	1
FBgn0038654	89	101	86	78	175	179	TRUE	TRUE	TRUE	1	TRUE	TRUE	1	1
FBgn0038655	90	91	80	98	170	189	TRUE	TRUE	TRUE	1	TRUE	TRUE	1	1
FBgn0038656	27	31	23	25	50	56	TRUE	TRUE	TRUE	1	TRUE	TRUE	1	1
FBgn0038658	71	80	66	50	137	130	TRUE	TRUE	TRUE	1	TRUE	TRUE	1	1
FBgn0038659	209	209	161	174	370	383	TRUE	TRUE	TRUE	1	TRUE	TRUE	1	1
FBgn0038660	186	206	185	168	371	374	TRUE	TRUE	TRUE	1	TRUE	TRUE	1	1
FBgn0038662	104	90	63	80	167	170	TRUE	TRUE	TRUE	1	TRUE	TRUE	1	1
FBgn0038665	43	39	38	33	81	72	TRUE	TRUE	TRUE	1	TRUE	TRUE	1	1
FBgn0038666	141	129	117	106	258	235	TRUE	TRUE	TRUE	1	TRUE	TRUE	1	1
FBgn0038672	92	100	82	90	174	190	TRUE	TRUE	TRUE	1	TRUE	TRUE	1	1
FBgn0038673	76	79	76	52	152	131	TRUE	FALSE	TRUE	0	TRUE	TRUE	1	0
FBgn0038674	77	68	68	65	145	133	TRUE	TRUE	TRUE	1	TRUE	TRUE	1	1
FBgn0038675	69	75	63	53	132	128	TRUE	TRUE	TRUE	1	TRUE	TRUE	1	1
FBgn0038676	409	429	316	359	725	788	TRUE	TRUE	TRUE	1	TRUE	TRUE	1	1
FBgn0038678	37	34	24	39	61	73	TRUE	FALSE	TRUE	0	TRUE	FALSE	0	0
FBgn0038679	640	705	558	563	1198	1268	FALSE	TRUE	TRUE	0	TRUE	TRUE	1	0
FBgn0038680	272	190	227	156	499	346	FALSE	FALSE	FALSE	0	TRUE	TRUE	1	0
FBgn0038681	188	88	160	70	348	158	FALSE	FALSE	FALSE	0	FALSE	FALSE	0	0
FBgn0038682	123	138	118	117	241	255	TRUE	TRUE	TRUE	1	TRUE	TRUE	1	1
FBgn0038683	210	212	208	204	418	416	TRUE	TRUE	TRUE	1	TRUE	TRUE	1	1
FBgn0038685	51	82	72	56	123	138	FALSE	TRUE	TRUE	0	FALSE	TRUE	0	0
FBgn0038686	107	127	87	82	194	209	TRUE	TRUE	TRUE	1	TRUE	TRUE	1	1
FBgn0038690	114	106	101	82	215	188	TRUE	TRUE	TRUE	1	TRUE	TRUE	1	1
FBgn0038691	47	49	54	43	101	92	TRUE	TRUE	TRUE	1	TRUE	TRUE	1	1
FBgn0038692	85	88	44	65	129	153	TRUE	FALSE	TRUE	0	TRUE	TRUE	1	0
FBgn0038693	831	870	682	670	1513	1540	TRUE	TRUE	TRUE	1	TRUE	TRUE	1	1
FBgn0038694	119	97	104	94	223	191	TRUE	TRUE	TRUE	1	TRUE	TRUE	1	1
FBgn0038695	245	248	200	244	445	492	TRUE	FALSE	TRUE	0	TRUE	TRUE	1	0
FBgn0038697	62	81	53	44	115	125	TRUE	TRUE	TRUE	1	TRUE	TRUE	1	1
FBgn0038700	179	180	151	143	330	323	TRUE	TRUE	TRUE	1	TRUE	TRUE	1	1
FBgn0038701	141	144	119	147	260	291	TRUE	FALSE	TRUE	0	TRUE	TRUE	1	0
FBgn0038702	136	150	118	100	254	250	TRUE	TRUE	TRUE	1	TRUE	TRUE	1	1
FBgn0038704	170	188	155	123	325	311	TRUE	FALSE	TRUE	0	TRUE	TRUE	1	0
FBgn0038705	154	158	145	147	299	305	TRUE	TRUE	TRUE	1	TRUE	TRUE	1	1
FBgn0038706	89	120	83	96	172	216	FALSE	TRUE	FALSE	0	TRUE	TRUE	1	0
FBgn0038708	104	90	79	83	183	173	TRUE	TRUE	TRUE	1	TRUE	TRUE	1	1
FBgn0038709	87	70	80	63	167	133	TRUE	TRUE	FALSE	0	TRUE	TRUE	1	0
FBgn0038714	134	149	107	115	241	264	TRUE	TRUE	TRUE	1	TRUE	TRUE	1	1
FBgn0038715	158	156	127	141	285	297	TRUE	TRUE	TRUE	1	TRUE	TRUE	1	1
FBgn0038716	275	290	259	234	534	524	TRUE	TRUE	TRUE	1	TRUE	TRUE	1	1
FBgn0038717	217	242	159	171	376	413	TRUE	TRUE	TRUE	1	TRUE	TRUE	1	1
FBgn0038718	207	233	166	207	373	440	TRUE	FALSE	FALSE	0	TRUE	TRUE	1	0
FBgn0038719	154	166	147	116	301	282	TRUE	FALSE	TRUE	0	TRUE	TRUE	1	0
FBgn0038720	403	389	376	328	779	717	TRUE	FALSE	TRUE	0	TRUE	TRUE	1	0
FBgn0038721	343	349	245	261	588	610	TRUE	TRUE	TRUE	1	TRUE	TRUE	1	1
FBgn0038723	56	50	46	39	102	89	TRUE	TRUE	TRUE	1	TRUE	TRUE	1	1
FBgn0038725	279	272	224	239	503	511	TRUE	TRUE	TRUE	1	TRUE	TRUE	1	1
FBgn0038727	184	183	157	152	341	335	TRUE	TRUE	TRUE	1	TRUE	TRUE	1	1
FBgn0038730	116	98	71	79	187	177	TRUE	TRUE	TRUE	1	TRUE	TRUE	1	1
FBgn0038731	120	114	94	104	214	218	TRUE	TRUE	TRUE	1	TRUE	TRUE	1	1
FBgn0038732	65	99	55	57	120	156	FALSE	TRUE	FALSE	0	FALSE	TRUE	0	0
FBgn0038733	176	163	144	128	320	291	TRUE	TRUE	TRUE	1	TRUE	TRUE	1	1
FBgn0038734	111	112	101	87	212	199	TRUE	TRUE	TRUE	1	TRUE	TRUE	1	1
FBgn0038735	295	308	217	237	512	545	TRUE	TRUE	TRUE	1	TRUE	TRUE	1	1
FBgn0038738	22	14	19	12	41	26	TRUE	TRUE	FALSE	0	FALSE	FALSE	0	0
FBgn0038739	71	52	40	50	111	102	TRUE	TRUE	TRUE	1	TRUE	TRUE	1	1
FBgn0038740	396	359	288	330	684	689	TRUE	FALSE	TRUE	0	TRUE	TRUE	1	0
FBgn0038741	146	137	111	136	257	273	TRUE	TRUE	TRUE	1	TRUE	TRUE	1	1
FBgn0038742	106	112	82	84	188	196	TRUE	TRUE	TRUE	1	TRUE	TRUE	1	1
FBgn0038744	203	179	168	155	371	334	TRUE	TRUE	TRUE	1	TRUE	TRUE	1	1
FBgn0038745	180	184	151	145	331	329	TRUE	TRUE	TRUE	1	TRUE	TRUE	1	1
FBgn0038747	280	265	291	251	571	516	TRUE	FALSE	TRUE	0	TRUE	TRUE	1	0
FBgn0038750	172	136	108	122	280	258	FALSE	TRUE	TRUE	0	TRUE	TRUE	1	0
FBgn0038751	193	204	177	140	370	344	TRUE	FALSE	TRUE	0	TRUE	TRUE	1	0
FBgn0038752	198	181	166	158	364	339	TRUE	TRUE	TRUE	1	TRUE	TRUE	1	1
FBgn0038753	155	168	116	108	271	276	TRUE	TRUE	TRUE	1	TRUE	TRUE	1	1
FBgn0038755	329	328	258	272	587	600	TRUE	TRUE	TRUE	1	TRUE	TRUE	1	1
FBgn0038760	131	175	113	143	244	318	FALSE	FALSE	FALSE	0	TRUE	TRUE	1	0
FBgn0038761	91	62	63	57	154	119	FALSE	TRUE	FALSE	0	TRUE	TRUE	1	0
FBgn0038763	103	136	93	93	196	229	FALSE	TRUE	TRUE	0	TRUE	TRUE	1	0
FBgn0038765	122	117	96	85	218	202	TRUE	TRUE	TRUE	1	TRUE	TRUE	1	1
FBgn0038766	66	78	61	66	127	144	TRUE	TRUE	TRUE	1	TRUE	TRUE	1	1
FBgn0038767	124	143	107	92	231	235	TRUE	TRUE	TRUE	1	TRUE	TRUE	1	1
FBgn0038768	130	99	111	105	241	204	FALSE	TRUE	FALSE	0	TRUE	TRUE	1	0
FBgn0038769	64	64	51	49	115	113	TRUE	TRUE	TRUE	1	TRUE	TRUE	1	1
FBgn0038771	70	65	73	59	143	124	TRUE	TRUE	TRUE	1	TRUE	TRUE	1	1
FBgn0038772	112	97	79	81	191	178	TRUE	TRUE	TRUE	1	TRUE	TRUE	1	1
FBgn0038773	111	133	123	120	234	253	TRUE	TRUE	TRUE	1	TRUE	TRUE	1	1
FBgn0038774	75	59	52	45	127	104	TRUE	TRUE	TRUE	1	TRUE	TRUE	1	1
FBgn0038775	151	128	107	99	258	227	TRUE	TRUE	TRUE	1	TRUE	TRUE	1	1
FBgn0038783	92	102	70	76	162	178	TRUE	TRUE	TRUE	1	TRUE	TRUE	1	1
FBgn0038784	90	79	81	65	171	144	TRUE	TRUE	TRUE	1	TRUE	TRUE	1	1
FBgn0038787	135	148	120	101	255	249	TRUE	TRUE	TRUE	1	TRUE	TRUE	1	1
FBgn0038788	96	77	77	74	173	151	TRUE	TRUE	TRUE	1	TRUE	TRUE	1	1
FBgn0038789	300	295	245	257	545	552	TRUE	TRUE	TRUE	1	TRUE	TRUE	1	1
FBgn0038790	31	27	26	26	57	53	TRUE	TRUE	TRUE	1	TRUE	TRUE	1	1
FBgn0038795	100	107	103	93	203	200	TRUE	TRUE	TRUE	1	TRUE	TRUE	1	1
FBgn0038796	73	69	39	58	112	127	TRUE	FALSE	TRUE	0	TRUE	TRUE	1	0
FBgn0038797	123	126	82	132	205	258	TRUE	FALSE	FALSE	0	TRUE	FALSE	0	0
FBgn0038798	111	113	104	107	215	220	TRUE	TRUE	TRUE	1	TRUE	TRUE	1	1
FBgn0038799	174	208	182	140	356	348	FALSE	FALSE	TRUE	0	TRUE	TRUE	1	0
FBgn0038803	251	224	203	210	454	434	TRUE	TRUE	TRUE	1	TRUE	TRUE	1	1
FBgn0038804	123	102	92	105	215	207	TRUE	TRUE	TRUE	1	TRUE	TRUE	1	1
FBgn0038805	112	116	98	93	210	209	TRUE	TRUE	TRUE	1	TRUE	TRUE	1	1
FBgn0038806	36	31	29	20	65	51	TRUE	TRUE	TRUE	1	TRUE	TRUE	1	1
FBgn0038809	119	131	114	122	233	253	TRUE	TRUE	TRUE	1	TRUE	TRUE	1	1
FBgn0038810	65	81	66	55	131	136	TRUE	TRUE	TRUE	1	TRUE	TRUE	1	1
FBgn0038811	96	100	85	67	181	167	TRUE	TRUE	TRUE	1	TRUE	TRUE	1	1
FBgn0038814	291	252	220	199	511	451	TRUE	TRUE	FALSE	0	TRUE	TRUE	1	0
FBgn0038815	163	141	106	111	269	252	TRUE	TRUE	TRUE	1	TRUE	TRUE	1	1
FBgn0038816	473	502	368	364	841	866	TRUE	TRUE	TRUE	1	TRUE	TRUE	1	1
FBgn0038818	289	272	223	240	512	512	TRUE	TRUE	TRUE	1	TRUE	TRUE	1	1
FBgn0038819	188	187	158	140	346	327	TRUE	TRUE	TRUE	1	TRUE	TRUE	1	1
FBgn0038820	44	57	44	42	88	99	TRUE	TRUE	TRUE	1	TRUE	TRUE	1	1
FBgn0038821	42	35	39	34	81	69	TRUE	TRUE	TRUE	1	TRUE	TRUE	1	1
FBgn0038826	611	597	510	516	1121	1113	TRUE	TRUE	TRUE	1	TRUE	TRUE	1	1
FBgn0038827	405	370	301	279	706	649	TRUE	TRUE	TRUE	1	TRUE	TRUE	1	1
FBgn0038828	176	175	116	121	292	296	TRUE	TRUE	TRUE	1	TRUE	TRUE	1	1
FBgn0038829	203	202	167	159	370	361	TRUE	TRUE	TRUE	1	TRUE	TRUE	1	1
FBgn0038830	21	16	13	19	34	35	TRUE	TRUE	TRUE	1	TRUE	TRUE	1	1
FBgn0038832	67	70	76	61	143	131	TRUE	TRUE	TRUE	1	TRUE	TRUE	1	1
FBgn0038837	288	256	262	254	550	510	TRUE	TRUE	TRUE	1	TRUE	TRUE	1	1
FBgn0038838	53	42	35	33	88	75	TRUE	TRUE	TRUE	1	TRUE	TRUE	1	1
FBgn0038839	117	107	92	107	209	214	TRUE	TRUE	TRUE	1	TRUE	TRUE	1	1
FBgn0038840	277	320	242	242	519	562	FALSE	TRUE	TRUE	0	TRUE	TRUE	1	0
FBgn0038842	291	269	219	205	510	474	TRUE	TRUE	TRUE	1	TRUE	TRUE	1	1
FBgn0038845	127	116	90	94	217	210	TRUE	TRUE	TRUE	1	TRUE	TRUE	1	1
FBgn0038846	93	80	71	38	164	118	TRUE	FALSE	FALSE	0	TRUE	FALSE	0	0
FBgn0038847	63	52	45	76	108	128	TRUE	FALSE	TRUE	0	TRUE	FALSE	0	0
FBgn0038849	153	135	118	133	271	268	TRUE	TRUE	TRUE	1	TRUE	TRUE	1	1
FBgn0038850	99	113	102	103	201	216	TRUE	TRUE	TRUE	1	TRUE	TRUE	1	1
FBgn0038851	159	143	114	134	273	277	TRUE	TRUE	TRUE	1	TRUE	TRUE	1	1
FBgn0038852	109	111	85	97	194	208	TRUE	TRUE	TRUE	1	TRUE	TRUE	1	1
FBgn0038853	519	456	417	410	936	866	FALSE	TRUE	TRUE	0	TRUE	TRUE	1	0
FBgn0038854	241	199	176	217	417	416	FALSE	FALSE	TRUE	0	TRUE	TRUE	1	0
FBgn0038855	105	106	94	96	199	202	TRUE	TRUE	TRUE	1	TRUE	TRUE	1	1
FBgn0038857	51	50	51	53	102	103	TRUE	TRUE	TRUE	1	TRUE	TRUE	1	1
FBgn0038858	80	65	63	57	143	122	TRUE	TRUE	TRUE	1	TRUE	TRUE	1	1
FBgn0038860	212	208	165	165	377	373	TRUE	TRUE	TRUE	1	TRUE	TRUE	1	1
FBgn0038861	85	90	79	68	164	158	TRUE	TRUE	TRUE	1	TRUE	TRUE	1	1
FBgn0038862	204	232	173	164	377	396	TRUE	TRUE	TRUE	1	TRUE	TRUE	1	1
FBgn0038865	159	180	144	123	303	303	TRUE	TRUE	TRUE	1	TRUE	TRUE	1	1
FBgn0038866	110	126	103	131	213	257	TRUE	FALSE	FALSE	0	TRUE	TRUE	1	0
FBgn0038868	85	120	73	89	158	209	FALSE	TRUE	FALSE	0	TRUE	TRUE	1	0
FBgn0038869	93	86	85	62	178	148	TRUE	FALSE	TRUE	0	TRUE	TRUE	1	0
FBgn0038870	60	71	54	49	114	120	TRUE	TRUE	TRUE	1	TRUE	TRUE	1	1
FBgn0038871	38	28	19	30	57	58	TRUE	TRUE	TRUE	1	TRUE	FALSE	0	0
FBgn0038872	227	248	183	173	410	421	TRUE	TRUE	TRUE	1	TRUE	TRUE	1	1
FBgn0038873	224	201	179	161	403	362	TRUE	TRUE	TRUE	1	TRUE	TRUE	1	1
FBgn0038874	426	407	330	329	756	736	TRUE	TRUE	TRUE	1	TRUE	TRUE	1	1
FBgn0038876	30	35	28	23	58	58	TRUE	TRUE	TRUE	1	TRUE	TRUE	1	1
FBgn0038877	97	100	63	76	160	176	TRUE	TRUE	TRUE	1	TRUE	TRUE	1	1
FBgn0038878	140	139	126	124	266	263	TRUE	TRUE	TRUE	1	TRUE	TRUE	1	1
FBgn0038879	64	57	45	44	109	101	TRUE	TRUE	TRUE	1	TRUE	TRUE	1	1
FBgn0038880	189	215	175	183	364	398	TRUE	TRUE	TRUE	1	TRUE	TRUE	1	1
FBgn0038881	450	524	408	392	858	916	FALSE	TRUE	TRUE	0	TRUE	TRUE	1	0
FBgn0038886	218	205	186	159	404	364	TRUE	TRUE	TRUE	1	TRUE	TRUE	1	1
FBgn0038887	186	174	157	128	343	302	TRUE	FALSE	TRUE	0	TRUE	TRUE	1	0
FBgn0038888	51	72	42	75	93	147	FALSE	FALSE	FALSE	0	TRUE	FALSE	0	0
FBgn0038889	332	301	308	291	640	592	TRUE	TRUE	TRUE	1	TRUE	TRUE	1	1
FBgn0038890	345	347	296	301	641	648	TRUE	TRUE	TRUE	1	TRUE	TRUE	1	1
FBgn0038892	149	139	130	110	279	249	TRUE	TRUE	TRUE	1	TRUE	TRUE	1	1
FBgn0038893	114	105	118	89	232	194	TRUE	FALSE	FALSE	0	TRUE	TRUE	1	0
FBgn0038894	131	139	131	118	262	257	TRUE	TRUE	TRUE	1	TRUE	TRUE	1	1
FBgn0038897	235	251	217	219	452	470	TRUE	TRUE	TRUE	1	TRUE	TRUE	1	1
FBgn0038901	55	62	43	40	98	102	TRUE	TRUE	TRUE	1	TRUE	TRUE	1	1
FBgn0038902	90	83	84	62	174	145	TRUE	FALSE	TRUE	0	TRUE	TRUE	1	0
FBgn0038903	31	39	42	36	73	75	TRUE	TRUE	TRUE	1	TRUE	TRUE	1	1
FBgn0038909	77	70	64	66	141	136	TRUE	TRUE	TRUE	1	TRUE	TRUE	1	1
FBgn0038912	183	168	133	144	316	312	TRUE	TRUE	TRUE	1	TRUE	TRUE	1	1
FBgn0038914	33	29	20	14	53	43	TRUE	TRUE	TRUE	1	TRUE	TRUE	1	1
FBgn0038915	65	72	59	57	124	129	TRUE	TRUE	TRUE	1	TRUE	TRUE	1	1
FBgn0038916	31	46	29	42	60	88	TRUE	TRUE	FALSE	0	TRUE	TRUE	1	0
FBgn0038917	218	225	171	202	389	427	TRUE	TRUE	TRUE	1	TRUE	TRUE	1	1
FBgn0038918	129	125	91	98	220	223	TRUE	TRUE	TRUE	1	TRUE	TRUE	1	1
FBgn0038919	145	145	128	129	273	274	TRUE	TRUE	TRUE	1	TRUE	TRUE	1	1
FBgn0038921	162	147	131	97	293	244	TRUE	FALSE	FALSE	0	TRUE	TRUE	1	0
FBgn0038922	177	195	147	161	324	356	TRUE	TRUE	TRUE	1	TRUE	TRUE	1	1
FBgn0038923	69	51	40	46	109	97	TRUE	TRUE	TRUE	1	TRUE	TRUE	1	1
FBgn0038924	38	48	37	28	75	76	TRUE	TRUE	TRUE	1	TRUE	TRUE	1	1
FBgn0038925	137	150	94	103	231	253	TRUE	TRUE	TRUE	1	TRUE	TRUE	1	1
FBgn0038926	194	218	111	142	305	360	TRUE	FALSE	FALSE	0	TRUE	TRUE	1	0
FBgn0038928	62	54	56	41	118	95	TRUE	TRUE	TRUE	1	TRUE	TRUE	1	1
FBgn0038929	129	135	135	142	264	277	TRUE	TRUE	TRUE	1	TRUE	TRUE	1	1
FBgn0038930	107	88	73	81	180	169	TRUE	TRUE	TRUE	1	TRUE	TRUE	1	1
FBgn0038931	143	152	123	105	266	257	TRUE	TRUE	TRUE	1	TRUE	TRUE	1	1
FBgn0038934	153	143	122	134	275	277	TRUE	TRUE	TRUE	1	TRUE	TRUE	1	1
FBgn0038938	280	274	264	249	544	523	TRUE	TRUE	TRUE	1	TRUE	TRUE	1	1
FBgn0038941	121	135	104	114	225	249	TRUE	TRUE	TRUE	1	TRUE	TRUE	1	1
FBgn0038942	70	74	56	50	126	124	TRUE	TRUE	TRUE	1	TRUE	TRUE	1	1
FBgn0038943	64	90	64	90	128	180	FALSE	FALSE	FALSE	0	TRUE	TRUE	1	0
FBgn0038944	48	54	63	56	111	110	TRUE	TRUE	TRUE	1	TRUE	TRUE	1	1
FBgn0038945	31	40	23	36	54	76	TRUE	TRUE	FALSE	0	TRUE	FALSE	0	0
FBgn0038946	166	180	101	133	267	313	TRUE	FALSE	FALSE	0	TRUE	TRUE	1	0
FBgn0038947	135	153	114	140	249	293	TRUE	TRUE	FALSE	0	TRUE	TRUE	1	0
FBgn0038948	112	101	82	75	194	176	TRUE	TRUE	TRUE	1	TRUE	TRUE	1	1
FBgn0038950	76	87	60	69	136	156	TRUE	TRUE	TRUE	1	TRUE	TRUE	1	1
FBgn0038951	131	114	109	100	240	214	TRUE	TRUE	TRUE	1	TRUE	TRUE	1	1
FBgn0038952	104	120	82	96	186	216	TRUE	TRUE	TRUE	1	TRUE	TRUE	1	1
FBgn0038953	350	331	243	270	593	601	TRUE	TRUE	TRUE	1	TRUE	TRUE	1	1
FBgn0038956	98	106	93	82	191	188	TRUE	TRUE	TRUE	1	TRUE	TRUE	1	1
FBgn0038957	47	49	40	52	87	101	TRUE	TRUE	TRUE	1	TRUE	TRUE	1	1
FBgn0038958	51	53	54	53	105	106	TRUE	TRUE	TRUE	1	TRUE	TRUE	1	1
FBgn0038959	72	87	59	59	131	146	TRUE	TRUE	TRUE	1	TRUE	TRUE	1	1
FBgn0038960	130	107	122	128	252	235	TRUE	TRUE	TRUE	1	TRUE	TRUE	1	1
FBgn0038961	145	181	123	133	268	314	FALSE	TRUE	FALSE	0	TRUE	TRUE	1	0
FBgn0038964	132	127	101	110	233	237	TRUE	TRUE	TRUE	1	TRUE	TRUE	1	1
FBgn0038965	91	82	79	75	170	157	TRUE	TRUE	TRUE	1	TRUE	TRUE	1	1
FBgn0038966	69	56	63	64	132	120	TRUE	TRUE	TRUE	1	TRUE	TRUE	1	1
FBgn0038967	248	250	190	178	438	428	TRUE	TRUE	TRUE	1	TRUE	TRUE	1	1
FBgn0038968	339	378	285	291	624	669	TRUE	TRUE	TRUE	1	TRUE	TRUE	1	1
FBgn0038972	73	81	61	64	134	145	TRUE	TRUE	TRUE	1	TRUE	TRUE	1	1
FBgn0038973	29	29	22	22	51	51	TRUE	TRUE	TRUE	1	TRUE	TRUE	1	1
FBgn0038974	100	136	92	88	192	224	FALSE	TRUE	TRUE	0	TRUE	TRUE	1	0
FBgn0038975	646	601	452	501	1098	1102	TRUE	TRUE	TRUE	1	TRUE	TRUE	1	1
FBgn0038977	36	68	39	40	75	108	FALSE	TRUE	FALSE	0	FALSE	TRUE	0	0
FBgn0038979	58	36	47	45	105	81	FALSE	TRUE	FALSE	0	FALSE	TRUE	0	0
FBgn0038980	520	520	456	440	976	960	TRUE	TRUE	TRUE	1	TRUE	TRUE	1	1
FBgn0038981	189	208	150	161	339	369	TRUE	TRUE	TRUE	1	TRUE	TRUE	1	1
FBgn0038983	176	176	155	130	331	306	TRUE	TRUE	TRUE	1	TRUE	TRUE	1	1
FBgn0038984	256	275	198	197	454	472	TRUE	TRUE	TRUE	1	TRUE	TRUE	1	1
FBgn0038986	172	201	143	129	315	330	TRUE	TRUE	TRUE	1	TRUE	TRUE	1	1
FBgn0038989	94	70	62	46	156	116	FALSE	TRUE	FALSE	0	TRUE	TRUE	1	0
FBgn0038993	43	60	37	45	80	105	TRUE	TRUE	FALSE	0	TRUE	TRUE	1	0
FBgn0039002	28	28	31	18	59	46	TRUE	FALSE	TRUE	0	TRUE	FALSE	0	0
FBgn0039003	23	30	36	18	59	48	TRUE	FALSE	TRUE	0	TRUE	FALSE	0	0
FBgn0039004	139	175	122	132	261	307	FALSE	TRUE	FALSE	0	TRUE	TRUE	1	0
FBgn0039006	200	208	147	165	347	373	TRUE	TRUE	TRUE	1	TRUE	TRUE	1	1
FBgn0039007	72	79	66	64	138	143	TRUE	TRUE	TRUE	1	TRUE	TRUE	1	1
FBgn0039008	139	126	119	110	258	236	TRUE	TRUE	TRUE	1	TRUE	TRUE	1	1
FBgn0039009	143	136	129	131	272	267	TRUE	TRUE	TRUE	1	TRUE	TRUE	1	1
FBgn0039010	159	173	143	145	302	318	TRUE	TRUE	TRUE	1	TRUE	TRUE	1	1
FBgn0039013	36	31	21	22	57	53	TRUE	TRUE	TRUE	1	TRUE	TRUE	1	1
FBgn0039015	69	68	59	56	128	124	TRUE	TRUE	TRUE	1	TRUE	TRUE	1	1
FBgn0039016	387	381	286	333	673	714	TRUE	FALSE	TRUE	0	TRUE	TRUE	1	0
FBgn0039017	62	66	73	53	135	119	TRUE	FALSE	TRUE	0	TRUE	TRUE	1	0
FBgn0039022	39	62	42	19	81	81	FALSE	FALSE	TRUE	0	FALSE	FALSE	0	0
FBgn0039023	119	138	122	124	241	262	TRUE	TRUE	TRUE	1	TRUE	TRUE	1	1
FBgn0039024	102	108	91	73	193	181	TRUE	TRUE	TRUE	1	TRUE	TRUE	1	1
FBgn0039025	52	43	51	36	103	79	TRUE	TRUE	FALSE	0	TRUE	TRUE	1	0
FBgn0039026	516	526	378	440	894	966	TRUE	FALSE	FALSE	0	TRUE	TRUE	1	0
FBgn0039027	75	47	57	43	132	90	FALSE	TRUE	FALSE	0	FALSE	TRUE	0	0
FBgn0039030	93	101	84	79	177	180	TRUE	TRUE	TRUE	1	TRUE	TRUE	1	1
FBgn0039031	65	69	60	56	125	125	TRUE	TRUE	TRUE	1	TRUE	TRUE	1	1
FBgn0039033	118	121	81	87	199	208	TRUE	TRUE	TRUE	1	TRUE	TRUE	1	1
FBgn0039034	116	126	72	93	188	219	TRUE	TRUE	TRUE	1	TRUE	TRUE	1	1
FBgn0039038	108	107	80	107	188	214	TRUE	FALSE	TRUE	0	TRUE	TRUE	1	0
FBgn0039039	319	263	270	258	589	521	FALSE	TRUE	FALSE	0	TRUE	TRUE	1	0
FBgn0039040	129	128	107	106	236	234	TRUE	TRUE	TRUE	1	TRUE	TRUE	1	1
FBgn0039041	46	54	60	39	106	93	TRUE	FALSE	TRUE	0	TRUE	FALSE	0	0
FBgn0039042	55	51	39	51	94	102	TRUE	TRUE	TRUE	1	TRUE	TRUE	1	1
FBgn0039043	146	154	145	128	291	282	TRUE	TRUE	TRUE	1	TRUE	TRUE	1	1
FBgn0039044	110	105	95	93	205	198	TRUE	TRUE	TRUE	1	TRUE	TRUE	1	1
FBgn0039048	282	278	228	214	510	492	TRUE	TRUE	TRUE	1	TRUE	TRUE	1	1
FBgn0039050	36	36	17	25	53	61	TRUE	TRUE	TRUE	1	TRUE	TRUE	1	1
FBgn0039051	164	133	131	143	295	276	FALSE	TRUE	TRUE	0	TRUE	TRUE	1	0
FBgn0039052	158	155	129	105	287	260	TRUE	TRUE	TRUE	1	TRUE	TRUE	1	1
FBgn0039053	137	138	125	116	262	254	TRUE	TRUE	TRUE	1	TRUE	TRUE	1	1
FBgn0039054	389	417	374	364	763	781	TRUE	TRUE	TRUE	1	TRUE	TRUE	1	1
FBgn0039055	220	202	200	155	420	357	TRUE	FALSE	FALSE	0	TRUE	TRUE	1	0
FBgn0039056	279	325	191	223	470	548	FALSE	TRUE	FALSE	0	TRUE	TRUE	1	0
FBgn0039058	122	129	104	106	226	235	TRUE	TRUE	TRUE	1	TRUE	TRUE	1	1
FBgn0039059	45	34	38	48	83	82	TRUE	TRUE	TRUE	1	TRUE	TRUE	1	1
FBgn0039064	733	684	550	614	1283	1298	TRUE	FALSE	TRUE	0	TRUE	TRUE	1	0
FBgn0039065	132	130	105	109	237	239	TRUE	TRUE	TRUE	1	TRUE	TRUE	1	1
FBgn0039066	239	257	202	182	441	439	TRUE	TRUE	TRUE	1	TRUE	TRUE	1	1
FBgn0039067	182	187	163	157	345	344	TRUE	TRUE	TRUE	1	TRUE	TRUE	1	1
FBgn0039068	111	117	105	74	216	191	TRUE	FALSE	TRUE	0	TRUE	TRUE	1	0
FBgn0039069	113	116	100	95	213	211	TRUE	TRUE	TRUE	1	TRUE	TRUE	1	1
FBgn0039070	150	143	111	109	261	252	TRUE	TRUE	TRUE	1	TRUE	TRUE	1	1
FBgn0039071	164	144	97	105	261	249	TRUE	TRUE	TRUE	1	TRUE	TRUE	1	1
FBgn0039073	131	133	123	114	254	247	TRUE	TRUE	TRUE	1	TRUE	TRUE	1	1
FBgn0039075	468	501	387	408	855	909	TRUE	TRUE	TRUE	1	TRUE	TRUE	1	1
FBgn0039077	35	36	29	36	64	72	TRUE	TRUE	TRUE	1	TRUE	TRUE	1	1
FBgn0039078	335	352	310	288	645	640	TRUE	TRUE	TRUE	1	TRUE	TRUE	1	1
FBgn0039079	167	155	140	123	307	278	TRUE	TRUE	TRUE	1	TRUE	TRUE	1	1
FBgn0039080	140	146	122	97	262	243	TRUE	TRUE	TRUE	1	TRUE	TRUE	1	1
FBgn0039081	225	218	164	175	389	393	TRUE	TRUE	TRUE	1	TRUE	TRUE	1	1
FBgn0039083	107	122	93	97	200	219	TRUE	TRUE	TRUE	1	TRUE	TRUE	1	1
FBgn0039084	171	190	137	141	308	331	TRUE	TRUE	TRUE	1	TRUE	TRUE	1	1
FBgn0039085	32	22	25	29	57	51	TRUE	TRUE	TRUE	1	TRUE	TRUE	1	1
FBgn0039087	88	114	85	97	173	211	FALSE	TRUE	FALSE	0	TRUE	TRUE	1	0
FBgn0039088	79	65	86	68	165	133	TRUE	TRUE	FALSE	0	TRUE	TRUE	1	0
FBgn0039089	154	170	137	135	291	305	TRUE	TRUE	TRUE	1	TRUE	TRUE	1	1
FBgn0039091	63	72	53	50	116	122	TRUE	TRUE	TRUE	1	TRUE	TRUE	1	1
FBgn0039092	61	69	50	54	111	123	TRUE	TRUE	TRUE	1	TRUE	TRUE	1	1
FBgn0039093	122	131	97	110	219	241	TRUE	TRUE	TRUE	1	TRUE	TRUE	1	1
FBgn0039098	39	49	44	29	83	78	TRUE	TRUE	TRUE	1	TRUE	FALSE	0	0
FBgn0039099	69	46	49	43	118	89	FALSE	TRUE	FALSE	0	TRUE	TRUE	1	0
FBgn0039101	48	54	36	38	84	92	TRUE	TRUE	TRUE	1	TRUE	TRUE	1	1
FBgn0039102	87	70	59	65	146	135	TRUE	TRUE	TRUE	1	TRUE	TRUE	1	1
FBgn0039104	27	30	20	27	47	57	TRUE	TRUE	TRUE	1	TRUE	TRUE	1	1
FBgn0039107	40	63	46	49	86	112	FALSE	TRUE	FALSE	0	FALSE	TRUE	0	0
FBgn0039108	169	184	180	173	349	357	TRUE	TRUE	TRUE	1	TRUE	TRUE	1	1
FBgn0039109	88	103	78	103	166	206	TRUE	FALSE	FALSE	0	TRUE	TRUE	1	0
FBgn0039110	119	116	96	88	215	204	TRUE	TRUE	TRUE	1	TRUE	TRUE	1	1
FBgn0039111	37	29	34	19	71	48	TRUE	FALSE	FALSE	0	TRUE	FALSE	0	0
FBgn0039112	52	54	39	41	91	95	TRUE	TRUE	TRUE	1	TRUE	TRUE	1	1
FBgn0039113	130	124	113	103	243	227	TRUE	TRUE	TRUE	1	TRUE	TRUE	1	1
FBgn0039114	148	149	130	132	278	281	TRUE	TRUE	TRUE	1	TRUE	TRUE	1	1
FBgn0039115	24	38	30	18	54	56	FALSE	TRUE	TRUE	0	FALSE	FALSE	0	0
FBgn0039116	32	40	30	29	62	69	TRUE	TRUE	TRUE	1	TRUE	TRUE	1	1
FBgn0039117	283	263	250	225	533	488	TRUE	TRUE	TRUE	1	TRUE	TRUE	1	1
FBgn0039118	73	44	47	44	120	88	FALSE	TRUE	FALSE	0	FALSE	TRUE	0	0
FBgn0039120	311	362	317	284	628	646	FALSE	TRUE	TRUE	0	TRUE	TRUE	1	0
FBgn0039124	79	82	48	48	127	130	TRUE	TRUE	TRUE	1	TRUE	TRUE	1	1
FBgn0039125	115	104	98	71	213	175	TRUE	FALSE	FALSE	0	TRUE	TRUE	1	0
FBgn0039126	65	69	50	41	115	110	TRUE	TRUE	TRUE	1	TRUE	TRUE	1	1
FBgn0039128	67	82	65	65	132	147	TRUE	TRUE	TRUE	1	TRUE	TRUE	1	1
FBgn0039129	55	38	47	51	102	89	FALSE	TRUE	TRUE	0	TRUE	TRUE	1	0
FBgn0039130	114	107	100	75	214	182	TRUE	FALSE	TRUE	0	TRUE	TRUE	1	0
FBgn0039131	184	194	147	171	331	365	TRUE	TRUE	TRUE	1	TRUE	TRUE	1	1
FBgn0039132	158	120	136	110	294	230	FALSE	TRUE	FALSE	0	TRUE	TRUE	1	0
FBgn0039135	115	125	80	74	195	199	TRUE	TRUE	TRUE	1	TRUE	TRUE	1	1
FBgn0039136	81	100	74	82	155	182	TRUE	TRUE	TRUE	1	TRUE	TRUE	1	1
FBgn0039137	246	213	180	193	426	406	TRUE	TRUE	TRUE	1	TRUE	TRUE	1	1
FBgn0039139	107	112	75	86	182	198	TRUE	TRUE	TRUE	1	TRUE	TRUE	1	1
FBgn0039140	183	223	147	171	330	394	FALSE	TRUE	FALSE	0	TRUE	TRUE	1	0
FBgn0039141	245	295	231	204	476	499	FALSE	TRUE	TRUE	0	TRUE	TRUE	1	0
FBgn0039147	33	37	23	25	56	62	TRUE	TRUE	TRUE	1	TRUE	TRUE	1	1
FBgn0039149	30	16	17	25	47	41	FALSE	TRUE	TRUE	0	FALSE	TRUE	0	0
FBgn0039150	153	183	146	138	299	321	TRUE	TRUE	TRUE	1	TRUE	TRUE	1	1
FBgn0039151	167	141	112	142	279	283	TRUE	FALSE	TRUE	0	TRUE	TRUE	1	0
FBgn0039152	563	602	496	510	1059	1112	TRUE	TRUE	TRUE	1	TRUE	TRUE	1	1
FBgn0039153	47	47	43	39	90	86	TRUE	TRUE	TRUE	1	TRUE	TRUE	1	1
FBgn0039154	47	65	44	49	91	114	TRUE	TRUE	TRUE	1	TRUE	TRUE	1	1
FBgn0039155	120	126	92	93	212	219	TRUE	TRUE	TRUE	1	TRUE	TRUE	1	1
FBgn0039156	102	99	81	88	183	187	TRUE	TRUE	TRUE	1	TRUE	TRUE	1	1
FBgn0039157	363	393	303	326	666	719	TRUE	TRUE	TRUE	1	TRUE	TRUE	1	1
FBgn0039160	101	112	89	80	190	192	TRUE	TRUE	TRUE	1	TRUE	TRUE	1	1
FBgn0039161	202	183	149	134	351	317	TRUE	TRUE	TRUE	1	TRUE	TRUE	1	1
FBgn0039163	36	41	32	31	68	72	TRUE	TRUE	TRUE	1	TRUE	TRUE	1	1
FBgn0039165	133	119	76	92	209	211	TRUE	TRUE	TRUE	1	TRUE	TRUE	1	1
FBgn0039167	192	190	164	159	356	349	TRUE	TRUE	TRUE	1	TRUE	TRUE	1	1
FBgn0039169	149	108	96	96	245	204	FALSE	TRUE	FALSE	0	TRUE	TRUE	1	0
FBgn0039170	53	76	49	54	102	130	FALSE	TRUE	FALSE	0	TRUE	TRUE	1	0
FBgn0039172	28	26	24	13	52	39	TRUE	FALSE	TRUE	0	TRUE	FALSE	0	0
FBgn0039175	149	157	133	119	282	276	TRUE	TRUE	TRUE	1	TRUE	TRUE	1	1
FBgn0039178	232	210	182	178	414	388	TRUE	TRUE	TRUE	1	TRUE	TRUE	1	1
FBgn0039180	57	73	42	52	99	125	TRUE	TRUE	FALSE	0	TRUE	TRUE	1	0
FBgn0039182	179	185	152	142	331	327	TRUE	TRUE	TRUE	1	TRUE	TRUE	1	1
FBgn0039183	182	170	131	149	313	319	TRUE	TRUE	TRUE	1	TRUE	TRUE	1	1
FBgn0039184	148	137	114	127	262	264	TRUE	TRUE	TRUE	1	TRUE	TRUE	1	1
FBgn0039186	305	311	242	240	547	551	TRUE	TRUE	TRUE	1	TRUE	TRUE	1	1
FBgn0039187	320	364	300	281	620	645	TRUE	TRUE	TRUE	1	TRUE	TRUE	1	1
FBgn0039188	82	104	103	76	185	180	TRUE	FALSE	TRUE	0	TRUE	TRUE	1	0
FBgn0039189	185	160	119	137	304	297	TRUE	TRUE	TRUE	1	TRUE	TRUE	1	1
FBgn0039190	42	42	31	45	73	87	TRUE	TRUE	TRUE	1	TRUE	TRUE	1	1
FBgn0039192	66	76	51	50	117	126	TRUE	TRUE	TRUE	1	TRUE	TRUE	1	1
FBgn0039193	72	66	55	59	127	125	TRUE	TRUE	TRUE	1	TRUE	TRUE	1	1
FBgn0039194	102	96	89	77	191	173	TRUE	TRUE	TRUE	1	TRUE	TRUE	1	1
FBgn0039195	107	100	100	90	207	190	TRUE	TRUE	TRUE	1	TRUE	TRUE	1	1
FBgn0039196	167	164	124	149	291	313	TRUE	TRUE	TRUE	1	TRUE	TRUE	1	1
FBgn0039197	181	173	141	139	322	312	TRUE	TRUE	TRUE	1	TRUE	TRUE	1	1
FBgn0039198	134	132	91	105	225	237	TRUE	TRUE	TRUE	1	TRUE	TRUE	1	1
FBgn0039199	164	127	118	107	282	234	FALSE	TRUE	FALSE	0	TRUE	TRUE	1	0
FBgn0039200	47	52	45	42	92	94	TRUE	TRUE	TRUE	1	TRUE	TRUE	1	1
FBgn0039201	246	283	230	228	476	511	TRUE	TRUE	TRUE	1	TRUE	TRUE	1	1
FBgn0039202	104	114	108	75	212	189	TRUE	FALSE	TRUE	0	TRUE	TRUE	1	0
FBgn0039203	147	148	123	124	270	272	TRUE	TRUE	TRUE	1	TRUE	TRUE	1	1
FBgn0039204	102	116	99	112	201	228	TRUE	TRUE	TRUE	1	TRUE	TRUE	1	1
FBgn0039205	54	49	34	37	88	86	TRUE	TRUE	TRUE	1	TRUE	TRUE	1	1
FBgn0039207	398	354	329	292	727	646	TRUE	TRUE	FALSE	0	TRUE	TRUE	1	0
FBgn0039209	616	558	429	496	1045	1054	FALSE	FALSE	TRUE	0	TRUE	TRUE	1	0
FBgn0039210	164	197	140	161	304	358	FALSE	TRUE	FALSE	0	TRUE	TRUE	1	0
FBgn0039212	58	64	44	43	102	107	TRUE	TRUE	TRUE	1	TRUE	TRUE	1	1
FBgn0039213	228	233	189	176	417	409	TRUE	TRUE	TRUE	1	TRUE	TRUE	1	1
FBgn0039214	631	610	511	506	1142	1116	TRUE	TRUE	TRUE	1	TRUE	TRUE	1	1
FBgn0039215	159	166	111	128	270	294	TRUE	TRUE	TRUE	1	TRUE	TRUE	1	1
FBgn0039218	14	22	15	18	29	40	TRUE	TRUE	TRUE	1	FALSE	TRUE	0	0
FBgn0039219	79	90	62	77	141	167	TRUE	TRUE	TRUE	1	TRUE	TRUE	1	1
FBgn0039223	230	231	168	175	398	406	TRUE	TRUE	TRUE	1	TRUE	TRUE	1	1
FBgn0039224	150	134	129	132	279	266	TRUE	TRUE	TRUE	1	TRUE	TRUE	1	1
FBgn0039225	220	238	184	189	404	427	TRUE	TRUE	TRUE	1	TRUE	TRUE	1	1
FBgn0039226	85	88	82	70	167	158	TRUE	TRUE	TRUE	1	TRUE	TRUE	1	1
FBgn0039227	229	242	205	190	434	432	TRUE	TRUE	TRUE	1	TRUE	TRUE	1	1
FBgn0039228	58	60	31	41	89	101	TRUE	TRUE	TRUE	1	TRUE	TRUE	1	1
FBgn0039229	270	237	229	185	499	422	TRUE	FALSE	FALSE	0	TRUE	TRUE	1	0
FBgn0039232	188	187	145	168	333	355	TRUE	TRUE	TRUE	1	TRUE	TRUE	1	1
FBgn0039233	26	44	28	34	54	78	FALSE	TRUE	FALSE	0	FALSE	TRUE	0	0
FBgn0039234	168	185	126	168	294	353	TRUE	FALSE	FALSE	0	TRUE	TRUE	1	0
FBgn0039235	109	71	84	71	193	142	FALSE	TRUE	FALSE	0	FALSE	TRUE	0	0
FBgn0039237	52	67	46	49	98	116	TRUE	TRUE	TRUE	1	TRUE	TRUE	1	1
FBgn0039238	45	32	35	18	80	50	TRUE	FALSE	FALSE	0	TRUE	FALSE	0	0
FBgn0039239	47	30	30	29	77	59	FALSE	TRUE	TRUE	0	FALSE	TRUE	0	0
FBgn0039240	235	193	184	182	419	375	FALSE	TRUE	TRUE	0	TRUE	TRUE	1	0
FBgn0039241	118	89	91	82	209	171	FALSE	TRUE	FALSE	0	TRUE	TRUE	1	0
FBgn0039244	197	150	150	125	347	275	FALSE	TRUE	FALSE	0	TRUE	TRUE	1	0
FBgn0039246	144	102	86	110	230	212	FALSE	TRUE	TRUE	0	TRUE	TRUE	1	0
FBgn0039249	240	240	206	219	446	459	TRUE	TRUE	TRUE	1	TRUE	TRUE	1	1
FBgn0039250	57	77	74	63	131	140	TRUE	TRUE	TRUE	1	TRUE	TRUE	1	1
FBgn0039251	65	58	55	68	120	126	TRUE	TRUE	TRUE	1	TRUE	TRUE	1	1
FBgn0039252	190	201	181	179	371	380	TRUE	TRUE	TRUE	1	TRUE	TRUE	1	1
FBgn0039254	83	72	69	70	152	142	TRUE	TRUE	TRUE	1	TRUE	TRUE	1	1
FBgn0039257	760	782	638	647	1398	1429	TRUE	TRUE	TRUE	1	TRUE	TRUE	1	1
FBgn0039258	72	64	36	59	108	123	TRUE	FALSE	TRUE	0	TRUE	FALSE	0	0
FBgn0039259	34	35	33	32	67	67	TRUE	TRUE	TRUE	1	TRUE	TRUE	1	1
FBgn0039260	142	110	93	94	235	204	FALSE	TRUE	TRUE	0	TRUE	TRUE	1	0
FBgn0039261	149	132	130	111	279	243	TRUE	TRUE	TRUE	1	TRUE	TRUE	1	1
FBgn0039264	72	63	57	49	129	112	TRUE	TRUE	TRUE	1	TRUE	TRUE	1	1
FBgn0039265	103	109	94	82	197	191	TRUE	TRUE	TRUE	1	TRUE	TRUE	1	1
FBgn0039266	92	71	76	74	168	145	TRUE	TRUE	TRUE	1	TRUE	TRUE	1	1
FBgn0039269	69	69	46	54	115	123	TRUE	TRUE	TRUE	1	TRUE	TRUE	1	1
FBgn0039270	31	14	20	22	51	36	FALSE	TRUE	TRUE	0	FALSE	TRUE	0	0
FBgn0039272	78	89	59	71	137	160	TRUE	TRUE	TRUE	1	TRUE	TRUE	1	1
FBgn0039273	145	150	119	128	264	278	TRUE	TRUE	TRUE	1	TRUE	TRUE	1	1
FBgn0039274	111	95	84	127	195	222	TRUE	FALSE	TRUE	0	TRUE	FALSE	0	0
FBgn0039277	299	306	248	267	547	573	TRUE	TRUE	TRUE	1	TRUE	TRUE	1	1
FBgn0039282	264	274	208	238	472	512	TRUE	TRUE	TRUE	1	TRUE	TRUE	1	1
FBgn0039283	48	46	57	49	105	95	TRUE	TRUE	TRUE	1	TRUE	TRUE	1	1
FBgn0039286	248	269	204	196	452	465	TRUE	TRUE	TRUE	1	TRUE	TRUE	1	1
FBgn0039288	96	110	90	125	186	235	TRUE	FALSE	FALSE	0	TRUE	TRUE	1	0
FBgn0039290	245	219	167	173	412	392	TRUE	TRUE	TRUE	1	TRUE	TRUE	1	1
FBgn0039293	99	100	94	115	193	215	TRUE	TRUE	TRUE	1	TRUE	TRUE	1	1
FBgn0039294	236	213	180	191	416	404	TRUE	TRUE	TRUE	1	TRUE	TRUE	1	1
FBgn0039296	186	188	149	166	335	354	TRUE	TRUE	TRUE	1	TRUE	TRUE	1	1
FBgn0039297	105	93	74	73	179	166	TRUE	TRUE	TRUE	1	TRUE	TRUE	1	1
FBgn0039298	134	125	120	117	254	242	TRUE	TRUE	TRUE	1	TRUE	TRUE	1	1
FBgn0039299	76	79	50	68	126	147	TRUE	TRUE	TRUE	1	TRUE	TRUE	1	1
FBgn0039300	47	42	37	29	84	71	TRUE	TRUE	TRUE	1	TRUE	TRUE	1	1
FBgn0039301	87	98	64	81	151	179	TRUE	TRUE	TRUE	1	TRUE	TRUE	1	1
FBgn0039302	319	339	310	288	629	627	TRUE	TRUE	TRUE	1	TRUE	TRUE	1	1
FBgn0039303	68	61	29	66	97	127	TRUE	FALSE	FALSE	0	TRUE	FALSE	0	0
FBgn0039304	104	97	82	97	186	194	TRUE	TRUE	TRUE	1	TRUE	TRUE	1	1
FBgn0039305	46	30	24	32	70	62	FALSE	TRUE	TRUE	0	FALSE	TRUE	0	0
FBgn0039307	83	87	76	63	159	150	TRUE	TRUE	TRUE	1	TRUE	TRUE	1	1
FBgn0039310	100	90	68	72	168	162	TRUE	TRUE	TRUE	1	TRUE	TRUE	1	1
FBgn0039311	65	86	64	75	129	161	TRUE	TRUE	FALSE	0	TRUE	TRUE	1	0
FBgn0039312	137	123	103	98	240	221	TRUE	TRUE	TRUE	1	TRUE	TRUE	1	1
FBgn0039313	36	65	43	59	79	124	FALSE	TRUE	FALSE	0	FALSE	TRUE	0	0
FBgn0039315	64	70	41	81	105	151	TRUE	FALSE	FALSE	0	TRUE	FALSE	0	0
FBgn0039316	69	57	65	41	134	98	TRUE	FALSE	FALSE	0	TRUE	FALSE	0	0
FBgn0039319	123	134	115	112	238	246	TRUE	TRUE	TRUE	1	TRUE	TRUE	1	1
FBgn0039321	95	95	70	84	165	179	TRUE	TRUE	TRUE	1	TRUE	TRUE	1	1
FBgn0039323	91	95	90	81	181	176	TRUE	TRUE	TRUE	1	TRUE	TRUE	1	1
FBgn0039324	170	176	142	146	312	322	TRUE	TRUE	TRUE	1	TRUE	TRUE	1	1
FBgn0039325	70	80	56	58	126	138	TRUE	TRUE	TRUE	1	TRUE	TRUE	1	1
FBgn0039326	116	94	90	97	206	191	TRUE	TRUE	TRUE	1	TRUE	TRUE	1	1
FBgn0039328	137	126	117	113	254	239	TRUE	TRUE	TRUE	1	TRUE	TRUE	1	1
FBgn0039329	166	195	174	142	340	337	TRUE	FALSE	TRUE	0	TRUE	TRUE	1	0
FBgn0039331	129	108	124	107	253	215	TRUE	TRUE	FALSE	0	TRUE	TRUE	1	0
FBgn0039332	119	103	104	107	223	210	TRUE	TRUE	TRUE	1	TRUE	TRUE	1	1
FBgn0039335	164	205	155	144	319	349	FALSE	TRUE	TRUE	0	TRUE	TRUE	1	0
FBgn0039336	20	24	23	12	43	36	TRUE	FALSE	TRUE	0	TRUE	FALSE	0	0
FBgn0039337	58	69	48	48	106	117	TRUE	TRUE	TRUE	1	TRUE	TRUE	1	1
FBgn0039338	253	259	224	249	477	508	TRUE	TRUE	TRUE	1	TRUE	TRUE	1	1
FBgn0039342	78	105	64	87	142	192	FALSE	FALSE	FALSE	0	TRUE	TRUE	1	0
FBgn0039343	144	136	134	128	278	264	TRUE	TRUE	TRUE	1	TRUE	TRUE	1	1
FBgn0039344	121	146	96	86	217	232	TRUE	TRUE	TRUE	1	TRUE	TRUE	1	1
FBgn0039346	51	40	41	38	92	78	TRUE	TRUE	TRUE	1	TRUE	TRUE	1	1
FBgn0039347	294	297	244	240	538	537	TRUE	TRUE	TRUE	1	TRUE	TRUE	1	1
FBgn0039348	186	160	163	136	349	296	TRUE	TRUE	FALSE	0	TRUE	TRUE	1	0
FBgn0039349	100	105	98	90	198	195	TRUE	TRUE	TRUE	1	TRUE	TRUE	1	1
FBgn0039350	245	262	251	233	496	495	TRUE	TRUE	TRUE	1	TRUE	TRUE	1	1
FBgn0039354	273	279	192	185	465	464	TRUE	TRUE	TRUE	1	TRUE	TRUE	1	1
FBgn0039355	55	72	50	46	105	118	TRUE	TRUE	TRUE	1	TRUE	TRUE	1	1
FBgn0039357	73	60	50	44	123	104	TRUE	TRUE	TRUE	1	TRUE	TRUE	1	1
FBgn0039358	175	178	162	150	337	328	TRUE	TRUE	TRUE	1	TRUE	TRUE	1	1
FBgn0039359	27	29	28	25	55	54	TRUE	TRUE	TRUE	1	TRUE	TRUE	1	1
FBgn0039360	185	158	163	154	348	312	TRUE	TRUE	TRUE	1	TRUE	TRUE	1	1
FBgn0039368	44	41	36	46	80	87	TRUE	TRUE	TRUE	1	TRUE	TRUE	1	1
FBgn0039369	74	58	59	58	133	116	TRUE	TRUE	TRUE	1	TRUE	TRUE	1	1
FBgn0039370	33	18	21	19	54	37	FALSE	TRUE	FALSE	0	FALSE	TRUE	0	0
FBgn0039371	104	99	84	75	188	174	TRUE	TRUE	TRUE	1	TRUE	TRUE	1	1
FBgn0039373	68	63	62	60	130	123	TRUE	TRUE	TRUE	1	TRUE	TRUE	1	1
FBgn0039376	47	52	26	37	73	89	TRUE	TRUE	TRUE	1	TRUE	TRUE	1	1
FBgn0039378	143	128	121	115	264	243	TRUE	TRUE	TRUE	1	TRUE	TRUE	1	1
FBgn0039379	122	127	121	103	243	230	TRUE	TRUE	TRUE	1	TRUE	TRUE	1	1
FBgn0039380	396	400	337	343	733	743	TRUE	TRUE	TRUE	1	TRUE	TRUE	1	1
FBgn0039381	227	236	156	205	383	441	TRUE	FALSE	FALSE	0	TRUE	TRUE	1	0
FBgn0039385	33	47	43	48	76	95	TRUE	TRUE	TRUE	1	TRUE	TRUE	1	1
FBgn0039386	116	126	91	110	207	236	TRUE	TRUE	TRUE	1	TRUE	TRUE	1	1
FBgn0039387	215	182	161	193	376	375	TRUE	FALSE	TRUE	0	TRUE	TRUE	1	0
FBgn0039395	150	133	139	127	289	260	TRUE	TRUE	TRUE	1	TRUE	TRUE	1	1
FBgn0039396	289	282	215	229	504	511	TRUE	TRUE	TRUE	1	TRUE	TRUE	1	1
FBgn0039398	62	70	52	37	114	107	TRUE	TRUE	TRUE	1	TRUE	TRUE	1	1
FBgn0039402	44	48	45	39	89	87	TRUE	TRUE	TRUE	1	TRUE	TRUE	1	1
FBgn0039403	58	54	43	51	101	105	TRUE	TRUE	TRUE	1	TRUE	TRUE	1	1
FBgn0039404	45	30	30	27	75	57	TRUE	TRUE	TRUE	1	TRUE	TRUE	1	1
FBgn0039406	67	65	65	58	132	123	TRUE	TRUE	TRUE	1	TRUE	TRUE	1	1
FBgn0039407	70	69	57	59	127	128	TRUE	TRUE	TRUE	1	TRUE	TRUE	1	1
FBgn0039408	141	116	117	103	258	219	TRUE	TRUE	FALSE	0	TRUE	TRUE	1	0
FBgn0039411	307	283	241	232	548	515	TRUE	TRUE	TRUE	1	TRUE	TRUE	1	1
FBgn0039413	103	104	79	102	182	206	TRUE	TRUE	TRUE	1	TRUE	TRUE	1	1
FBgn0039415	278	269	189	234	467	503	TRUE	FALSE	TRUE	0	TRUE	TRUE	1	0
FBgn0039417	101	87	62	72	163	159	TRUE	TRUE	TRUE	1	TRUE	TRUE	1	1
FBgn0039419	293	282	252	215	545	497	TRUE	FALSE	TRUE	0	TRUE	TRUE	1	0
FBgn0039420	243	261	218	204	461	465	TRUE	TRUE	TRUE	1	TRUE	TRUE	1	1
FBgn0039421	95	85	79	73	174	158	TRUE	TRUE	TRUE	1	TRUE	TRUE	1	1
FBgn0039424	131	150	123	138	254	288	TRUE	TRUE	TRUE	1	TRUE	TRUE	1	1
FBgn0039425	92	76	76	69	168	145	TRUE	TRUE	TRUE	1	TRUE	TRUE	1	1
FBgn0039427	83	94	71	73	154	167	TRUE	TRUE	TRUE	1	TRUE	TRUE	1	1
FBgn0039428	18	33	20	23	38	56	FALSE	TRUE	FALSE	0	FALSE	TRUE	0	0
FBgn0039429	193	210	162	162	355	372	TRUE	TRUE	TRUE	1	TRUE	TRUE	1	1
FBgn0039430	248	239	203	188	451	427	TRUE	TRUE	TRUE	1	TRUE	TRUE	1	1
FBgn0039431	545	513	477	432	1022	945	TRUE	TRUE	FALSE	0	TRUE	TRUE	1	0
FBgn0039434	89	94	62	93	151	187	TRUE	FALSE	FALSE	0	TRUE	TRUE	1	0
FBgn0039435	61	49	38	41	99	90	TRUE	TRUE	TRUE	1	TRUE	TRUE	1	1
FBgn0039436	96	46	67	92	163	138	FALSE	FALSE	TRUE	0	FALSE	TRUE	0	0
FBgn0039437	61	53	57	61	118	114	TRUE	TRUE	TRUE	1	TRUE	TRUE	1	1
FBgn0039438	44	30	38	26	82	56	TRUE	TRUE	FALSE	0	TRUE	TRUE	1	0
FBgn0039439	33	38	35	43	68	81	TRUE	TRUE	TRUE	1	TRUE	TRUE	1	1
FBgn0039440	113	83	80	86	193	169	FALSE	TRUE	TRUE	0	TRUE	TRUE	1	0
FBgn0039441	80	65	42	55	122	120	TRUE	TRUE	TRUE	1	TRUE	TRUE	1	1
FBgn0039443	92	70	75	49	167	119	FALSE	FALSE	FALSE	0	TRUE	FALSE	0	0
FBgn0039444	74	68	50	81	124	149	TRUE	FALSE	TRUE	0	TRUE	FALSE	0	0
FBgn0039448	88	100	73	85	161	185	TRUE	TRUE	TRUE	1	TRUE	TRUE	1	1
FBgn0039449	132	118	97	107	229	225	TRUE	TRUE	TRUE	1	TRUE	TRUE	1	1
FBgn0039450	110	98	82	81	192	179	TRUE	TRUE	TRUE	1	TRUE	TRUE	1	1
FBgn0039451	158	129	118	133	276	262	FALSE	TRUE	TRUE	0	TRUE	TRUE	1	0
FBgn0039452	68	93	55	80	123	173	FALSE	FALSE	FALSE	0	TRUE	TRUE	1	0
FBgn0039453	78	92	68	81	146	173	TRUE	TRUE	TRUE	1	TRUE	TRUE	1	1
FBgn0039454	126	106	80	108	206	214	TRUE	FALSE	TRUE	0	TRUE	TRUE	1	0
FBgn0039459	64	56	37	43	101	99	TRUE	TRUE	TRUE	1	TRUE	TRUE	1	1
FBgn0039461	81	93	64	56	145	149	TRUE	TRUE	TRUE	1	TRUE	TRUE	1	1
FBgn0039462	136	161	141	112	277	273	TRUE	FALSE	TRUE	0	TRUE	TRUE	1	0
FBgn0039463	106	111	84	87	190	198	TRUE	TRUE	TRUE	1	TRUE	TRUE	1	1
FBgn0039464	260	221	221	180	481	401	FALSE	FALSE	FALSE	0	TRUE	TRUE	1	0
FBgn0039465	235	203	185	191	420	394	TRUE	TRUE	TRUE	1	TRUE	TRUE	1	1
FBgn0039466	636	626	593	545	1229	1171	TRUE	TRUE	TRUE	1	TRUE	TRUE	1	1
FBgn0039467	119	119	115	115	234	234	TRUE	TRUE	TRUE	1	TRUE	TRUE	1	1
FBgn0039469	132	134	110	105	242	239	TRUE	TRUE	TRUE	1	TRUE	TRUE	1	1
FBgn0039470	196	200	142	168	338	368	TRUE	TRUE	TRUE	1	TRUE	TRUE	1	1
FBgn0039471	116	72	71	69	187	141	FALSE	TRUE	FALSE	0	FALSE	TRUE	0	0
FBgn0039472	88	80	67	58	155	138	TRUE	TRUE	TRUE	1	TRUE	TRUE	1	1
FBgn0039473	99	95	90	92	189	187	TRUE	TRUE	TRUE	1	TRUE	TRUE	1	1
FBgn0039474	98	105	77	77	175	182	TRUE	TRUE	TRUE	1	TRUE	TRUE	1	1
FBgn0039475	101	105	85	92	186	197	TRUE	TRUE	TRUE	1	TRUE	TRUE	1	1
FBgn0039476	115	110	83	86	198	196	TRUE	TRUE	TRUE	1	TRUE	TRUE	1	1
FBgn0039478	350	344	290	292	640	636	TRUE	TRUE	TRUE	1	TRUE	TRUE	1	1
FBgn0039479	297	247	195	233	492	480	FALSE	FALSE	TRUE	0	TRUE	TRUE	1	0
FBgn0039480	182	185	152	128	334	313	TRUE	TRUE	TRUE	1	TRUE	TRUE	1	1
FBgn0039481	116	89	77	81	193	170	FALSE	TRUE	TRUE	0	TRUE	TRUE	1	0
FBgn0039482	154	155	99	100	253	255	TRUE	TRUE	TRUE	1	TRUE	TRUE	1	1
FBgn0039483	94	95	92	74	186	169	TRUE	TRUE	TRUE	1	TRUE	TRUE	1	1
FBgn0039485	102	150	108	101	210	251	FALSE	TRUE	FALSE	0	TRUE	TRUE	1	0
FBgn0039486	147	150	114	103	261	253	TRUE	TRUE	TRUE	1	TRUE	TRUE	1	1
FBgn0039487	117	106	66	99	183	205	TRUE	FALSE	TRUE	0	TRUE	TRUE	1	0
FBgn0039488	36	54	35	43	71	97	FALSE	TRUE	FALSE	0	TRUE	TRUE	1	0
FBgn0039489	125	124	87	75	212	199	TRUE	TRUE	TRUE	1	TRUE	TRUE	1	1
FBgn0039490	180	171	143	150	323	321	TRUE	TRUE	TRUE	1	TRUE	TRUE	1	1
FBgn0039491	161	130	115	104	276	234	FALSE	TRUE	FALSE	0	TRUE	TRUE	1	0
FBgn0039492	261	258	191	181	452	439	TRUE	TRUE	TRUE	1	TRUE	TRUE	1	1
FBgn0039494	208	209	157	162	365	371	TRUE	TRUE	TRUE	1	TRUE	TRUE	1	1
FBgn0039495	140	139	114	118	254	257	TRUE	TRUE	TRUE	1	TRUE	TRUE	1	1
FBgn0039498	28	24	20	14	48	38	TRUE	TRUE	TRUE	1	TRUE	TRUE	1	1
FBgn0039500	148	169	101	101	249	270	TRUE	TRUE	TRUE	1	TRUE	TRUE	1	1
FBgn0039501	168	182	140	148	308	330	TRUE	TRUE	TRUE	1	TRUE	TRUE	1	1
FBgn0039503	82	70	65	68	147	138	TRUE	TRUE	TRUE	1	TRUE	TRUE	1	1
FBgn0039504	40	31	17	23	57	54	TRUE	TRUE	TRUE	1	TRUE	TRUE	1	1
FBgn0039505	40	42	24	33	64	75	TRUE	TRUE	TRUE	1	TRUE	TRUE	1	1
FBgn0039507	163	174	160	149	323	323	TRUE	TRUE	TRUE	1	TRUE	TRUE	1	1
FBgn0039508	175	192	157	134	332	326	TRUE	TRUE	TRUE	1	TRUE	TRUE	1	1
FBgn0039509	38	50	38	37	76	87	TRUE	TRUE	TRUE	1	TRUE	TRUE	1	1
FBgn0039510	1040	1108	854	868	1894	1976	TRUE	TRUE	TRUE	1	TRUE	TRUE	1	1
FBgn0039511	58	65	54	63	112	128	TRUE	TRUE	TRUE	1	TRUE	TRUE	1	1
FBgn0039518	206	192	206	194	412	386	TRUE	TRUE	TRUE	1	TRUE	TRUE	1	1
FBgn0039519	296	298	236	261	532	559	TRUE	TRUE	TRUE	1	TRUE	TRUE	1	1
FBgn0039520	160	166	142	151	302	317	TRUE	TRUE	TRUE	1	TRUE	TRUE	1	1
FBgn0039521	49	44	56	55	105	99	TRUE	TRUE	TRUE	1	TRUE	TRUE	1	1
FBgn0039522	111	115	116	94	227	209	TRUE	TRUE	TRUE	1	TRUE	TRUE	1	1
FBgn0039523	236	264	185	214	421	478	TRUE	TRUE	FALSE	0	TRUE	TRUE	1	0
FBgn0039525	82	82	62	58	144	140	TRUE	TRUE	TRUE	1	TRUE	TRUE	1	1
FBgn0039527	331	380	273	294	604	674	FALSE	TRUE	FALSE	0	TRUE	TRUE	1	0
FBgn0039528	398	428	346	321	744	749	TRUE	TRUE	TRUE	1	TRUE	TRUE	1	1
FBgn0039529	155	172	139	133	294	305	TRUE	TRUE	TRUE	1	TRUE	TRUE	1	1
FBgn0039530	501	470	403	414	904	884	TRUE	TRUE	TRUE	1	TRUE	TRUE	1	1
FBgn0039531	77	84	70	68	147	152	TRUE	TRUE	TRUE	1	TRUE	TRUE	1	1
FBgn0039532	201	199	147	178	348	377	TRUE	FALSE	TRUE	0	TRUE	TRUE	1	0
FBgn0039536	1021	912	816	783	1837	1695	FALSE	TRUE	FALSE	0	TRUE	TRUE	1	0
FBgn0039537	81	82	71	66	152	148	TRUE	TRUE	TRUE	1	TRUE	TRUE	1	1
FBgn0039538	43	58	38	43	81	101	TRUE	TRUE	TRUE	1	TRUE	TRUE	1	1
FBgn0039543	91	109	88	89	179	198	TRUE	TRUE	TRUE	1	TRUE	TRUE	1	1
FBgn0039544	300	284	244	217	544	501	TRUE	TRUE	TRUE	1	TRUE	TRUE	1	1
FBgn0039551	118	130	103	126	221	256	TRUE	TRUE	TRUE	1	TRUE	TRUE	1	1
FBgn0039552	105	100	83	87	188	187	TRUE	TRUE	TRUE	1	TRUE	TRUE	1	1
FBgn0039554	198	199	166	147	364	346	TRUE	TRUE	TRUE	1	TRUE	TRUE	1	1
FBgn0039555	22	21	39	21	61	42	TRUE	FALSE	FALSE	0	TRUE	FALSE	0	0
FBgn0039557	96	93	69	88	165	181	TRUE	TRUE	TRUE	1	TRUE	TRUE	1	1
FBgn0039558	99	89	79	63	178	152	TRUE	TRUE	TRUE	1	TRUE	TRUE	1	1
FBgn0039559	246	216	179	177	425	393	TRUE	TRUE	TRUE	1	TRUE	TRUE	1	1
FBgn0039560	294	262	205	208	499	470	TRUE	TRUE	TRUE	1	TRUE	TRUE	1	1
FBgn0039561	197	192	162	137	359	329	TRUE	TRUE	TRUE	1	TRUE	TRUE	1	1
FBgn0039562	212	233	218	174	430	407	TRUE	FALSE	TRUE	0	TRUE	TRUE	1	0
FBgn0039563	105	106	108	90	213	196	TRUE	TRUE	TRUE	1	TRUE	TRUE	1	1
FBgn0039564	110	135	112	94	222	229	TRUE	TRUE	TRUE	1	TRUE	TRUE	1	1
FBgn0039566	159	172	133	143	292	315	TRUE	TRUE	TRUE	1	TRUE	TRUE	1	1
FBgn0039568	61	44	51	54	112	98	TRUE	TRUE	TRUE	1	TRUE	TRUE	1	1
FBgn0039576	26	27	18	25	44	52	TRUE	TRUE	TRUE	1	TRUE	TRUE	1	1
FBgn0039577	54	46	37	43	91	89	TRUE	TRUE	TRUE	1	TRUE	TRUE	1	1
FBgn0039580	73	88	71	71	144	159	TRUE	TRUE	TRUE	1	TRUE	TRUE	1	1
FBgn0039581	225	247	198	205	423	452	TRUE	TRUE	TRUE	1	TRUE	TRUE	1	1
FBgn0039582	95	94	90	95	185	189	TRUE	TRUE	TRUE	1	TRUE	TRUE	1	1
FBgn0039584	246	227	219	225	465	452	TRUE	TRUE	TRUE	1	TRUE	TRUE	1	1
FBgn0039585	187	22	160	28	347	50	FALSE	FALSE	FALSE	0	FALSE	FALSE	0	0
FBgn0039588	121	105	104	89	225	194	TRUE	TRUE	TRUE	1	TRUE	TRUE	1	1
FBgn0039589	134	138	106	132	240	270	TRUE	TRUE	TRUE	1	TRUE	TRUE	1	1
FBgn0039590	516	493	364	395	880	888	TRUE	TRUE	TRUE	1	TRUE	TRUE	1	1
FBgn0039591	136	145	101	111	237	256	TRUE	TRUE	TRUE	1	TRUE	TRUE	1	1
FBgn0039592	135	131	108	106	243	237	TRUE	TRUE	TRUE	1	TRUE	TRUE	1	1
FBgn0039593	80	99	76	81	156	180	TRUE	TRUE	TRUE	1	TRUE	TRUE	1	1
FBgn0039594	509	461	420	491	929	952	TRUE	FALSE	TRUE	0	TRUE	TRUE	1	0
FBgn0039595	202	200	173	173	375	373	TRUE	TRUE	TRUE	1	TRUE	TRUE	1	1
FBgn0039596	195	195	137	132	332	327	TRUE	TRUE	TRUE	1	TRUE	TRUE	1	1
FBgn0039597	49	53	50	44	99	97	TRUE	TRUE	TRUE	1	TRUE	TRUE	1	1
FBgn0039598	74	74	56	64	130	138	TRUE	TRUE	TRUE	1	TRUE	TRUE	1	1
FBgn0039599	108	104	78	68	186	172	TRUE	TRUE	TRUE	1	TRUE	TRUE	1	1
FBgn0039600	161	194	143	167	304	361	FALSE	TRUE	FALSE	0	TRUE	TRUE	1	0
FBgn0039601	81	67	62	45	143	112	TRUE	TRUE	FALSE	0	TRUE	TRUE	1	0
FBgn0039602	217	250	222	192	439	442	TRUE	TRUE	TRUE	1	TRUE	TRUE	1	1
FBgn0039609	69	76	61	53	130	129	TRUE	TRUE	TRUE	1	TRUE	TRUE	1	1
FBgn0039611	158	153	124	148	282	301	TRUE	TRUE	TRUE	1	TRUE	TRUE	1	1
FBgn0039612	183	147	145	137	328	284	FALSE	TRUE	FALSE	0	TRUE	TRUE	1	0
FBgn0039613	163	144	135	136	298	280	TRUE	TRUE	TRUE	1	TRUE	TRUE	1	1
FBgn0039616	150	157	147	154	297	311	TRUE	TRUE	TRUE	1	TRUE	TRUE	1	1
FBgn0039617	169	191	183	180	352	371	TRUE	TRUE	TRUE	1	TRUE	TRUE	1	1
FBgn0039620	202	193	165	154	367	347	TRUE	TRUE	TRUE	1	TRUE	TRUE	1	1
FBgn0039621	98	96	73	83	171	179	TRUE	TRUE	TRUE	1	TRUE	TRUE	1	1
FBgn0039622	37	36	24	34	61	70	TRUE	TRUE	TRUE	1	TRUE	TRUE	1	1
FBgn0039623	120	116	80	90	200	206	TRUE	TRUE	TRUE	1	TRUE	TRUE	1	1
FBgn0039626	51	81	39	60	90	141	FALSE	FALSE	FALSE	0	FALSE	FALSE	0	0
FBgn0039627	86	81	62	60	148	141	TRUE	TRUE	TRUE	1	TRUE	TRUE	1	1
FBgn0039628	102	95	87	67	189	162	TRUE	TRUE	TRUE	1	TRUE	TRUE	1	1
FBgn0039629	141	89	88	62	229	151	FALSE	FALSE	FALSE	0	FALSE	TRUE	0	0
FBgn0039631	178	173	117	115	295	288	TRUE	TRUE	TRUE	1	TRUE	TRUE	1	1
FBgn0039632	188	179	140	142	328	321	TRUE	TRUE	TRUE	1	TRUE	TRUE	1	1
FBgn0039633	643	638	549	496	1192	1134	TRUE	TRUE	TRUE	1	TRUE	TRUE	1	1
FBgn0039634	207	200	202	164	409	364	TRUE	FALSE	TRUE	0	TRUE	TRUE	1	0
FBgn0039635	153	157	136	122	289	279	TRUE	TRUE	TRUE	1	TRUE	TRUE	1	1
FBgn0039636	70	55	61	48	131	103	TRUE	TRUE	FALSE	0	TRUE	TRUE	1	0
FBgn0039637	215	234	195	176	410	410	TRUE	TRUE	TRUE	1	TRUE	TRUE	1	1
FBgn0039638	249	206	209	165	458	371	FALSE	FALSE	FALSE	0	TRUE	TRUE	1	0
FBgn0039639	25	24	36	26	61	50	TRUE	TRUE	TRUE	1	TRUE	TRUE	1	1
FBgn0039640	341	339	245	267	586	606	TRUE	TRUE	TRUE	1	TRUE	TRUE	1	1
FBgn0039641	77	84	60	62	137	146	TRUE	TRUE	TRUE	1	TRUE	TRUE	1	1
FBgn0039642	77	102	69	80	146	182	FALSE	TRUE	FALSE	0	TRUE	TRUE	1	0
FBgn0039644	353	362	321	280	674	642	TRUE	TRUE	TRUE	1	TRUE	TRUE	1	1
FBgn0039645	378	359	317	293	695	652	TRUE	TRUE	TRUE	1	TRUE	TRUE	1	1
FBgn0039647	325	314	248	237	573	551	TRUE	TRUE	TRUE	1	TRUE	TRUE	1	1
FBgn0039648	66	73	64	54	130	127	TRUE	TRUE	TRUE	1	TRUE	TRUE	1	1
FBgn0039650	14	23	17	14	31	37	TRUE	TRUE	TRUE	1	FALSE	TRUE	0	0
FBgn0039651	90	80	67	55	157	135	TRUE	TRUE	TRUE	1	TRUE	TRUE	1	1
FBgn0039654	186	185	122	138	308	323	TRUE	TRUE	TRUE	1	TRUE	TRUE	1	1
FBgn0039655	110	131	94	89	204	220	TRUE	TRUE	TRUE	1	TRUE	TRUE	1	1
FBgn0039656	165	136	125	127	290	263	TRUE	TRUE	TRUE	1	TRUE	TRUE	1	1
FBgn0039659	286	265	230	245	516	510	TRUE	TRUE	TRUE	1	TRUE	TRUE	1	1
FBgn0039663	176	184	130	121	306	305	TRUE	TRUE	TRUE	1	TRUE	TRUE	1	1
FBgn0039664	137	126	95	77	232	203	TRUE	TRUE	TRUE	1	TRUE	TRUE	1	1
FBgn0039665	170	163	117	150	287	313	TRUE	FALSE	TRUE	0	TRUE	TRUE	1	0
FBgn0039666	50	57	38	40	88	97	TRUE	TRUE	TRUE	1	TRUE	TRUE	1	1
FBgn0039667	248	257	212	200	460	457	TRUE	TRUE	TRUE	1	TRUE	TRUE	1	1
FBgn0039668	303	273	253	234	556	507	TRUE	TRUE	TRUE	1	TRUE	TRUE	1	1
FBgn0039669	108	113	81	79	189	192	TRUE	TRUE	TRUE	1	TRUE	TRUE	1	1
FBgn0039670	111	124	91	77	202	201	TRUE	TRUE	TRUE	1	TRUE	TRUE	1	1
FBgn0039671	105	88	74	63	179	151	TRUE	TRUE	TRUE	1	TRUE	TRUE	1	1
FBgn0039673	100	111	95	110	195	221	TRUE	TRUE	TRUE	1	TRUE	TRUE	1	1
FBgn0039674	135	147	96	116	231	263	TRUE	TRUE	TRUE	1	TRUE	TRUE	1	1
FBgn0039675	196	167	161	124	357	291	TRUE	FALSE	FALSE	0	TRUE	TRUE	1	0
FBgn0039676	182	183	155	164	337	347	TRUE	TRUE	TRUE	1	TRUE	TRUE	1	1
FBgn0039677	195	211	175	164	370	375	TRUE	TRUE	TRUE	1	TRUE	TRUE	1	1
FBgn0039678	74	78	76	43	150	121	TRUE	FALSE	FALSE	0	TRUE	FALSE	0	0
FBgn0039679	102	122	98	91	200	213	TRUE	TRUE	TRUE	1	TRUE	TRUE	1	1
FBgn0039680	376	327	324	296	700	623	FALSE	TRUE	FALSE	0	TRUE	TRUE	1	0
FBgn0039681	142	117	115	130	257	247	TRUE	TRUE	TRUE	1	TRUE	TRUE	1	1
FBgn0039682	73	78	71	69	144	147	TRUE	TRUE	TRUE	1	TRUE	TRUE	1	1
FBgn0039683	247	242	210	200	457	442	TRUE	TRUE	TRUE	1	TRUE	TRUE	1	1
FBgn0039684	51	52	39	48	90	100	TRUE	TRUE	TRUE	1	TRUE	TRUE	1	1
FBgn0039685	74	69	47	47	121	116	TRUE	TRUE	TRUE	1	TRUE	TRUE	1	1
FBgn0039686	89	95	73	83	162	178	TRUE	TRUE	TRUE	1	TRUE	TRUE	1	1
FBgn0039687	58	63	36	54	94	117	TRUE	FALSE	TRUE	0	TRUE	TRUE	1	0
FBgn0039688	604	675	468	516	1072	1191	FALSE	TRUE	FALSE	0	TRUE	TRUE	1	0
FBgn0039689	65	52	39	24	104	76	TRUE	FALSE	FALSE	0	TRUE	FALSE	0	0
FBgn0039690	206	168	121	137	327	305	FALSE	TRUE	TRUE	0	TRUE	TRUE	1	0
FBgn0039691	101	115	111	89	212	204	TRUE	TRUE	TRUE	1	TRUE	TRUE	1	1
FBgn0039694	137	125	96	111	233	236	TRUE	TRUE	TRUE	1	TRUE	TRUE	1	1
FBgn0039696	260	272	213	218	473	490	TRUE	TRUE	TRUE	1	TRUE	TRUE	1	1
FBgn0039697	96	125	80	92	176	217	FALSE	TRUE	FALSE	0	TRUE	TRUE	1	0
FBgn0039698	83	114	75	78	158	192	FALSE	TRUE	FALSE	0	TRUE	TRUE	1	0
FBgn0039702	86	85	81	79	167	164	TRUE	TRUE	TRUE	1	TRUE	TRUE	1	1
FBgn0039703	73	78	58	78	131	156	TRUE	TRUE	TRUE	1	TRUE	TRUE	1	1
FBgn0039704	238	205	169	171	407	376	TRUE	TRUE	TRUE	1	TRUE	TRUE	1	1
FBgn0039705	223	207	165	184	388	391	TRUE	TRUE	TRUE	1	TRUE	TRUE	1	1
FBgn0039707	86	73	61	51	147	124	TRUE	TRUE	TRUE	1	TRUE	TRUE	1	1
FBgn0039709	496	473	409	353	905	826	TRUE	FALSE	FALSE	0	TRUE	TRUE	1	0
FBgn0039710	137	142	113	104	250	246	TRUE	TRUE	TRUE	1	TRUE	TRUE	1	1
FBgn0039711	57	61	61	52	118	113	TRUE	TRUE	TRUE	1	TRUE	TRUE	1	1
FBgn0039712	78	99	65	77	143	176	TRUE	TRUE	FALSE	0	TRUE	TRUE	1	0
FBgn0039713	71	77	69	76	140	153	TRUE	TRUE	TRUE	1	TRUE	TRUE	1	1
FBgn0039714	181	180	182	188	363	368	TRUE	TRUE	TRUE	1	TRUE	TRUE	1	1
FBgn0039718	42	59	33	61	75	120	TRUE	FALSE	FALSE	0	TRUE	FALSE	0	0
FBgn0039719	76	86	66	67	142	153	TRUE	TRUE	TRUE	1	TRUE	TRUE	1	1
FBgn0039722	81	79	70	64	151	143	TRUE	TRUE	TRUE	1	TRUE	TRUE	1	1
FBgn0039723	60	58	55	49	115	107	TRUE	TRUE	TRUE	1	TRUE	TRUE	1	1
FBgn0039726	42	47	30	29	72	76	TRUE	TRUE	TRUE	1	TRUE	TRUE	1	1
FBgn0039727	829	771	712	712	1541	1483	TRUE	TRUE	TRUE	1	TRUE	TRUE	1	1
FBgn0039728	359	378	287	278	646	656	TRUE	TRUE	TRUE	1	TRUE	TRUE	1	1
FBgn0039730	56	55	51	39	107	94	TRUE	TRUE	TRUE	1	TRUE	TRUE	1	1
FBgn0039731	95	111	114	92	209	203	TRUE	TRUE	TRUE	1	TRUE	TRUE	1	1
FBgn0039732	61	54	33	48	94	102	TRUE	TRUE	TRUE	1	TRUE	TRUE	1	1
FBgn0039733	102	109	70	90	172	199	TRUE	TRUE	TRUE	1	TRUE	TRUE	1	1
FBgn0039734	229	241	159	211	388	452	TRUE	FALSE	FALSE	0	TRUE	TRUE	1	0
FBgn0039735	50	56	46	36	96	92	TRUE	TRUE	TRUE	1	TRUE	TRUE	1	1
FBgn0039736	223	210	165	183	388	393	TRUE	TRUE	TRUE	1	TRUE	TRUE	1	1
FBgn0039737	169	148	141	162	310	310	TRUE	TRUE	TRUE	1	TRUE	TRUE	1	1
FBgn0039738	345	341	324	297	669	638	TRUE	TRUE	TRUE	1	TRUE	TRUE	1	1
FBgn0039739	22	20	20	21	42	41	TRUE	TRUE	TRUE	1	TRUE	TRUE	1	1
FBgn0039740	75	77	73	76	148	153	TRUE	TRUE	TRUE	1	TRUE	TRUE	1	1
FBgn0039741	169	137	102	109	271	246	FALSE	TRUE	TRUE	0	TRUE	TRUE	1	0
FBgn0039742	38	27	26	25	64	52	TRUE	TRUE	TRUE	1	TRUE	TRUE	1	1
FBgn0039743	131	115	100	121	231	236	TRUE	TRUE	TRUE	1	TRUE	TRUE	1	1
FBgn0039744	44	34	43	36	87	70	TRUE	TRUE	TRUE	1	TRUE	TRUE	1	1
FBgn0039747	161	161	116	138	277	299	TRUE	TRUE	TRUE	1	TRUE	TRUE	1	1
FBgn0039748	89	101	65	62	154	163	TRUE	TRUE	TRUE	1	TRUE	TRUE	1	1
FBgn0039749	213	202	193	170	406	372	TRUE	TRUE	TRUE	1	TRUE	TRUE	1	1
FBgn0039751	191	186	152	147	343	333	TRUE	TRUE	TRUE	1	TRUE	TRUE	1	1
FBgn0039752	143	166	147	128	290	294	TRUE	TRUE	TRUE	1	TRUE	TRUE	1	1
FBgn0039754	207	181	145	150	352	331	TRUE	TRUE	TRUE	1	TRUE	TRUE	1	1
FBgn0039755	133	138	110	93	243	231	TRUE	TRUE	TRUE	1	TRUE	TRUE	1	1
FBgn0039756	205	189	173	134	378	323	TRUE	FALSE	FALSE	0	TRUE	TRUE	1	0
FBgn0039757	68	71	67	62	135	133	TRUE	TRUE	TRUE	1	TRUE	TRUE	1	1
FBgn0039758	188	200	158	156	346	356	TRUE	TRUE	TRUE	1	TRUE	TRUE	1	1
FBgn0039759	203	203	174	158	377	361	TRUE	TRUE	TRUE	1	TRUE	TRUE	1	1
FBgn0039760	144	189	118	149	262	338	FALSE	FALSE	FALSE	0	TRUE	TRUE	1	0
FBgn0039761	130	123	102	112	232	235	TRUE	TRUE	TRUE	1	TRUE	TRUE	1	1
FBgn0039764	69	87	58	62	127	149	TRUE	TRUE	TRUE	1	TRUE	TRUE	1	1
FBgn0039765	20	30	21	18	41	48	TRUE	TRUE	TRUE	1	TRUE	TRUE	1	1
FBgn0039766	30	40	34	30	64	70	TRUE	TRUE	TRUE	1	TRUE	TRUE	1	1
FBgn0039767	164	146	143	167	307	313	TRUE	TRUE	TRUE	1	TRUE	TRUE	1	1
FBgn0039768	222	190	174	211	396	401	TRUE	FALSE	TRUE	0	TRUE	TRUE	1	0
FBgn0039769	223	224	159	191	382	415	TRUE	FALSE	TRUE	0	TRUE	TRUE	1	0
FBgn0039770	124	128	112	94	236	222	TRUE	TRUE	TRUE	1	TRUE	TRUE	1	1
FBgn0039771	113	125	101	129	214	254	TRUE	FALSE	FALSE	0	TRUE	TRUE	1	0
FBgn0039773	213	192	158	113	371	305	TRUE	FALSE	FALSE	0	TRUE	TRUE	1	0
FBgn0039774	338	340	274	255	612	595	TRUE	TRUE	TRUE	1	TRUE	TRUE	1	1
FBgn0039776	294	297	270	239	564	536	TRUE	TRUE	TRUE	1	TRUE	TRUE	1	1
FBgn0039777	71	68	71	55	142	123	TRUE	TRUE	TRUE	1	TRUE	TRUE	1	1
FBgn0039778	63	87	60	67	123	154	FALSE	TRUE	FALSE	0	TRUE	TRUE	1	0
FBgn0039779	143	150	151	110	294	260	TRUE	FALSE	TRUE	0	TRUE	TRUE	1	0
FBgn0039780	249	259	210	183	459	442	TRUE	TRUE	TRUE	1	TRUE	TRUE	1	1
FBgn0039782	150	175	129	156	279	331	TRUE	TRUE	FALSE	0	TRUE	TRUE	1	0
FBgn0039783	170	187	149	146	319	333	TRUE	TRUE	TRUE	1	TRUE	TRUE	1	1
FBgn0039784	148	158	123	134	271	292	TRUE	TRUE	TRUE	1	TRUE	TRUE	1	1
FBgn0039787	87	105	88	82	175	187	TRUE	TRUE	TRUE	1	TRUE	TRUE	1	1
FBgn0039788	20	28	23	35	43	63	TRUE	TRUE	FALSE	0	TRUE	FALSE	0	0
FBgn0039789	293	259	220	226	513	485	TRUE	TRUE	TRUE	1	TRUE	TRUE	1	1
FBgn0039790	282	286	263	267	545	553	TRUE	TRUE	TRUE	1	TRUE	TRUE	1	1
FBgn0039792	164	206	151	151	315	357	FALSE	TRUE	TRUE	0	TRUE	TRUE	1	0
FBgn0039795	134	143	109	107	243	250	TRUE	TRUE	TRUE	1	TRUE	TRUE	1	1
FBgn0039796	143	144	105	131	248	275	TRUE	TRUE	TRUE	1	TRUE	TRUE	1	1
FBgn0039797	101	148	92	96	193	244	FALSE	TRUE	FALSE	0	TRUE	TRUE	1	0
FBgn0039798	93	102	66	78	159	180	TRUE	TRUE	TRUE	1	TRUE	TRUE	1	1
FBgn0039799	140	122	112	96	252	218	TRUE	TRUE	TRUE	1	TRUE	TRUE	1	1
FBgn0039800	63	72	50	53	113	125	TRUE	TRUE	TRUE	1	TRUE	TRUE	1	1
FBgn0039801	96	83	93	77	189	160	TRUE	TRUE	TRUE	1	TRUE	TRUE	1	1
FBgn0039802	91	99	69	77	160	176	TRUE	TRUE	TRUE	1	TRUE	TRUE	1	1
FBgn0039804	409	343	332	282	741	625	FALSE	FALSE	FALSE	0	TRUE	TRUE	1	0
FBgn0039805	147	133	91	135	238	268	TRUE	FALSE	TRUE	0	TRUE	TRUE	1	0
FBgn0039806	147	165	108	132	255	297	TRUE	TRUE	FALSE	0	TRUE	TRUE	1	0
FBgn0039807	208	215	147	175	355	390	TRUE	TRUE	TRUE	1	TRUE	TRUE	1	1
FBgn0039808	163	198	127	151	290	349	FALSE	TRUE	FALSE	0	TRUE	TRUE	1	0
FBgn0039809	119	92	85	86	204	178	FALSE	TRUE	TRUE	0	TRUE	TRUE	1	0
FBgn0039810	103	100	96	65	199	165	TRUE	FALSE	FALSE	0	TRUE	TRUE	1	0
FBgn0039811	60	57	55	59	115	116	TRUE	TRUE	TRUE	1	TRUE	TRUE	1	1
FBgn0039812	184	213	199	188	383	401	TRUE	TRUE	TRUE	1	TRUE	TRUE	1	1
FBgn0039816	107	114	113	111	220	225	TRUE	TRUE	TRUE	1	TRUE	TRUE	1	1
FBgn0039817	210	187	199	181	409	368	TRUE	TRUE	TRUE	1	TRUE	TRUE	1	1
FBgn0039818	275	259	243	197	518	456	TRUE	FALSE	FALSE	0	TRUE	TRUE	1	0
FBgn0039820	90	90	55	60	145	150	TRUE	TRUE	TRUE	1	TRUE	TRUE	1	1
FBgn0039821	187	201	160	183	347	384	TRUE	TRUE	TRUE	1	TRUE	TRUE	1	1
FBgn0039827	241	244	218	184	459	428	TRUE	FALSE	TRUE	0	TRUE	TRUE	1	0
FBgn0039828	51	46	31	40	82	86	TRUE	TRUE	TRUE	1	TRUE	TRUE	1	1
FBgn0039829	51	60	45	44	96	104	TRUE	TRUE	TRUE	1	TRUE	TRUE	1	1
FBgn0039830	68	61	65	57	133	118	TRUE	TRUE	TRUE	1	TRUE	TRUE	1	1
FBgn0039831	314	345	275	282	589	627	TRUE	TRUE	TRUE	1	TRUE	TRUE	1	1
FBgn0039832	27	36	26	33	53	69	TRUE	TRUE	TRUE	1	TRUE	TRUE	1	1
FBgn0039833	141	134	93	99	234	233	TRUE	TRUE	TRUE	1	TRUE	TRUE	1	1
FBgn0039835	75	67	64	57	139	124	TRUE	TRUE	TRUE	1	TRUE	TRUE	1	1
FBgn0039836	86	96	97	69	183	165	TRUE	FALSE	TRUE	0	TRUE	TRUE	1	0
FBgn0039838	129	110	116	99	245	209	TRUE	TRUE	TRUE	1	TRUE	TRUE	1	1
FBgn0039839	177	166	118	122	295	288	TRUE	TRUE	TRUE	1	TRUE	TRUE	1	1
FBgn0039840	347	264	256	236	603	500	FALSE	TRUE	FALSE	0	TRUE	TRUE	1	0
FBgn0039844	239	251	236	226	475	477	TRUE	TRUE	TRUE	1	TRUE	TRUE	1	1
FBgn0039846	194	177	125	136	319	313	TRUE	TRUE	TRUE	1	TRUE	TRUE	1	1
FBgn0039848	33	38	20	20	53	58	TRUE	TRUE	TRUE	1	TRUE	TRUE	1	1
FBgn0039849	58	56	40	53	98	109	TRUE	TRUE	TRUE	1	TRUE	TRUE	1	1
FBgn0039850	34	24	26	38	60	62	TRUE	TRUE	TRUE	1	TRUE	TRUE	1	1
FBgn0039851	133	134	110	113	243	247	TRUE	TRUE	TRUE	1	TRUE	TRUE	1	1
FBgn0039852	157	171	147	159	304	330	TRUE	TRUE	TRUE	1	TRUE	TRUE	1	1
FBgn0039855	114	134	94	97	208	231	TRUE	TRUE	TRUE	1	TRUE	TRUE	1	1
FBgn0039856	99	83	62	96	161	179	TRUE	FALSE	TRUE	0	TRUE	FALSE	0	0
FBgn0039857	45	52	48	35	93	87	TRUE	TRUE	TRUE	1	TRUE	TRUE	1	1
FBgn0039858	143	136	110	105	253	241	TRUE	TRUE	TRUE	1	TRUE	TRUE	1	1
FBgn0039859	29	27	14	18	43	45	TRUE	TRUE	TRUE	1	TRUE	TRUE	1	1
FBgn0039860	77	82	102	71	179	153	TRUE	FALSE	TRUE	0	TRUE	TRUE	1	0
FBgn0039861	83	72	74	68	157	140	TRUE	TRUE	TRUE	1	TRUE	TRUE	1	1
FBgn0039862	340	353	269	286	609	639	TRUE	TRUE	TRUE	1	TRUE	TRUE	1	1
FBgn0039863	202	202	201	171	403	373	TRUE	TRUE	TRUE	1	TRUE	TRUE	1	1
FBgn0039864	91	84	74	73	165	157	TRUE	TRUE	TRUE	1	TRUE	TRUE	1	1
FBgn0039868	27	25	23	28	50	53	TRUE	TRUE	TRUE	1	TRUE	TRUE	1	1
FBgn0039869	33	22	21	30	54	52	TRUE	TRUE	TRUE	1	TRUE	TRUE	1	1
FBgn0039873	41	44	29	26	70	70	TRUE	TRUE	TRUE	1	TRUE	TRUE	1	1
FBgn0039875	19	15	25	14	44	29	TRUE	TRUE	TRUE	1	TRUE	FALSE	0	0
FBgn0039877	117	102	86	81	203	183	TRUE	TRUE	TRUE	1	TRUE	TRUE	1	1
FBgn0039879	43	31	28	42	71	73	TRUE	TRUE	TRUE	1	TRUE	TRUE	1	1
FBgn0039881	52	63	36	50	88	113	TRUE	TRUE	FALSE	0	TRUE	TRUE	1	0
FBgn0039882	23	15	16	19	39	34	TRUE	TRUE	TRUE	1	FALSE	TRUE	0	0
FBgn0039883	338	356	299	323	637	679	TRUE	TRUE	TRUE	1	TRUE	TRUE	1	1
FBgn0039886	163	162	128	127	291	289	TRUE	TRUE	TRUE	1	TRUE	TRUE	1	1
FBgn0039887	64	57	41	39	105	96	TRUE	TRUE	TRUE	1	TRUE	TRUE	1	1
FBgn0039889	19	14	18	18	37	32	TRUE	TRUE	TRUE	1	TRUE	TRUE	1	1
FBgn0039890	147	154	134	119	281	273	TRUE	TRUE	TRUE	1	TRUE	TRUE	1	1
FBgn0039896	44	48	40	23	84	71	TRUE	FALSE	TRUE	0	TRUE	FALSE	0	0
FBgn0039897	105	87	83	80	188	167	TRUE	TRUE	TRUE	1	TRUE	TRUE	1	1
FBgn0039900	157	156	125	139	282	295	TRUE	TRUE	TRUE	1	TRUE	TRUE	1	1
FBgn0039902	40	27	18	20	58	47	TRUE	TRUE	TRUE	1	TRUE	TRUE	1	1
FBgn0039904	195	218	191	190	386	408	TRUE	TRUE	TRUE	1	TRUE	TRUE	1	1
FBgn0039907	50	46	38	39	88	85	TRUE	TRUE	TRUE	1	TRUE	TRUE	1	1
FBgn0039908	137	140	80	100	217	240	TRUE	TRUE	TRUE	1	TRUE	TRUE	1	1
FBgn0039911	15	18	21	19	36	37	TRUE	TRUE	TRUE	1	TRUE	TRUE	1	1
FBgn0039914	25	29	31	19	56	48	TRUE	TRUE	TRUE	1	TRUE	FALSE	0	0
FBgn0039915	40	50	38	29	78	79	TRUE	TRUE	TRUE	1	TRUE	TRUE	1	1
FBgn0039916	26	20	25	21	51	41	TRUE	TRUE	TRUE	1	TRUE	TRUE	1	1
FBgn0039920	130	125	117	113	247	238	TRUE	TRUE	TRUE	1	TRUE	TRUE	1	1
FBgn0039923	97	106	106	82	203	188	TRUE	FALSE	TRUE	0	TRUE	TRUE	1	0
FBgn0039924	42	39	35	36	77	75	TRUE	TRUE	TRUE	1	TRUE	TRUE	1	1
FBgn0039925	100	130	115	86	215	216	FALSE	FALSE	TRUE	0	TRUE	TRUE	1	0
FBgn0039927	191	209	163	150	354	359	TRUE	TRUE	TRUE	1	TRUE	TRUE	1	1
FBgn0039928	84	89	55	78	139	167	TRUE	FALSE	TRUE	0	TRUE	TRUE	1	0
FBgn0039932	47	50	47	42	94	92	TRUE	TRUE	TRUE	1	TRUE	TRUE	1	1
FBgn0039936	94	93	74	103	168	196	TRUE	FALSE	TRUE	0	TRUE	TRUE	1	0
FBgn0039937	33	32	16	26	49	58	TRUE	TRUE	TRUE	1	TRUE	FALSE	0	0
FBgn0039938	58	97	38	60	96	157	FALSE	FALSE	FALSE	0	FALSE	FALSE	0	0
FBgn0039955	91	63	62	61	153	124	FALSE	TRUE	FALSE	0	TRUE	TRUE	1	0
FBgn0039958	47	48	44	44	91	92	TRUE	TRUE	TRUE	1	TRUE	TRUE	1	1
FBgn0039959	122	113	108	95	230	208	TRUE	TRUE	TRUE	1	TRUE	TRUE	1	1
FBgn0039970	139	129	95	103	234	232	TRUE	TRUE	TRUE	1	TRUE	TRUE	1	1
FBgn0039972	183	149	169	147	352	296	FALSE	TRUE	FALSE	0	TRUE	TRUE	1	0
FBgn0039977	51	45	31	35	82	80	TRUE	TRUE	TRUE	1	TRUE	TRUE	1	1
FBgn0039993	59	56	38	50	97	106	TRUE	TRUE	TRUE	1	TRUE	TRUE	1	1
FBgn0039994	96	85	92	53	188	138	TRUE	FALSE	FALSE	0	TRUE	FALSE	0	0
FBgn0040001	44	41	34	45	78	86	TRUE	TRUE	TRUE	1	TRUE	TRUE	1	1
FBgn0040005	74	55	77	48	151	103	TRUE	FALSE	FALSE	0	TRUE	FALSE	0	0
FBgn0040007	27	34	36	31	63	65	TRUE	TRUE	TRUE	1	TRUE	TRUE	1	1
FBgn0040009	59	57	51	45	110	102	TRUE	TRUE	TRUE	1	TRUE	TRUE	1	1
FBgn0040010	353	371	349	346	702	717	TRUE	TRUE	TRUE	1	TRUE	TRUE	1	1
FBgn0040011	79	105	80	67	159	172	FALSE	TRUE	TRUE	0	TRUE	TRUE	1	0
FBgn0040020	31	36	21	19	52	55	TRUE	TRUE	TRUE	1	TRUE	TRUE	1	1
FBgn0040022	77	69	81	65	158	134	TRUE	TRUE	TRUE	1	TRUE	TRUE	1	1
FBgn0040056	106	115	102	109	208	224	TRUE	TRUE	TRUE	1	TRUE	TRUE	1	1
FBgn0040060	85	94	72	79	157	173	TRUE	TRUE	TRUE	1	TRUE	TRUE	1	1
FBgn0040063	96	83	86	66	182	149	TRUE	TRUE	FALSE	0	TRUE	TRUE	1	0
FBgn0040064	185	165	103	148	288	313	TRUE	FALSE	TRUE	0	TRUE	TRUE	1	0
FBgn0040070	132	133	93	108	225	241	TRUE	TRUE	TRUE	1	TRUE	TRUE	1	1
FBgn0040071	197	207	172	153	369	360	TRUE	TRUE	TRUE	1	TRUE	TRUE	1	1
FBgn0040074	77	74	62	56	139	130	TRUE	TRUE	TRUE	1	TRUE	TRUE	1	1
FBgn0040075	47	48	47	45	94	93	TRUE	TRUE	TRUE	1	TRUE	TRUE	1	1
FBgn0040078	72	68	58	69	130	137	TRUE	TRUE	TRUE	1	TRUE	TRUE	1	1
FBgn0040079	199	191	160	201	359	392	TRUE	FALSE	TRUE	0	TRUE	TRUE	1	0
FBgn0040080	188	220	166	170	354	390	TRUE	TRUE	TRUE	1	TRUE	TRUE	1	1
FBgn0040091	54	77	55	58	109	135	FALSE	TRUE	TRUE	0	TRUE	TRUE	1	0
FBgn0040092	48	56	39	37	87	93	TRUE	TRUE	TRUE	1	TRUE	TRUE	1	1
FBgn0040093	106	91	97	96	203	187	TRUE	TRUE	TRUE	1	TRUE	TRUE	1	1
FBgn0040096	46	35	46	40	92	75	TRUE	TRUE	TRUE	1	TRUE	TRUE	1	1
FBgn0040097	88	111	75	86	163	197	TRUE	TRUE	FALSE	0	TRUE	TRUE	1	0
FBgn0040098	49	57	47	35	96	92	TRUE	TRUE	TRUE	1	TRUE	TRUE	1	1
FBgn0040099	79	74	66	67	145	141	TRUE	TRUE	TRUE	1	TRUE	TRUE	1	1
FBgn0040102	105	105	76	87	181	192	TRUE	TRUE	TRUE	1	TRUE	TRUE	1	1
FBgn0040104	30	34	31	35	61	69	TRUE	TRUE	TRUE	1	TRUE	TRUE	1	1
FBgn0040106	81	78	75	72	156	150	TRUE	TRUE	TRUE	1	TRUE	TRUE	1	1
FBgn0040107	79	69	54	63	133	132	TRUE	TRUE	TRUE	1	TRUE	TRUE	1	1
FBgn0040206	97	77	72	74	169	151	TRUE	TRUE	TRUE	1	TRUE	TRUE	1	1
FBgn0040208	94	84	84	72	178	156	TRUE	TRUE	TRUE	1	TRUE	TRUE	1	1
FBgn0040211	202	236	192	178	394	414	TRUE	TRUE	TRUE	1	TRUE	TRUE	1	1
FBgn0040212	300	288	226	261	526	549	TRUE	TRUE	TRUE	1	TRUE	TRUE	1	1
FBgn0040227	29	24	36	40	65	64	TRUE	TRUE	TRUE	1	TRUE	TRUE	1	1
FBgn0040228	91	77	52	56	143	133	TRUE	TRUE	TRUE	1	TRUE	TRUE	1	1
FBgn0040230	245	235	191	170	436	405	TRUE	TRUE	TRUE	1	TRUE	TRUE	1	1
FBgn0040232	228	225	177	189	405	414	TRUE	TRUE	TRUE	1	TRUE	TRUE	1	1
FBgn0040233	426	420	382	373	808	793	TRUE	TRUE	TRUE	1	TRUE	TRUE	1	1
FBgn0040237	199	168	148	149	347	317	TRUE	TRUE	TRUE	1	TRUE	TRUE	1	1
FBgn0040238	89	85	73	62	162	147	TRUE	TRUE	TRUE	1	TRUE	TRUE	1	1
FBgn0040239	72	80	54	57	126	137	TRUE	TRUE	TRUE	1	TRUE	TRUE	1	1
FBgn0040250	169	144	133	125	302	269	TRUE	TRUE	TRUE	1	TRUE	TRUE	1	1
FBgn0040251	161	168	136	138	297	306	TRUE	TRUE	TRUE	1	TRUE	TRUE	1	1
FBgn0040252	289	281	238	239	527	520	TRUE	TRUE	TRUE	1	TRUE	TRUE	1	1
FBgn0040253	173	168	143	175	316	343	TRUE	FALSE	TRUE	0	TRUE	TRUE	1	0
FBgn0040255	135	159	154	110	289	269	TRUE	FALSE	TRUE	0	TRUE	TRUE	1	0
FBgn0040256	128	138	112	131	240	269	TRUE	TRUE	TRUE	1	TRUE	TRUE	1	1
FBgn0040257	128	112	113	102	241	214	TRUE	TRUE	TRUE	1	TRUE	TRUE	1	1
FBgn0040259	162	183	151	130	313	313	TRUE	TRUE	TRUE	1	TRUE	TRUE	1	1
FBgn0040260	175	185	129	149	304	334	TRUE	TRUE	TRUE	1	TRUE	TRUE	1	1
FBgn0040261	206	164	164	144	370	308	FALSE	TRUE	FALSE	0	TRUE	TRUE	1	0
FBgn0040262	165	163	161	134	326	297	TRUE	TRUE	TRUE	1	TRUE	TRUE	1	1
FBgn0040268	92	117	77	89	169	206	FALSE	TRUE	FALSE	0	TRUE	TRUE	1	0
FBgn0040271	393	403	310	291	703	694	TRUE	TRUE	TRUE	1	TRUE	TRUE	1	1
FBgn0040273	289	306	219	215	508	521	TRUE	TRUE	TRUE	1	TRUE	TRUE	1	1
FBgn0040281	220	230	238	196	458	426	TRUE	FALSE	TRUE	0	TRUE	TRUE	1	0
FBgn0040283	294	279	233	262	527	541	TRUE	TRUE	TRUE	1	TRUE	TRUE	1	1
FBgn0040290	405	382	346	326	751	708	TRUE	TRUE	TRUE	1	TRUE	TRUE	1	1
FBgn0040294	185	175	142	121	327	296	TRUE	TRUE	TRUE	1	TRUE	TRUE	1	1
FBgn0040296	88	78	74	72	162	150	TRUE	TRUE	TRUE	1	TRUE	TRUE	1	1
FBgn0040297	184	230	167	160	351	390	FALSE	TRUE	TRUE	0	TRUE	TRUE	1	0
FBgn0040298	131	102	96	87	227	189	FALSE	TRUE	FALSE	0	TRUE	TRUE	1	0
FBgn0040299	614	617	522	534	1136	1151	TRUE	TRUE	TRUE	1	TRUE	TRUE	1	1
FBgn0040305	118	144	125	128	243	272	TRUE	TRUE	TRUE	1	TRUE	TRUE	1	1
FBgn0040308	143	148	98	101	241	249	TRUE	TRUE	TRUE	1	TRUE	TRUE	1	1
FBgn0040318	220	197	165	190	385	387	TRUE	TRUE	TRUE	1	TRUE	TRUE	1	1
FBgn0040321	121	134	114	85	235	219	TRUE	FALSE	TRUE	0	TRUE	TRUE	1	0
FBgn0040322	83	68	78	75	161	143	TRUE	TRUE	TRUE	1	TRUE	TRUE	1	1
FBgn0040323	85	89	72	66	157	155	TRUE	TRUE	TRUE	1	TRUE	TRUE	1	1
FBgn0040324	36	37	29	27	65	64	TRUE	TRUE	TRUE	1	TRUE	TRUE	1	1
FBgn0040465	62	62	42	60	104	122	TRUE	FALSE	TRUE	0	TRUE	TRUE	1	0
FBgn0040475	138	160	143	144	281	304	TRUE	TRUE	TRUE	1	TRUE	TRUE	1	1
FBgn0040477	63	64	66	60	129	124	TRUE	TRUE	TRUE	1	TRUE	TRUE	1	1
FBgn0040487	43	55	48	52	91	107	TRUE	TRUE	TRUE	1	TRUE	TRUE	1	1
FBgn0040491	115	103	103	86	218	189	TRUE	TRUE	TRUE	1	TRUE	TRUE	1	1
FBgn0040493	189	178	144	140	333	318	TRUE	TRUE	TRUE	1	TRUE	TRUE	1	1
FBgn0040496	158	151	149	153	307	304	TRUE	TRUE	TRUE	1	TRUE	TRUE	1	1
FBgn0040503	92	99	98	81	190	180	TRUE	TRUE	TRUE	1	TRUE	TRUE	1	1
FBgn0040505	831	814	701	653	1532	1467	TRUE	TRUE	TRUE	1	TRUE	TRUE	1	1
FBgn0040506	115	102	97	87	212	189	TRUE	TRUE	TRUE	1	TRUE	TRUE	1	1
FBgn0040507	124	118	76	62	200	180	TRUE	TRUE	TRUE	1	TRUE	TRUE	1	1
FBgn0040508	224	221	201	180	425	401	TRUE	TRUE	TRUE	1	TRUE	TRUE	1	1
FBgn0040509	85	76	58	58	143	134	TRUE	TRUE	TRUE	1	TRUE	TRUE	1	1
FBgn0040510	108	90	68	92	176	182	TRUE	FALSE	TRUE	0	TRUE	TRUE	1	0
FBgn0040512	137	174	108	147	245	321	FALSE	FALSE	FALSE	0	TRUE	TRUE	1	0
FBgn0040519	40	46	37	33	77	79	TRUE	TRUE	TRUE	1	TRUE	TRUE	1	1
FBgn0040528	67	70	68	63	135	133	TRUE	TRUE	TRUE	1	TRUE	TRUE	1	1
FBgn0040532	28	42	26	36	54	78	TRUE	TRUE	FALSE	0	TRUE	TRUE	1	0
FBgn0040551	79	80	56	53	135	133	TRUE	TRUE	TRUE	1	TRUE	TRUE	1	1
FBgn0040553	28	24	23	22	51	46	TRUE	TRUE	TRUE	1	TRUE	TRUE	1	1
FBgn0040565	126	100	78	93	204	193	FALSE	TRUE	TRUE	0	TRUE	TRUE	1	0
FBgn0040569	46	55	39	34	85	89	TRUE	TRUE	TRUE	1	TRUE	TRUE	1	1
FBgn0040571	214	237	191	174	405	411	TRUE	TRUE	TRUE	1	TRUE	TRUE	1	1
FBgn0040575	52	32	39	25	91	57	FALSE	TRUE	FALSE	0	FALSE	FALSE	0	0
FBgn0040582	89	75	86	77	175	152	TRUE	TRUE	TRUE	1	TRUE	TRUE	1	1
FBgn0040588	60	46	51	38	111	84	TRUE	TRUE	FALSE	0	TRUE	TRUE	1	0
FBgn0040600	130	127	80	89	210	216	TRUE	TRUE	TRUE	1	TRUE	TRUE	1	1
FBgn0040601	297	297	265	226	562	523	TRUE	FALSE	TRUE	0	TRUE	TRUE	1	0
FBgn0040606	60	47	39	37	99	84	TRUE	TRUE	TRUE	1	TRUE	TRUE	1	1
FBgn0040607	53	49	57	58	110	107	TRUE	TRUE	TRUE	1	TRUE	TRUE	1	1
FBgn0040608	64	82	43	61	107	143	TRUE	FALSE	FALSE	0	TRUE	TRUE	1	0
FBgn0040609	30	39	29	39	59	78	TRUE	TRUE	TRUE	1	TRUE	TRUE	1	1
FBgn0040628	53	57	53	46	106	103	TRUE	TRUE	TRUE	1	TRUE	TRUE	1	1
FBgn0040629	61	56	41	48	102	104	TRUE	TRUE	TRUE	1	TRUE	TRUE	1	1
FBgn0040636	25	25	25	34	50	59	TRUE	TRUE	TRUE	1	TRUE	TRUE	1	1
FBgn0040637	18	17	25	21	43	38	TRUE	TRUE	TRUE	1	TRUE	TRUE	1	1
FBgn0040653	72	82	83	69	155	151	TRUE	TRUE	TRUE	1	TRUE	TRUE	1	1
FBgn0040658	118	124	95	110	213	234	TRUE	TRUE	TRUE	1	TRUE	TRUE	1	1
FBgn0040660	27	24	32	31	59	55	TRUE	TRUE	TRUE	1	TRUE	TRUE	1	1
FBgn0040670	29	21	25	19	54	40	TRUE	TRUE	TRUE	1	TRUE	TRUE	1	1
FBgn0040674	38	38	24	23	62	61	TRUE	TRUE	TRUE	1	TRUE	TRUE	1	1
FBgn0040679	38	35	41	39	79	74	TRUE	TRUE	TRUE	1	TRUE	TRUE	1	1
FBgn0040682	52	63	49	55	101	118	TRUE	TRUE	TRUE	1	TRUE	TRUE	1	1
FBgn0040684	126	106	95	93	221	199	TRUE	TRUE	TRUE	1	TRUE	TRUE	1	1
FBgn0040694	65	86	72	69	137	155	TRUE	TRUE	TRUE	1	TRUE	TRUE	1	1
FBgn0040696	79	68	79	51	158	119	TRUE	FALSE	FALSE	0	TRUE	FALSE	0	0
FBgn0040697	92	94	87	71	179	165	TRUE	TRUE	TRUE	1	TRUE	TRUE	1	1
FBgn0040705	40	40	26	39	66	79	TRUE	TRUE	TRUE	1	TRUE	TRUE	1	1
FBgn0040717	64	63	44	49	108	112	TRUE	TRUE	TRUE	1	TRUE	TRUE	1	1
FBgn0040719	67	81	64	52	131	133	TRUE	TRUE	TRUE	1	TRUE	TRUE	1	1
FBgn0040723	39	37	44	32	83	69	TRUE	TRUE	TRUE	1	TRUE	TRUE	1	1
FBgn0040725	53	43	39	33	92	76	TRUE	TRUE	TRUE	1	TRUE	TRUE	1	1
FBgn0040726	361	326	338	271	699	597	TRUE	FALSE	FALSE	0	TRUE	TRUE	1	0
FBgn0040729	37	36	41	26	78	62	TRUE	FALSE	TRUE	0	TRUE	FALSE	0	0
FBgn0040730	61	46	43	45	104	91	TRUE	TRUE	TRUE	1	TRUE	TRUE	1	1
FBgn0040732	90	92	72	66	162	158	TRUE	TRUE	TRUE	1	TRUE	TRUE	1	1
FBgn0040733	44	30	27	36	71	66	TRUE	TRUE	TRUE	1	TRUE	TRUE	1	1
FBgn0040734	50	35	28	33	78	68	TRUE	TRUE	TRUE	1	TRUE	TRUE	1	1
FBgn0040735	70	59	66	70	136	129	TRUE	TRUE	TRUE	1	TRUE	TRUE	1	1
FBgn0040736	111	98	85	101	196	199	TRUE	TRUE	TRUE	1	TRUE	TRUE	1	1
FBgn0040737	21	18	22	28	43	46	TRUE	TRUE	TRUE	1	TRUE	TRUE	1	1
FBgn0040747	51	46	50	41	101	87	TRUE	TRUE	TRUE	1	TRUE	TRUE	1	1
FBgn0040752	560	655	474	492	1034	1147	FALSE	TRUE	FALSE	0	TRUE	TRUE	1	0
FBgn0040754	26	23	19	26	45	49	TRUE	TRUE	TRUE	1	TRUE	TRUE	1	1
FBgn0040755	110	104	91	83	201	187	TRUE	TRUE	TRUE	1	TRUE	TRUE	1	1
FBgn0040763	29	29	14	22	43	51	TRUE	TRUE	TRUE	1	TRUE	FALSE	0	0
FBgn0040764	45	61	41	39	86	100	TRUE	TRUE	TRUE	1	TRUE	TRUE	1	1
FBgn0040765	544	467	468	421	1012	888	FALSE	TRUE	FALSE	0	TRUE	TRUE	1	0
FBgn0040773	64	55	47	31	111	86	TRUE	FALSE	FALSE	0	TRUE	FALSE	0	0
FBgn0040775	37	48	39	33	76	81	TRUE	TRUE	TRUE	1	TRUE	TRUE	1	1
FBgn0040777	92	83	79	73	171	156	TRUE	TRUE	TRUE	1	TRUE	TRUE	1	1
FBgn0040778	46	32	32	42	78	74	TRUE	TRUE	TRUE	1	TRUE	TRUE	1	1
FBgn0040780	34	16	22	25	56	41	FALSE	TRUE	TRUE	0	FALSE	TRUE	0	0
FBgn0040794	63	44	66	58	129	102	FALSE	TRUE	FALSE	0	TRUE	TRUE	1	0
FBgn0040795	86	83	80	65	166	148	TRUE	TRUE	TRUE	1	TRUE	TRUE	1	1
FBgn0040796	38	30	36	34	74	64	TRUE	TRUE	TRUE	1	TRUE	TRUE	1	1
FBgn0040797	50	44	36	36	86	80	TRUE	TRUE	TRUE	1	TRUE	TRUE	1	1
FBgn0040799	36	48	36	35	72	83	TRUE	TRUE	TRUE	1	TRUE	TRUE	1	1
FBgn0040801	33	37	28	23	61	60	TRUE	TRUE	TRUE	1	TRUE	TRUE	1	1
FBgn0040805	213	194	187	162	400	356	TRUE	TRUE	TRUE	1	TRUE	TRUE	1	1
FBgn0040809	56	57	60	55	116	112	TRUE	TRUE	TRUE	1	TRUE	TRUE	1	1
FBgn0040812	54	51	40	52	94	103	TRUE	TRUE	TRUE	1	TRUE	TRUE	1	1
FBgn0040813	49	44	48	48	97	92	TRUE	TRUE	TRUE	1	TRUE	TRUE	1	1
FBgn0040816	52	51	46	41	98	92	TRUE	TRUE	TRUE	1	TRUE	TRUE	1	1
FBgn0040817	77	79	61	65	138	144	TRUE	TRUE	TRUE	1	TRUE	TRUE	1	1
FBgn0040823	481	518	474	455	955	973	TRUE	TRUE	TRUE	1	TRUE	TRUE	1	1
FBgn0040827	66	53	41	50	107	103	TRUE	TRUE	TRUE	1	TRUE	TRUE	1	1
FBgn0040828	366	378	52	54	418	432	TRUE	TRUE	TRUE	1	TRUE	TRUE	1	1
FBgn0040832	81	81	71	66	152	147	TRUE	TRUE	TRUE	1	TRUE	TRUE	1	1
FBgn0040837	100	78	91	70	191	148	TRUE	TRUE	FALSE	0	TRUE	TRUE	1	0
FBgn0040843	44	22	31	25	75	47	FALSE	TRUE	FALSE	0	FALSE	TRUE	0	0
FBgn0040849	62	56	54	59	116	115	TRUE	TRUE	TRUE	1	TRUE	TRUE	1	1
FBgn0040959	71	55	65	73	136	128	TRUE	TRUE	TRUE	1	TRUE	TRUE	1	1
FBgn0040963	121	103	80	68	201	171	TRUE	TRUE	TRUE	1	TRUE	TRUE	1	1
FBgn0040964	64	74	58	64	122	138	TRUE	TRUE	TRUE	1	TRUE	TRUE	1	1
FBgn0040965	44	54	39	30	83	84	TRUE	TRUE	TRUE	1	TRUE	TRUE	1	1
FBgn0040967	66	67	58	45	124	112	TRUE	TRUE	TRUE	1	TRUE	TRUE	1	1
FBgn0040972	53	58	53	48	106	106	TRUE	TRUE	TRUE	1	TRUE	TRUE	1	1
FBgn0040973	76	53	50	42	126	95	FALSE	TRUE	FALSE	0	TRUE	TRUE	1	0
FBgn0040984	36	26	30	25	66	51	TRUE	TRUE	TRUE	1	TRUE	TRUE	1	1
FBgn0040985	74	61	58	61	132	122	TRUE	TRUE	TRUE	1	TRUE	TRUE	1	1
FBgn0040989	29	29	25	23	54	52	TRUE	TRUE	TRUE	1	TRUE	TRUE	1	1
FBgn0040996	89	66	55	59	144	125	FALSE	TRUE	TRUE	0	TRUE	TRUE	1	0
FBgn0041087	187	169	129	140	316	309	TRUE	TRUE	TRUE	1	TRUE	TRUE	1	1
FBgn0041092	1017	1026	811	812	1828	1838	TRUE	TRUE	TRUE	1	TRUE	TRUE	1	1
FBgn0041094	49	83	70	65	119	148	FALSE	TRUE	FALSE	0	FALSE	TRUE	0	0
FBgn0041096	620	685	530	562	1150	1247	FALSE	TRUE	FALSE	0	TRUE	TRUE	1	0
FBgn0041097	631	652	535	519	1166	1171	TRUE	TRUE	TRUE	1	TRUE	TRUE	1	1
FBgn0041102	54	64	60	44	114	108	TRUE	TRUE	TRUE	1	TRUE	TRUE	1	1
FBgn0041103	87	69	79	61	166	130	TRUE	TRUE	FALSE	0	TRUE	TRUE	1	0
FBgn0041105	50	53	37	58	87	111	TRUE	FALSE	TRUE	0	TRUE	FALSE	0	0
FBgn0041111	369	384	295	269	664	653	TRUE	TRUE	TRUE	1	TRUE	TRUE	1	1
FBgn0041147	150	163	147	142	297	305	TRUE	TRUE	TRUE	1	TRUE	TRUE	1	1
FBgn0041150	491	526	437	441	928	967	TRUE	TRUE	TRUE	1	TRUE	TRUE	1	1
FBgn0041156	231	199	180	154	411	353	TRUE	TRUE	FALSE	0	TRUE	TRUE	1	0
FBgn0041160	83	89	62	66	145	155	TRUE	TRUE	TRUE	1	TRUE	TRUE	1	1
FBgn0041164	254	278	237	249	491	527	TRUE	TRUE	TRUE	1	TRUE	TRUE	1	1
FBgn0041171	266	262	225	194	491	456	TRUE	TRUE	TRUE	1	TRUE	TRUE	1	1
FBgn0041180	220	210	203	180	423	390	TRUE	TRUE	TRUE	1	TRUE	TRUE	1	1
FBgn0041181	224	211	180	170	404	381	TRUE	TRUE	TRUE	1	TRUE	TRUE	1	1
FBgn0041182	434	420	398	323	832	743	TRUE	FALSE	FALSE	0	TRUE	TRUE	1	0
FBgn0041183	149	138	114	140	263	278	TRUE	TRUE	TRUE	1	TRUE	TRUE	1	1
FBgn0041184	235	267	217	265	452	532	TRUE	FALSE	FALSE	0	TRUE	TRUE	1	0
FBgn0041186	85	85	60	65	145	150	TRUE	TRUE	TRUE	1	TRUE	TRUE	1	1
FBgn0041188	154	182	124	141	278	323	TRUE	TRUE	FALSE	0	TRUE	TRUE	1	0
FBgn0041194	201	196	149	155	350	351	TRUE	TRUE	TRUE	1	TRUE	TRUE	1	1
FBgn0041195	304	300	296	285	600	585	TRUE	TRUE	TRUE	1	TRUE	TRUE	1	1
FBgn0041205	36	46	31	31	67	77	TRUE	TRUE	TRUE	1	TRUE	TRUE	1	1
FBgn0041224	129	144	105	112	234	256	TRUE	TRUE	TRUE	1	TRUE	TRUE	1	1
FBgn0041225	73	91	60	71	133	162	TRUE	TRUE	TRUE	1	TRUE	TRUE	1	1
FBgn0041229	67	53	59	55	126	108	TRUE	TRUE	TRUE	1	TRUE	TRUE	1	1
FBgn0041231	84	71	62	84	146	155	TRUE	FALSE	TRUE	0	TRUE	TRUE	1	0
FBgn0041232	94	113	110	85	204	198	TRUE	FALSE	TRUE	0	TRUE	TRUE	1	0
FBgn0041233	113	131	88	125	201	256	TRUE	FALSE	FALSE	0	TRUE	TRUE	1	0
FBgn0041234	119	119	118	99	237	218	TRUE	TRUE	TRUE	1	TRUE	TRUE	1	1
FBgn0041235	102	98	110	80	212	178	TRUE	FALSE	FALSE	0	TRUE	TRUE	1	0
FBgn0041236	93	103	71	70	164	173	TRUE	TRUE	TRUE	1	TRUE	TRUE	1	1
FBgn0041237	147	134	105	93	252	227	TRUE	TRUE	TRUE	1	TRUE	TRUE	1	1
FBgn0041238	182	160	108	115	290	275	TRUE	TRUE	TRUE	1	TRUE	TRUE	1	1
FBgn0041239	138	137	95	126	233	263	TRUE	FALSE	TRUE	0	TRUE	TRUE	1	0
FBgn0041240	118	140	124	97	242	237	TRUE	FALSE	TRUE	0	TRUE	TRUE	1	0
FBgn0041241	84	66	67	85	151	151	TRUE	TRUE	TRUE	1	TRUE	TRUE	1	1
FBgn0041242	139	104	108	86	247	190	FALSE	TRUE	FALSE	0	TRUE	TRUE	1	0
FBgn0041243	67	81	59	64	126	145	TRUE	TRUE	TRUE	1	TRUE	TRUE	1	1
FBgn0041245	139	127	110	121	249	248	TRUE	TRUE	TRUE	1	TRUE	TRUE	1	1
FBgn0041246	102	95	87	80	189	175	TRUE	TRUE	TRUE	1	TRUE	TRUE	1	1
FBgn0041247	174	198	143	150	317	348	TRUE	TRUE	TRUE	1	TRUE	TRUE	1	1
FBgn0041248	215	171	153	157	368	328	FALSE	TRUE	TRUE	0	TRUE	TRUE	1	0
FBgn0041249	101	113	92	93	193	206	TRUE	TRUE	TRUE	1	TRUE	TRUE	1	1
FBgn0041250	168	176	173	163	341	339	TRUE	TRUE	TRUE	1	TRUE	TRUE	1	1
FBgn0041336	76	83	61	60	137	143	TRUE	TRUE	TRUE	1	TRUE	TRUE	1	1
FBgn0041337	181	176	132	153	313	329	TRUE	TRUE	TRUE	1	TRUE	TRUE	1	1
FBgn0041342	230	279	214	196	444	475	FALSE	TRUE	TRUE	0	TRUE	TRUE	1	0
FBgn0041579	86	76	53	55	139	131	TRUE	TRUE	TRUE	1	TRUE	TRUE	1	1
FBgn0041581	96	81	58	68	154	149	TRUE	TRUE	TRUE	1	TRUE	TRUE	1	1
FBgn0041582	177	160	162	138	339	298	TRUE	TRUE	TRUE	1	TRUE	TRUE	1	1
FBgn0041585	478	485	394	419	872	904	TRUE	TRUE	TRUE	1	TRUE	TRUE	1	1
FBgn0041588	144	142	99	103	243	245	TRUE	TRUE	TRUE	1	TRUE	TRUE	1	1
FBgn0041604	282	262	270	276	552	538	TRUE	TRUE	TRUE	1	TRUE	TRUE	1	1
FBgn0041605	42	61	61	62	103	123	FALSE	TRUE	TRUE	0	TRUE	TRUE	1	0
FBgn0041621	28	36	39	27	67	63	TRUE	TRUE	TRUE	1	TRUE	TRUE	1	1
FBgn0041622	171	165	142	155	313	320	TRUE	TRUE	TRUE	1	TRUE	TRUE	1	1
FBgn0041623	138	125	118	93	256	218	TRUE	FALSE	FALSE	0	TRUE	TRUE	1	0
FBgn0041624	125	155	109	117	234	272	FALSE	TRUE	FALSE	0	TRUE	TRUE	1	0
FBgn0041625	150	142	122	127	272	269	TRUE	TRUE	TRUE	1	TRUE	TRUE	1	1
FBgn0041627	212	201	189	155	401	356	TRUE	FALSE	TRUE	0	TRUE	TRUE	1	0
FBgn0041630	178	192	147	145	325	337	TRUE	TRUE	TRUE	1	TRUE	TRUE	1	1
FBgn0041702	143	82	91	79	234	161	FALSE	TRUE	FALSE	0	FALSE	TRUE	0	0
FBgn0041706	150	160	134	132	284	292	TRUE	TRUE	TRUE	1	TRUE	TRUE	1	1
FBgn0041707	48	45	40	32	88	77	TRUE	TRUE	TRUE	1	TRUE	TRUE	1	1
FBgn0041709	195	216	96	80	291	296	TRUE	TRUE	TRUE	1	TRUE	TRUE	1	1
FBgn0041710	65	63	61	64	126	127	TRUE	TRUE	TRUE	1	TRUE	TRUE	1	1
FBgn0041711	50	51	44	33	94	84	TRUE	TRUE	TRUE	1	TRUE	TRUE	1	1
FBgn0041712	117	117	98	88	215	205	TRUE	TRUE	TRUE	1	TRUE	TRUE	1	1
FBgn0041713	53	50	54	42	107	92	TRUE	TRUE	TRUE	1	TRUE	TRUE	1	1
FBgn0041721	48	44	30	32	78	76	TRUE	TRUE	TRUE	1	TRUE	TRUE	1	1
FBgn0041723	412	404	318	352	730	756	TRUE	TRUE	TRUE	1	TRUE	TRUE	1	1
FBgn0041775	180	203	171	165	351	368	TRUE	TRUE	TRUE	1	TRUE	TRUE	1	1
FBgn0041781	199	212	149	148	348	360	TRUE	TRUE	TRUE	1	TRUE	TRUE	1	1
FBgn0041789	324	290	293	312	617	602	TRUE	TRUE	TRUE	1	TRUE	TRUE	1	1
FBgn0042083	196	202	135	143	331	345	TRUE	TRUE	TRUE	1	TRUE	TRUE	1	1
FBgn0042085	186	191	146	131	332	322	TRUE	TRUE	TRUE	1	TRUE	TRUE	1	1
FBgn0042092	94	107	73	88	167	195	TRUE	TRUE	TRUE	1	TRUE	TRUE	1	1
FBgn0042094	32	25	29	28	61	53	TRUE	TRUE	TRUE	1	TRUE	TRUE	1	1
FBgn0042098	84	134	79	71	163	205	FALSE	TRUE	FALSE	0	FALSE	TRUE	0	0
FBgn0042101	117	74	83	80	200	154	FALSE	TRUE	FALSE	0	FALSE	TRUE	0	0
FBgn0042102	41	25	33	23	74	48	FALSE	TRUE	FALSE	0	FALSE	TRUE	0	0
FBgn0042103	127	119	106	94	233	213	TRUE	TRUE	TRUE	1	TRUE	TRUE	1	1
FBgn0042104	85	71	66	63	151	134	TRUE	TRUE	TRUE	1	TRUE	TRUE	1	1
FBgn0042105	86	79	75	69	161	148	TRUE	TRUE	TRUE	1	TRUE	TRUE	1	1
FBgn0042106	137	128	99	102	236	230	TRUE	TRUE	TRUE	1	TRUE	TRUE	1	1
FBgn0042110	72	65	73	78	145	143	TRUE	TRUE	TRUE	1	TRUE	TRUE	1	1
FBgn0042111	64	90	43	55	107	145	FALSE	TRUE	FALSE	0	TRUE	TRUE	1	0
FBgn0042112	26	20	21	18	47	38	TRUE	TRUE	TRUE	1	TRUE	TRUE	1	1
FBgn0042119	50	37	40	30	90	67	TRUE	TRUE	FALSE	0	TRUE	TRUE	1	0
FBgn0042126	81	87	62	58	143	145	TRUE	TRUE	TRUE	1	TRUE	TRUE	1	1
FBgn0042129	76	58	76	76	152	134	TRUE	TRUE	TRUE	1	TRUE	TRUE	1	1
FBgn0042131	99	111	83	61	182	172	TRUE	FALSE	TRUE	0	TRUE	TRUE	1	0
FBgn0042133	41	40	27	30	68	70	TRUE	TRUE	TRUE	1	TRUE	TRUE	1	1
FBgn0042134	62	59	53	62	115	121	TRUE	TRUE	TRUE	1	TRUE	TRUE	1	1
FBgn0042135	409	391	335	320	744	711	TRUE	TRUE	TRUE	1	TRUE	TRUE	1	1
FBgn0042137	82	77	88	60	170	137	TRUE	FALSE	FALSE	0	TRUE	TRUE	1	0
FBgn0042138	145	149	116	113	261	262	TRUE	TRUE	TRUE	1	TRUE	TRUE	1	1
FBgn0042175	30	16	26	18	56	34	FALSE	TRUE	FALSE	0	FALSE	TRUE	0	0
FBgn0042177	32	36	27	20	59	56	TRUE	TRUE	TRUE	1	TRUE	TRUE	1	1
FBgn0042178	82	77	73	60	155	137	TRUE	TRUE	TRUE	1	TRUE	TRUE	1	1
FBgn0042179	198	191	129	166	327	357	TRUE	FALSE	TRUE	0	TRUE	TRUE	1	0
FBgn0042180	218	219	168	187	386	406	TRUE	TRUE	TRUE	1	TRUE	TRUE	1	1
FBgn0042185	423	446	343	370	766	816	TRUE	TRUE	TRUE	1	TRUE	TRUE	1	1
FBgn0042186	105	102	71	89	176	191	TRUE	TRUE	TRUE	1	TRUE	TRUE	1	1
FBgn0042187	49	46	49	49	98	95	TRUE	TRUE	TRUE	1	TRUE	TRUE	1	1
FBgn0042189	85	92	77	70	162	162	TRUE	TRUE	TRUE	1	TRUE	TRUE	1	1
FBgn0042198	54	47	45	52	99	99	TRUE	TRUE	TRUE	1	TRUE	TRUE	1	1
FBgn0042199	33	31	16	27	49	58	TRUE	TRUE	TRUE	1	TRUE	FALSE	0	0
FBgn0042201	39	63	50	50	89	113	FALSE	TRUE	TRUE	0	FALSE	TRUE	0	0
FBgn0042205	52	46	44	50	96	96	TRUE	TRUE	TRUE	1	TRUE	TRUE	1	1
FBgn0042206	51	56	40	64	91	120	TRUE	FALSE	FALSE	0	TRUE	FALSE	0	0
FBgn0042207	46	50	51	49	97	99	TRUE	TRUE	TRUE	1	TRUE	TRUE	1	1
FBgn0042213	56	73	48	49	104	122	TRUE	TRUE	TRUE	1	TRUE	TRUE	1	1
FBgn0042627	50	47	46	47	96	94	TRUE	TRUE	TRUE	1	TRUE	TRUE	1	1
FBgn0042630	372	430	337	341	709	771	FALSE	TRUE	TRUE	0	TRUE	TRUE	1	0
FBgn0042693	363	365	338	314	701	679	TRUE	TRUE	TRUE	1	TRUE	TRUE	1	1
FBgn0042696	171	160	123	134	294	294	TRUE	TRUE	TRUE	1	TRUE	TRUE	1	1
FBgn0042701	74	55	45	56	119	111	TRUE	TRUE	TRUE	1	TRUE	TRUE	1	1
FBgn0042710	92	97	96	67	188	164	TRUE	FALSE	TRUE	0	TRUE	TRUE	1	0
FBgn0042711	49	48	37	48	86	96	TRUE	TRUE	TRUE	1	TRUE	TRUE	1	1
FBgn0042712	145	171	136	139	281	310	TRUE	TRUE	TRUE	1	TRUE	TRUE	1	1
FBgn0043005	105	95	82	109	187	204	TRUE	FALSE	TRUE	0	TRUE	TRUE	1	0
FBgn0043010	31	36	31	23	62	59	TRUE	TRUE	TRUE	1	TRUE	TRUE	1	1
FBgn0043012	44	60	37	39	81	99	TRUE	TRUE	TRUE	1	TRUE	TRUE	1	1
FBgn0043021	47	40	38	35	85	75	TRUE	TRUE	TRUE	1	TRUE	TRUE	1	1
FBgn0043022	19	18	16	24	35	42	TRUE	TRUE	TRUE	1	TRUE	TRUE	1	1
FBgn0043025	181	158	149	155	330	313	TRUE	TRUE	TRUE	1	TRUE	TRUE	1	1
FBgn0043043	71	76	54	66	125	142	TRUE	TRUE	TRUE	1	TRUE	TRUE	1	1
FBgn0043070	402	417	337	337	739	754	TRUE	TRUE	TRUE	1	TRUE	TRUE	1	1
FBgn0043362	859	907	793	795	1652	1702	TRUE	TRUE	TRUE	1	TRUE	TRUE	1	1
FBgn0043364	65	76	36	46	101	122	TRUE	TRUE	TRUE	1	TRUE	TRUE	1	1
FBgn0043455	23	26	29	20	52	46	TRUE	TRUE	TRUE	1	TRUE	TRUE	1	1
FBgn0043456	252	255	196	195	448	450	TRUE	TRUE	TRUE	1	TRUE	TRUE	1	1
FBgn0043457	114	96	93	93	207	189	TRUE	TRUE	TRUE	1	TRUE	TRUE	1	1
FBgn0043458	218	190	161	173	379	363	TRUE	TRUE	TRUE	1	TRUE	TRUE	1	1
FBgn0043470	34	53	35	35	69	88	FALSE	TRUE	TRUE	0	FALSE	TRUE	0	0
FBgn0043471	70	60	45	49	115	109	TRUE	TRUE	TRUE	1	TRUE	TRUE	1	1
FBgn0043530	33	32	32	41	65	73	TRUE	TRUE	TRUE	1	TRUE	TRUE	1	1
FBgn0043532	83	99	84	68	167	167	TRUE	TRUE	TRUE	1	TRUE	TRUE	1	1
FBgn0043533	71	79	46	50	117	129	TRUE	TRUE	TRUE	1	TRUE	TRUE	1	1
FBgn0043534	61	48	58	50	119	98	TRUE	TRUE	TRUE	1	TRUE	TRUE	1	1
FBgn0043535	69	69	37	50	106	119	TRUE	TRUE	TRUE	1	TRUE	TRUE	1	1
FBgn0043539	75	91	68	63	143	154	TRUE	TRUE	TRUE	1	TRUE	TRUE	1	1
FBgn0043550	170	147	124	153	294	300	TRUE	FALSE	TRUE	0	TRUE	TRUE	1	0
FBgn0043577	25	29	18	19	43	48	TRUE	TRUE	TRUE	1	TRUE	TRUE	1	1
FBgn0043783	78	72	66	55	144	127	TRUE	TRUE	TRUE	1	TRUE	TRUE	1	1
FBgn0043791	67	90	47	47	114	137	FALSE	TRUE	TRUE	0	TRUE	TRUE	1	0
FBgn0043792	35	25	35	24	70	49	TRUE	TRUE	FALSE	0	TRUE	TRUE	1	0
FBgn0043799	98	104	105	78	203	182	TRUE	FALSE	TRUE	0	TRUE	TRUE	1	0
FBgn0043806	130	145	98	98	228	243	TRUE	TRUE	TRUE	1	TRUE	TRUE	1	1
FBgn0043825	127	195	149	142	276	337	FALSE	TRUE	FALSE	0	FALSE	TRUE	0	0
FBgn0043841	258	232	179	209	437	441	TRUE	TRUE	TRUE	1	TRUE	TRUE	1	1
FBgn0043854	268	243	192	181	460	424	TRUE	TRUE	TRUE	1	TRUE	TRUE	1	1
FBgn0043865	370	368	327	278	697	646	TRUE	FALSE	TRUE	0	TRUE	TRUE	1	0
FBgn0043884	668	697	540	508	1208	1205	TRUE	TRUE	TRUE	1	TRUE	TRUE	1	1
FBgn0043900	123	120	100	85	223	205	TRUE	TRUE	TRUE	1	TRUE	TRUE	1	1
FBgn0044011	99	115	88	82	187	197	TRUE	TRUE	TRUE	1	TRUE	TRUE	1	1
FBgn0044020	134	150	121	110	255	260	TRUE	TRUE	TRUE	1	TRUE	TRUE	1	1
FBgn0044028	266	291	215	194	481	485	TRUE	TRUE	TRUE	1	TRUE	TRUE	1	1
FBgn0044049	73	85	63	66	136	151	TRUE	TRUE	TRUE	1	TRUE	TRUE	1	1
FBgn0044050	112	112	84	106	196	218	TRUE	TRUE	TRUE	1	TRUE	TRUE	1	1
FBgn0044051	22	28	24	21	46	49	TRUE	TRUE	TRUE	1	TRUE	TRUE	1	1
FBgn0044323	311	324	246	246	557	570	TRUE	TRUE	TRUE	1	TRUE	TRUE	1	1
FBgn0044324	45	47	42	36	87	83	TRUE	TRUE	TRUE	1	TRUE	TRUE	1	1
FBgn0044328	272	267	233	208	505	475	TRUE	TRUE	TRUE	1	TRUE	TRUE	1	1
FBgn0044452	449	399	332	324	781	723	FALSE	TRUE	TRUE	0	TRUE	TRUE	1	0
FBgn0044809	71	82	50	60	121	142	TRUE	TRUE	TRUE	1	TRUE	TRUE	1	1
FBgn0044810	61	56	47	68	108	124	TRUE	FALSE	TRUE	0	TRUE	TRUE	1	0
FBgn0044811	54	34	24	53	78	87	FALSE	FALSE	TRUE	0	FALSE	FALSE	0	0
FBgn0044812	59	75	60	67	119	142	TRUE	TRUE	TRUE	1	TRUE	TRUE	1	1
FBgn0044823	29	30	19	18	48	48	TRUE	TRUE	TRUE	1	TRUE	TRUE	1	1
FBgn0044826	142	120	135	83	277	203	TRUE	FALSE	FALSE	0	TRUE	FALSE	0	0
FBgn0044871	109	96	83	88	192	184	TRUE	TRUE	TRUE	1	TRUE	TRUE	1	1
FBgn0045035	300	348	264	306	564	654	FALSE	FALSE	FALSE	0	TRUE	TRUE	1	0
FBgn0045038	129	130	106	114	235	244	TRUE	TRUE	TRUE	1	TRUE	TRUE	1	1
FBgn0045063	209	242	171	174	380	416	TRUE	TRUE	TRUE	1	TRUE	TRUE	1	1
FBgn0045064	124	114	87	95	211	209	TRUE	TRUE	TRUE	1	TRUE	TRUE	1	1
FBgn0045442	27	21	26	22	53	43	TRUE	TRUE	TRUE	1	TRUE	TRUE	1	1
FBgn0045443	71	85	59	44	130	129	TRUE	TRUE	TRUE	1	TRUE	TRUE	1	1
FBgn0045469	111	107	97	87	208	194	TRUE	TRUE	TRUE	1	TRUE	TRUE	1	1
FBgn0045470	112	99	109	75	221	174	TRUE	FALSE	FALSE	0	TRUE	TRUE	1	0
FBgn0045471	110	97	106	90	216	187	TRUE	TRUE	TRUE	1	TRUE	TRUE	1	1
FBgn0045473	33	28	21	33	54	61	TRUE	TRUE	TRUE	1	TRUE	FALSE	0	0
FBgn0045474	95	95	78	89	173	184	TRUE	TRUE	TRUE	1	TRUE	TRUE	1	1
FBgn0045479	137	129	102	141	239	270	TRUE	FALSE	TRUE	0	TRUE	TRUE	1	0
FBgn0045482	92	88	81	79	173	167	TRUE	TRUE	TRUE	1	TRUE	TRUE	1	1
FBgn0045483	115	121	102	109	217	230	TRUE	TRUE	TRUE	1	TRUE	TRUE	1	1
FBgn0045485	56	71	67	49	123	120	TRUE	TRUE	TRUE	1	TRUE	TRUE	1	1
FBgn0045486	84	74	66	70	150	144	TRUE	TRUE	TRUE	1	TRUE	TRUE	1	1
FBgn0045487	71	83	85	63	156	146	TRUE	FALSE	TRUE	0	TRUE	TRUE	1	0
FBgn0045495	488	450	424	398	912	848	TRUE	TRUE	TRUE	1	TRUE	TRUE	1	1
FBgn0045497	91	102	93	76	184	178	TRUE	TRUE	TRUE	1	TRUE	TRUE	1	1
FBgn0045498	131	99	97	102	228	201	FALSE	TRUE	TRUE	0	TRUE	TRUE	1	0
FBgn0045500	119	112	81	101	200	213	TRUE	TRUE	TRUE	1	TRUE	TRUE	1	1
FBgn0045501	114	112	117	87	231	199	TRUE	FALSE	TRUE	0	TRUE	TRUE	1	0
FBgn0045759	227	211	179	169	406	380	TRUE	TRUE	TRUE	1	TRUE	TRUE	1	1
FBgn0045761	139	133	108	132	247	265	TRUE	TRUE	TRUE	1	TRUE	TRUE	1	1
FBgn0045770	194	198	155	139	349	337	TRUE	TRUE	TRUE	1	TRUE	TRUE	1	1
FBgn0045823	85	80	67	69	152	149	TRUE	TRUE	TRUE	1	TRUE	TRUE	1	1
FBgn0045842	373	329	322	292	695	621	TRUE	TRUE	FALSE	0	TRUE	TRUE	1	0
FBgn0045852	391	421	333	337	724	758	TRUE	TRUE	TRUE	1	TRUE	TRUE	1	1
FBgn0045862	111	126	99	100	210	226	TRUE	TRUE	TRUE	1	TRUE	TRUE	1	1
FBgn0045866	43	63	53	53	96	116	FALSE	TRUE	TRUE	0	TRUE	TRUE	1	0
FBgn0045980	193	199	155	182	348	381	TRUE	TRUE	TRUE	1	TRUE	TRUE	1	1
FBgn0046113	327	361	284	294	611	655	TRUE	TRUE	TRUE	1	TRUE	TRUE	1	1
FBgn0046114	27	27	21	26	48	53	TRUE	TRUE	TRUE	1	TRUE	TRUE	1	1
FBgn0046214	59	70	67	55	126	125	TRUE	TRUE	TRUE	1	TRUE	TRUE	1	1
FBgn0046222	21	14	24	12	45	26	TRUE	FALSE	FALSE	0	TRUE	FALSE	0	0
FBgn0046225	136	141	97	109	233	250	TRUE	TRUE	TRUE	1	TRUE	TRUE	1	1
FBgn0046247	140	123	123	103	263	226	TRUE	TRUE	TRUE	1	TRUE	TRUE	1	1
FBgn0046253	303	304	244	260	547	564	TRUE	TRUE	TRUE	1	TRUE	TRUE	1	1
FBgn0046258	122	123	92	105	214	228	TRUE	TRUE	TRUE	1	TRUE	TRUE	1	1
FBgn0046294	46	57	38	39	84	96	TRUE	TRUE	TRUE	1	TRUE	TRUE	1	1
FBgn0046296	35	32	27	26	62	58	TRUE	TRUE	TRUE	1	TRUE	TRUE	1	1
FBgn0046297	37	53	45	31	82	84	TRUE	TRUE	TRUE	1	TRUE	TRUE	1	1
FBgn0046302	139	159	118	128	257	287	TRUE	TRUE	TRUE	1	TRUE	TRUE	1	1
FBgn0046332	113	124	113	115	226	239	TRUE	TRUE	TRUE	1	TRUE	TRUE	1	1
FBgn0046685	179	196	143	154	322	350	TRUE	TRUE	TRUE	1	TRUE	TRUE	1	1
FBgn0046689	93	97	68	97	161	194	TRUE	FALSE	FALSE	0	TRUE	TRUE	1	0
FBgn0046692	101	103	113	95	214	198	TRUE	TRUE	TRUE	1	TRUE	TRUE	1	1
FBgn0046704	426	414	323	358	749	772	TRUE	TRUE	TRUE	1	TRUE	TRUE	1	1
FBgn0046756	31	36	27	24	58	60	TRUE	TRUE	TRUE	1	TRUE	TRUE	1	1
FBgn0046763	111	99	95	103	206	202	TRUE	TRUE	TRUE	1	TRUE	TRUE	1	1
FBgn0046776	73	84	86	63	159	147	TRUE	FALSE	TRUE	0	TRUE	TRUE	1	0
FBgn0046793	102	120	110	82	212	202	TRUE	FALSE	TRUE	0	TRUE	TRUE	1	0
FBgn0046873	45	42	34	36	79	78	TRUE	TRUE	TRUE	1	TRUE	TRUE	1	1
FBgn0046875	24	24	15	23	39	47	TRUE	TRUE	TRUE	1	TRUE	FALSE	0	0
FBgn0046876	31	22	24	15	55	37	TRUE	TRUE	FALSE	0	TRUE	FALSE	0	0
FBgn0046879	86	102	84	79	170	181	TRUE	TRUE	TRUE	1	TRUE	TRUE	1	1
FBgn0046880	61	57	43	49	104	106	TRUE	TRUE	TRUE	1	TRUE	TRUE	1	1
FBgn0046885	194	158	125	131	319	289	FALSE	TRUE	TRUE	0	TRUE	TRUE	1	0
FBgn0046886	163	130	135	102	298	232	FALSE	FALSE	FALSE	0	TRUE	TRUE	1	0
FBgn0046887	91	100	81	87	172	187	TRUE	TRUE	TRUE	1	TRUE	TRUE	1	1
FBgn0046888	58	53	63	70	121	123	TRUE	TRUE	TRUE	1	TRUE	TRUE	1	1
FBgn0046999	53	46	41	23	94	69	TRUE	FALSE	FALSE	0	TRUE	FALSE	0	0
FBgn0047000	32	44	29	41	61	85	TRUE	TRUE	FALSE	0	TRUE	TRUE	1	0
FBgn0047038	69	81	60	67	129	148	TRUE	TRUE	TRUE	1	TRUE	TRUE	1	1
FBgn0047114	54	57	58	43	112	100	TRUE	TRUE	TRUE	1	TRUE	TRUE	1	1
FBgn0047135	34	30	42	31	76	61	TRUE	TRUE	TRUE	1	TRUE	TRUE	1	1
FBgn0047199	86	100	69	71	155	171	TRUE	TRUE	TRUE	1	TRUE	TRUE	1	1
FBgn0047205	207	195	178	191	385	386	TRUE	TRUE	TRUE	1	TRUE	TRUE	1	1
FBgn0047330	77	77	53	57	130	134	TRUE	TRUE	TRUE	1	TRUE	TRUE	1	1
FBgn0047338	59	55	56	64	115	119	TRUE	TRUE	TRUE	1	TRUE	TRUE	1	1
FBgn0047351	54	52	47	50	101	102	TRUE	TRUE	TRUE	1	TRUE	TRUE	1	1
FBgn0050000	85	114	60	78	145	192	FALSE	TRUE	FALSE	0	TRUE	TRUE	1	0
FBgn0050001	81	89	66	77	147	166	TRUE	TRUE	TRUE	1	TRUE	TRUE	1	1
FBgn0050005	33	36	19	31	52	67	TRUE	TRUE	TRUE	1	TRUE	FALSE	0	0
FBgn0050008	37	55	31	32	68	87	FALSE	TRUE	TRUE	0	TRUE	TRUE	1	0
FBgn0050009	277	264	243	208	520	472	TRUE	TRUE	TRUE	1	TRUE	TRUE	1	1
FBgn0050010	32	35	33	28	65	63	TRUE	TRUE	TRUE	1	TRUE	TRUE	1	1
FBgn0050015	606	588	504	516	1110	1104	TRUE	TRUE	TRUE	1	TRUE	TRUE	1	1
FBgn0050016	39	43	26	17	65	60	TRUE	TRUE	TRUE	1	TRUE	FALSE	0	0
FBgn0050018	168	177	177	165	345	342	TRUE	TRUE	TRUE	1	TRUE	TRUE	1	1
FBgn0050020	273	229	175	191	448	420	FALSE	TRUE	TRUE	0	TRUE	TRUE	1	0
FBgn0050021	263	281	202	199	465	480	TRUE	TRUE	TRUE	1	TRUE	TRUE	1	1
FBgn0050022	158	173	123	117	281	290	TRUE	TRUE	TRUE	1	TRUE	TRUE	1	1
FBgn0050026	56	59	66	59	122	118	TRUE	TRUE	TRUE	1	TRUE	TRUE	1	1
FBgn0050029	73	49	39	46	112	95	FALSE	TRUE	TRUE	0	TRUE	TRUE	1	0
FBgn0050033	60	48	50	45	110	93	TRUE	TRUE	TRUE	1	TRUE	TRUE	1	1
FBgn0050035	230	233	212	185	442	418	TRUE	TRUE	TRUE	1	TRUE	TRUE	1	1
FBgn0050036	84	85	64	66	148	151	TRUE	TRUE	TRUE	1	TRUE	TRUE	1	1
FBgn0050037	47	51	47	36	94	87	TRUE	TRUE	TRUE	1	TRUE	TRUE	1	1
FBgn0050039	78	67	77	58	155	125	TRUE	TRUE	FALSE	0	TRUE	TRUE	1	0
FBgn0050042	106	93	100	86	206	179	TRUE	TRUE	TRUE	1	TRUE	TRUE	1	1
FBgn0050043	248	267	222	256	470	523	TRUE	TRUE	FALSE	0	TRUE	TRUE	1	0
FBgn0050044	163	184	122	155	285	339	TRUE	FALSE	FALSE	0	TRUE	TRUE	1	0
FBgn0050045	41	37	32	37	73	74	TRUE	TRUE	TRUE	1	TRUE	TRUE	1	1
FBgn0050046	252	257	195	189	447	446	TRUE	TRUE	TRUE	1	TRUE	TRUE	1	1
FBgn0050047	213	209	188	171	401	380	TRUE	TRUE	TRUE	1	TRUE	TRUE	1	1
FBgn0050048	325	350	302	279	627	629	TRUE	TRUE	TRUE	1	TRUE	TRUE	1	1
FBgn0050049	236	270	238	212	474	482	TRUE	TRUE	TRUE	1	TRUE	TRUE	1	1
FBgn0050050	95	72	67	64	162	136	FALSE	TRUE	TRUE	0	TRUE	TRUE	1	0
FBgn0050051	58	55	43	39	101	94	TRUE	TRUE	TRUE	1	TRUE	TRUE	1	1
FBgn0050052	70	68	57	64	127	132	TRUE	TRUE	TRUE	1	TRUE	TRUE	1	1
FBgn0050053	84	83	84	58	168	141	TRUE	FALSE	TRUE	0	TRUE	TRUE	1	0
FBgn0050054	158	143	130	122	288	265	TRUE	TRUE	TRUE	1	TRUE	TRUE	1	1
FBgn0050055	43	53	43	45	86	98	TRUE	TRUE	TRUE	1	TRUE	TRUE	1	1
FBgn0050062	49	50	53	51	102	101	TRUE	TRUE	TRUE	1	TRUE	TRUE	1	1
FBgn0050065	56	59	57	63	113	122	TRUE	TRUE	TRUE	1	TRUE	TRUE	1	1
FBgn0050067	28	20	30	26	58	46	TRUE	TRUE	TRUE	1	TRUE	TRUE	1	1
FBgn0050069	332	349	269	285	601	634	TRUE	TRUE	TRUE	1	TRUE	TRUE	1	1
FBgn0050075	49	50	54	48	103	98	TRUE	TRUE	TRUE	1	TRUE	TRUE	1	1
FBgn0050076	192	185	150	129	342	314	TRUE	TRUE	TRUE	1	TRUE	TRUE	1	1
FBgn0050081	123	134	115	120	238	254	TRUE	TRUE	TRUE	1	TRUE	TRUE	1	1
FBgn0050082	77	77	56	52	133	129	TRUE	TRUE	TRUE	1	TRUE	TRUE	1	1
FBgn0050083	124	98	96	93	220	191	FALSE	TRUE	TRUE	0	TRUE	TRUE	1	0
FBgn0050085	305	281	238	274	543	555	TRUE	TRUE	TRUE	1	TRUE	TRUE	1	1
FBgn0050089	325	338	253	292	578	630	TRUE	TRUE	TRUE	1	TRUE	TRUE	1	1
FBgn0050090	41	65	43	55	84	120	FALSE	TRUE	FALSE	0	FALSE	TRUE	0	0
FBgn0050091	79	84	51	48	130	132	TRUE	TRUE	TRUE	1	TRUE	TRUE	1	1
FBgn0050093	23	16	21	28	44	44	TRUE	TRUE	TRUE	1	TRUE	TRUE	1	1
FBgn0050094	72	90	64	69	136	159	TRUE	TRUE	TRUE	1	TRUE	TRUE	1	1
FBgn0050095	117	111	106	112	223	223	TRUE	TRUE	TRUE	1	TRUE	TRUE	1	1
FBgn0050096	32	25	32	19	64	44	TRUE	FALSE	FALSE	0	TRUE	FALSE	0	0
FBgn0050098	106	99	96	112	202	211	TRUE	TRUE	TRUE	1	TRUE	TRUE	1	1
FBgn0050099	37	43	41	33	78	76	TRUE	TRUE	TRUE	1	TRUE	TRUE	1	1
FBgn0050101	140	153	139	115	279	268	TRUE	TRUE	TRUE	1	TRUE	TRUE	1	1
FBgn0050103	271	235	225	230	496	465	TRUE	TRUE	TRUE	1	TRUE	TRUE	1	1
FBgn0050104	217	225	201	176	418	401	TRUE	TRUE	TRUE	1	TRUE	TRUE	1	1
FBgn0050106	302	281	257	258	559	539	TRUE	TRUE	TRUE	1	TRUE	TRUE	1	1
FBgn0050108	34	40	28	29	62	69	TRUE	TRUE	TRUE	1	TRUE	TRUE	1	1
FBgn0050109	41	53	47	49	88	102	TRUE	TRUE	TRUE	1	TRUE	TRUE	1	1
FBgn0050110	213	238	204	212	417	450	TRUE	TRUE	TRUE	1	TRUE	TRUE	1	1
FBgn0050114	109	88	88	65	197	153	TRUE	FALSE	FALSE	0	TRUE	TRUE	1	0
FBgn0050115	520	512	434	428	954	940	TRUE	TRUE	TRUE	1	TRUE	TRUE	1	1
FBgn0050121	150	157	122	139	272	296	TRUE	TRUE	TRUE	1	TRUE	TRUE	1	1
FBgn0050122	268	255	211	206	479	461	TRUE	TRUE	TRUE	1	TRUE	TRUE	1	1
FBgn0050125	50	41	54	56	104	97	TRUE	TRUE	TRUE	1	TRUE	TRUE	1	1
FBgn0050145	35	49	41	34	76	83	TRUE	TRUE	TRUE	1	TRUE	TRUE	1	1
FBgn0050147	266	260	229	209	495	469	TRUE	TRUE	TRUE	1	TRUE	TRUE	1	1
FBgn0050148	101	123	79	85	180	208	TRUE	TRUE	TRUE	1	TRUE	TRUE	1	1
FBgn0050151	130	119	112	134	242	253	TRUE	TRUE	TRUE	1	TRUE	TRUE	1	1
FBgn0050154	63	94	95	72	158	166	FALSE	FALSE	TRUE	0	TRUE	TRUE	1	0
FBgn0050155	31	17	20	14	51	31	FALSE	TRUE	FALSE	0	FALSE	TRUE	0	0
FBgn0050156	52	52	47	43	99	95	TRUE	TRUE	TRUE	1	TRUE	TRUE	1	1
FBgn0050157	29	28	23	33	52	61	TRUE	TRUE	TRUE	1	TRUE	TRUE	1	1
FBgn0050158	290	297	240	243	530	540	TRUE	TRUE	TRUE	1	TRUE	TRUE	1	1
FBgn0050159	97	121	87	101	184	222	TRUE	TRUE	FALSE	0	TRUE	TRUE	1	0
FBgn0050161	30	27	19	27	49	54	TRUE	TRUE	TRUE	1	TRUE	TRUE	1	1
FBgn0050169	187	196	133	136	320	332	TRUE	TRUE	TRUE	1	TRUE	TRUE	1	1
FBgn0050172	45	44	38	49	83	93	TRUE	TRUE	TRUE	1	TRUE	TRUE	1	1
FBgn0050177	112	121	118	97	230	218	TRUE	TRUE	TRUE	1	TRUE	TRUE	1	1
FBgn0050178	29	21	14	27	43	48	TRUE	FALSE	TRUE	0	TRUE	FALSE	0	0
FBgn0050181	174	165	134	149	308	314	TRUE	TRUE	TRUE	1	TRUE	TRUE	1	1
FBgn0050183	324	389	301	306	625	695	FALSE	TRUE	FALSE	0	TRUE	TRUE	1	0
FBgn0050184	48	51	37	32	85	83	TRUE	TRUE	TRUE	1	TRUE	TRUE	1	1
FBgn0050185	43	63	35	43	78	106	FALSE	TRUE	FALSE	0	TRUE	TRUE	1	0
FBgn0050187	73	69	80	54	153	123	TRUE	FALSE	FALSE	0	TRUE	TRUE	1	0
FBgn0050192	41	29	29	36	70	65	TRUE	TRUE	TRUE	1	TRUE	TRUE	1	1
FBgn0050195	70	75	66	66	136	141	TRUE	TRUE	TRUE	1	TRUE	TRUE	1	1
FBgn0050196	55	53	40	51	95	104	TRUE	TRUE	TRUE	1	TRUE	TRUE	1	1
FBgn0050197	48	54	55	34	103	88	TRUE	FALSE	TRUE	0	TRUE	FALSE	0	0
FBgn0050201	16	16	14	28	30	44	TRUE	FALSE	TRUE	0	TRUE	FALSE	0	0
FBgn0050202	19	27	15	19	34	46	TRUE	TRUE	TRUE	1	TRUE	TRUE	1	1
FBgn0050203	288	250	237	237	525	487	TRUE	TRUE	TRUE	1	TRUE	TRUE	1	1
FBgn0050206	17	21	19	15	36	36	TRUE	TRUE	TRUE	1	TRUE	TRUE	1	1
FBgn0050212	23	20	26	21	49	41	TRUE	TRUE	TRUE	1	TRUE	TRUE	1	1
FBgn0050220	16	23	22	21	38	44	TRUE	TRUE	TRUE	1	TRUE	TRUE	1	1
FBgn0050222	166	184	160	130	326	314	TRUE	FALSE	TRUE	0	TRUE	TRUE	1	0
FBgn0050223	31	31	23	23	54	54	TRUE	TRUE	TRUE	1	TRUE	TRUE	1	1
FBgn0050229	25	19	16	24	41	43	TRUE	TRUE	TRUE	1	TRUE	TRUE	1	1
FBgn0050232	43	23	24	14	67	37	FALSE	TRUE	FALSE	0	FALSE	FALSE	0	0
FBgn0050235	26	19	25	14	51	33	TRUE	TRUE	FALSE	0	TRUE	FALSE	0	0
FBgn0050237	21	21	24	30	45	51	TRUE	TRUE	TRUE	1	TRUE	TRUE	1	1
FBgn0050238	28	22	13	21	41	43	TRUE	TRUE	TRUE	1	TRUE	FALSE	0	0
FBgn0050239	28	31	12	25	40	56	TRUE	FALSE	TRUE	0	TRUE	FALSE	0	0
FBgn0050240	34	28	23	23	57	51	TRUE	TRUE	TRUE	1	TRUE	TRUE	1	1
FBgn0050241	38	33	32	23	70	56	TRUE	TRUE	TRUE	1	TRUE	TRUE	1	1
FBgn0050250	20	21	14	19	34	40	TRUE	TRUE	TRUE	1	TRUE	TRUE	1	1
FBgn0050257	29	24	26	27	55	51	TRUE	TRUE	TRUE	1	TRUE	TRUE	1	1
FBgn0050259	144	169	119	126	263	295	TRUE	TRUE	TRUE	1	TRUE	TRUE	1	1
FBgn0050263	604	620	462	515	1066	1135	TRUE	FALSE	TRUE	0	TRUE	TRUE	1	0
FBgn0050265	174	191	199	135	373	326	TRUE	FALSE	FALSE	0	TRUE	TRUE	1	0
FBgn0050267	40	44	32	36	72	80	TRUE	TRUE	TRUE	1	TRUE	TRUE	1	1
FBgn0050268	311	300	294	275	605	575	TRUE	TRUE	TRUE	1	TRUE	TRUE	1	1
FBgn0050271	213	214	169	176	382	390	TRUE	TRUE	TRUE	1	TRUE	TRUE	1	1
FBgn0050272	137	149	124	120	261	269	TRUE	TRUE	TRUE	1	TRUE	TRUE	1	1
FBgn0050274	143	165	106	131	249	296	TRUE	TRUE	FALSE	0	TRUE	TRUE	1	0
FBgn0050275	218	230	208	185	426	415	TRUE	TRUE	TRUE	1	TRUE	TRUE	1	1
FBgn0050277	163	166	147	133	310	299	TRUE	TRUE	TRUE	1	TRUE	TRUE	1	1
FBgn0050278	79	92	71	83	150	175	TRUE	TRUE	TRUE	1	TRUE	TRUE	1	1
FBgn0050280	125	93	90	95	215	188	FALSE	TRUE	TRUE	0	TRUE	TRUE	1	0
FBgn0050281	124	98	87	74	211	172	FALSE	TRUE	FALSE	0	TRUE	TRUE	1	0
FBgn0050284	30	26	26	23	56	49	TRUE	TRUE	TRUE	1	TRUE	TRUE	1	1
FBgn0050285	55	37	32	47	87	84	FALSE	TRUE	TRUE	0	TRUE	TRUE	1	0
FBgn0050286	115	117	84	106	199	223	TRUE	TRUE	TRUE	1	TRUE	TRUE	1	1
FBgn0050287	30	36	8	31	38	67	TRUE	FALSE	FALSE	0	TRUE	FALSE	0	0
FBgn0050288	55	71	57	53	112	124	TRUE	TRUE	TRUE	1	TRUE	TRUE	1	1
FBgn0050289	119	134	106	115	225	249	TRUE	TRUE	TRUE	1	TRUE	TRUE	1	1
FBgn0050291	120	97	90	95	210	192	TRUE	TRUE	TRUE	1	TRUE	TRUE	1	1
FBgn0050293	178	193	140	130	318	323	TRUE	TRUE	TRUE	1	TRUE	TRUE	1	1
FBgn0050295	309	306	263	285	572	591	TRUE	TRUE	TRUE	1	TRUE	TRUE	1	1
FBgn0050296	507	478	406	367	913	845	TRUE	TRUE	TRUE	1	TRUE	TRUE	1	1
FBgn0050316	21	10	23	11	44	21	FALSE	FALSE	FALSE	0	FALSE	FALSE	0	0
FBgn0050323	93	98	72	80	165	178	TRUE	TRUE	TRUE	1	TRUE	TRUE	1	1
FBgn0050325	271	248	215	195	486	443	TRUE	TRUE	TRUE	1	TRUE	TRUE	1	1
FBgn0050326	27	31	17	20	44	51	TRUE	TRUE	TRUE	1	TRUE	TRUE	1	1
FBgn0050334	24	31	19	20	43	51	TRUE	TRUE	TRUE	1	TRUE	TRUE	1	1
FBgn0050338	53	68	62	41	115	109	TRUE	FALSE	TRUE	0	TRUE	FALSE	0	0
FBgn0050339	48	45	42	37	90	82	TRUE	TRUE	TRUE	1	TRUE	TRUE	1	1
FBgn0050340	119	111	90	75	209	186	TRUE	TRUE	TRUE	1	TRUE	TRUE	1	1
FBgn0050343	23	25	15	23	38	48	TRUE	TRUE	TRUE	1	TRUE	FALSE	0	0
FBgn0050344	118	95	91	96	209	191	TRUE	TRUE	TRUE	1	TRUE	TRUE	1	1
FBgn0050345	68	59	59	69	127	128	TRUE	TRUE	TRUE	1	TRUE	TRUE	1	1
FBgn0050349	82	90	58	62	140	152	TRUE	TRUE	TRUE	1	TRUE	TRUE	1	1
FBgn0050350	36	28	26	26	62	54	TRUE	TRUE	TRUE	1	TRUE	TRUE	1	1
FBgn0050354	33	40	30	23	63	63	TRUE	TRUE	TRUE	1	TRUE	TRUE	1	1
FBgn0050357	31	36	36	34	67	70	TRUE	TRUE	TRUE	1	TRUE	TRUE	1	1
FBgn0050359	33	42	46	24	79	66	TRUE	FALSE	TRUE	0	TRUE	FALSE	0	0
FBgn0050360	65	88	88	44	153	132	FALSE	FALSE	TRUE	0	TRUE	FALSE	0	0
FBgn0050361	442	404	339	358	781	762	TRUE	TRUE	TRUE	1	TRUE	TRUE	1	1
FBgn0050362	66	70	53	50	119	120	TRUE	TRUE	TRUE	1	TRUE	TRUE	1	1
FBgn0050371	96	102	95	115	191	217	TRUE	TRUE	TRUE	1	TRUE	TRUE	1	1
FBgn0050372	114	110	99	94	213	204	TRUE	TRUE	TRUE	1	TRUE	TRUE	1	1
FBgn0050373	24	18	20	16	44	34	TRUE	TRUE	TRUE	1	TRUE	TRUE	1	1
FBgn0050375	113	99	68	66	181	165	TRUE	TRUE	TRUE	1	TRUE	TRUE	1	1
FBgn0050376	18	18	11	20	29	38	TRUE	TRUE	TRUE	1	TRUE	FALSE	0	0
FBgn0050377	369	335	249	245	618	580	TRUE	TRUE	TRUE	1	TRUE	TRUE	1	1
FBgn0050378	30	33	37	23	67	56	TRUE	FALSE	TRUE	0	TRUE	FALSE	0	0
FBgn0050379	44	40	41	46	85	86	TRUE	TRUE	TRUE	1	TRUE	TRUE	1	1
FBgn0050381	35	36	24	20	59	56	TRUE	TRUE	TRUE	1	TRUE	TRUE	1	1
FBgn0050383	58	66	51	55	109	121	TRUE	TRUE	TRUE	1	TRUE	TRUE	1	1
FBgn0050384	50	60	38	39	88	99	TRUE	TRUE	TRUE	1	TRUE	TRUE	1	1
FBgn0050385	73	80	76	68	149	148	TRUE	TRUE	TRUE	1	TRUE	TRUE	1	1
FBgn0050389	405	377	300	307	705	684	TRUE	TRUE	TRUE	1	TRUE	TRUE	1	1
FBgn0050391	133	126	99	105	232	231	TRUE	TRUE	TRUE	1	TRUE	TRUE	1	1
FBgn0050393	55	72	53	38	108	110	TRUE	TRUE	TRUE	1	TRUE	TRUE	1	1
FBgn0050394	202	184	151	168	353	352	TRUE	TRUE	TRUE	1	TRUE	TRUE	1	1
FBgn0050395	504	504	432	447	936	951	TRUE	TRUE	TRUE	1	TRUE	TRUE	1	1
FBgn0050398	74	81	48	55	122	136	TRUE	TRUE	TRUE	1	TRUE	TRUE	1	1
FBgn0050401	104	87	73	68	177	155	TRUE	TRUE	TRUE	1	TRUE	TRUE	1	1
FBgn0050403	65	84	76	61	141	145	TRUE	TRUE	TRUE	1	TRUE	TRUE	1	1
FBgn0050404	148	170	138	99	286	269	TRUE	FALSE	TRUE	0	TRUE	TRUE	1	0
FBgn0050406	28	42	24	27	52	69	TRUE	TRUE	TRUE	1	TRUE	TRUE	1	1
FBgn0050407	24	19	28	18	52	37	TRUE	TRUE	TRUE	1	TRUE	FALSE	0	0
FBgn0050409	58	58	73	56	131	114	TRUE	TRUE	TRUE	1	TRUE	TRUE	1	1
FBgn0050410	34	33	24	31	58	64	TRUE	TRUE	TRUE	1	TRUE	TRUE	1	1
FBgn0050411	112	124	92	126	204	250	TRUE	FALSE	FALSE	0	TRUE	TRUE	1	0
FBgn0050412	80	88	93	78	173	166	TRUE	TRUE	TRUE	1	TRUE	TRUE	1	1
FBgn0050413	31	19	21	17	52	36	TRUE	TRUE	TRUE	1	FALSE	TRUE	0	0
FBgn0050414	61	67	45	48	106	115	TRUE	TRUE	TRUE	1	TRUE	TRUE	1	1
FBgn0050416	133	132	112	113	245	245	TRUE	TRUE	TRUE	1	TRUE	TRUE	1	1
FBgn0050417	31	40	30	27	61	67	TRUE	TRUE	TRUE	1	TRUE	TRUE	1	1
FBgn0050418	197	228	181	174	378	402	TRUE	TRUE	TRUE	1	TRUE	TRUE	1	1
FBgn0050419	149	133	144	139	293	272	TRUE	TRUE	TRUE	1	TRUE	TRUE	1	1
FBgn0050421	165	155	142	139	307	294	TRUE	TRUE	TRUE	1	TRUE	TRUE	1	1
FBgn0050423	23	28	18	16	41	44	TRUE	TRUE	TRUE	1	TRUE	TRUE	1	1
FBgn0050429	90	81	62	62	152	143	TRUE	TRUE	TRUE	1	TRUE	TRUE	1	1
FBgn0050431	82	86	72	56	154	142	TRUE	TRUE	TRUE	1	TRUE	TRUE	1	1
FBgn0050438	144	158	135	138	279	296	TRUE	TRUE	TRUE	1	TRUE	TRUE	1	1
FBgn0050440	208	202	169	162	377	364	TRUE	TRUE	TRUE	1	TRUE	TRUE	1	1
FBgn0050443	59	63	51	33	110	96	TRUE	FALSE	TRUE	0	TRUE	FALSE	0	0
FBgn0050446	102	88	81	62	183	150	TRUE	TRUE	FALSE	0	TRUE	TRUE	1	0
FBgn0050447	112	88	108	95	220	183	TRUE	TRUE	FALSE	0	TRUE	TRUE	1	0
FBgn0050449	21	22	19	13	40	35	TRUE	TRUE	TRUE	1	TRUE	TRUE	1	1
FBgn0050456	273	310	226	241	499	551	TRUE	TRUE	TRUE	1	TRUE	TRUE	1	1
FBgn0050457	84	79	59	63	143	142	TRUE	TRUE	TRUE	1	TRUE	TRUE	1	1
FBgn0050458	45	45	27	22	72	67	TRUE	TRUE	TRUE	1	TRUE	TRUE	1	1
FBgn0050460	336	362	306	308	642	670	TRUE	TRUE	TRUE	1	TRUE	TRUE	1	1
FBgn0050463	498	545	431	477	929	1022	TRUE	TRUE	FALSE	0	TRUE	TRUE	1	0
FBgn0050464	144	134	114	130	258	264	TRUE	TRUE	TRUE	1	TRUE	TRUE	1	1
FBgn0050466	102	115	66	107	168	222	TRUE	FALSE	FALSE	0	TRUE	FALSE	0	0
FBgn0050467	92	101	90	78	182	179	TRUE	TRUE	TRUE	1	TRUE	TRUE	1	1
FBgn0050468	105	138	114	120	219	258	FALSE	TRUE	FALSE	0	TRUE	TRUE	1	0
FBgn0050469	141	133	117	115	258	248	TRUE	TRUE	TRUE	1	TRUE	TRUE	1	1
FBgn0050471	258	261	220	201	478	462	TRUE	TRUE	TRUE	1	TRUE	TRUE	1	1
FBgn0050472	59	64	58	51	117	115	TRUE	TRUE	TRUE	1	TRUE	TRUE	1	1
FBgn0050476	33	28	22	29	55	57	TRUE	TRUE	TRUE	1	TRUE	TRUE	1	1
FBgn0050484	190	211	203	189	393	400	TRUE	TRUE	TRUE	1	TRUE	TRUE	1	1
FBgn0050485	148	134	139	137	287	271	TRUE	TRUE	TRUE	1	TRUE	TRUE	1	1
FBgn0050487	17	25	20	19	37	44	TRUE	TRUE	TRUE	1	TRUE	TRUE	1	1
FBgn0050488	86	107	78	87	164	194	TRUE	TRUE	TRUE	1	TRUE	TRUE	1	1
FBgn0050489	283	265	202	254	485	519	TRUE	FALSE	TRUE	0	TRUE	TRUE	1	0
FBgn0050493	82	90	81	86	163	176	TRUE	TRUE	TRUE	1	TRUE	TRUE	1	1
FBgn0050495	28	29	28	25	56	54	TRUE	TRUE	TRUE	1	TRUE	TRUE	1	1
FBgn0050496	45	48	31	31	76	79	TRUE	TRUE	TRUE	1	TRUE	TRUE	1	1
FBgn0050499	26	21	20	16	46	37	TRUE	TRUE	TRUE	1	TRUE	TRUE	1	1
FBgn0050502	84	85	60	47	144	132	TRUE	TRUE	TRUE	1	TRUE	TRUE	1	1
FBgn0050506	34	25	23	31	57	56	TRUE	TRUE	TRUE	1	TRUE	TRUE	1	1
FBgn0051002	137	148	108	102	245	250	TRUE	TRUE	TRUE	1	TRUE	TRUE	1	1
FBgn0051004	460	447	412	397	872	844	TRUE	TRUE	TRUE	1	TRUE	TRUE	1	1
FBgn0051005	333	300	285	227	618	527	TRUE	FALSE	FALSE	0	TRUE	TRUE	1	0
FBgn0051007	61	63	56	67	117	130	TRUE	TRUE	TRUE	1	TRUE	TRUE	1	1
FBgn0051008	55	75	71	59	126	134	FALSE	TRUE	TRUE	0	TRUE	TRUE	1	0
FBgn0051010	62	94	82	65	144	159	FALSE	TRUE	TRUE	0	FALSE	TRUE	0	0
FBgn0051013	188	197	181	176	369	373	TRUE	TRUE	TRUE	1	TRUE	TRUE	1	1
FBgn0051014	194	198	180	171	374	369	TRUE	TRUE	TRUE	1	TRUE	TRUE	1	1
FBgn0051015	261	249	176	208	437	457	TRUE	TRUE	TRUE	1	TRUE	TRUE	1	1
FBgn0051016	409	383	338	354	747	737	TRUE	TRUE	TRUE	1	TRUE	TRUE	1	1
FBgn0051017	193	208	176	152	369	360	TRUE	TRUE	TRUE	1	TRUE	TRUE	1	1
FBgn0051019	243	227	176	193	419	420	TRUE	TRUE	TRUE	1	TRUE	TRUE	1	1
FBgn0051021	177	154	132	123	309	277	TRUE	TRUE	TRUE	1	TRUE	TRUE	1	1
FBgn0051023	28	31	19	30	47	61	TRUE	TRUE	TRUE	1	TRUE	FALSE	0	0
FBgn0051025	257	269	200	212	457	481	TRUE	TRUE	TRUE	1	TRUE	TRUE	1	1
FBgn0051028	202	185	181	175	383	360	TRUE	TRUE	TRUE	1	TRUE	TRUE	1	1
FBgn0051029	205	206	168	164	373	370	TRUE	TRUE	TRUE	1	TRUE	TRUE	1	1
FBgn0051030	135	111	83	109	218	220	TRUE	FALSE	TRUE	0	TRUE	TRUE	1	0
FBgn0051032	76	67	58	72	134	139	TRUE	TRUE	TRUE	1	TRUE	TRUE	1	1
FBgn0051036	337	336	291	271	628	607	TRUE	TRUE	TRUE	1	TRUE	TRUE	1	1
FBgn0051038	501	506	419	375	920	881	TRUE	TRUE	TRUE	1	TRUE	TRUE	1	1
FBgn0051040	113	143	82	99	195	242	FALSE	TRUE	FALSE	0	TRUE	TRUE	1	0
FBgn0051041	70	57	46	87	116	144	TRUE	FALSE	FALSE	0	TRUE	FALSE	0	0
FBgn0051044	252	256	184	208	436	464	TRUE	TRUE	TRUE	1	TRUE	TRUE	1	1
FBgn0051050	95	78	56	62	151	140	TRUE	TRUE	TRUE	1	TRUE	TRUE	1	1
FBgn0051051	54	62	42	41	96	103	TRUE	TRUE	TRUE	1	TRUE	TRUE	1	1
FBgn0051053	26	34	27	29	53	63	TRUE	TRUE	TRUE	1	TRUE	TRUE	1	1
FBgn0051055	91	100	88	90	179	190	TRUE	TRUE	TRUE	1	TRUE	TRUE	1	1
FBgn0051064	470	475	371	412	841	887	TRUE	TRUE	TRUE	1	TRUE	TRUE	1	1
FBgn0051065	84	104	92	73	176	177	TRUE	TRUE	TRUE	1	TRUE	TRUE	1	1
FBgn0051068	230	246	176	162	406	408	TRUE	TRUE	TRUE	1	TRUE	TRUE	1	1
FBgn0051070	22	27	22	15	44	42	TRUE	TRUE	TRUE	1	TRUE	TRUE	1	1
FBgn0051072	338	337	254	259	592	596	TRUE	TRUE	TRUE	1	TRUE	TRUE	1	1
FBgn0051075	167	192	142	178	309	370	TRUE	FALSE	FALSE	0	TRUE	TRUE	1	0
FBgn0051076	79	124	77	88	156	212	FALSE	TRUE	FALSE	0	FALSE	TRUE	0	0
FBgn0051077	243	281	248	244	491	525	TRUE	TRUE	TRUE	1	TRUE	TRUE	1	1
FBgn0051080	81	54	53	54	134	108	FALSE	TRUE	TRUE	0	TRUE	TRUE	1	0
FBgn0051081	107	109	99	85	206	194	TRUE	TRUE	TRUE	1	TRUE	TRUE	1	1
FBgn0051087	122	151	100	103	222	254	FALSE	TRUE	TRUE	0	TRUE	TRUE	1	0
FBgn0051089	56	64	43	53	99	117	TRUE	TRUE	TRUE	1	TRUE	TRUE	1	1
FBgn0051091	158	140	151	150	309	290	TRUE	TRUE	TRUE	1	TRUE	TRUE	1	1
FBgn0051092	501	460	380	404	881	864	TRUE	TRUE	TRUE	1	TRUE	TRUE	1	1
FBgn0051097	169	182	143	152	312	334	TRUE	TRUE	TRUE	1	TRUE	TRUE	1	1
FBgn0051098	55	73	66	49	121	122	TRUE	TRUE	TRUE	1	TRUE	TRUE	1	1
FBgn0051099	142	128	130	124	272	252	TRUE	TRUE	TRUE	1	TRUE	TRUE	1	1
FBgn0051100	131	134	111	111	242	245	TRUE	TRUE	TRUE	1	TRUE	TRUE	1	1
FBgn0051102	152	188	163	168	315	356	FALSE	TRUE	TRUE	0	TRUE	TRUE	1	0
FBgn0051103	56	32	45	36	101	68	FALSE	TRUE	FALSE	0	FALSE	TRUE	0	0
FBgn0051104	136	96	91	88	227	184	FALSE	TRUE	FALSE	0	TRUE	TRUE	1	0
FBgn0051105	154	146	120	115	274	261	TRUE	TRUE	TRUE	1	TRUE	TRUE	1	1
FBgn0051106	191	178	151	143	342	321	TRUE	TRUE	TRUE	1	TRUE	TRUE	1	1
FBgn0051108	158	176	128	140	286	316	TRUE	TRUE	TRUE	1	TRUE	TRUE	1	1
FBgn0051109	50	35	38	37	88	72	TRUE	TRUE	TRUE	1	TRUE	TRUE	1	1
FBgn0051111	72	69	54	44	126	113	TRUE	TRUE	TRUE	1	TRUE	TRUE	1	1
FBgn0051115	76	71	63	55	139	126	TRUE	TRUE	TRUE	1	TRUE	TRUE	1	1
FBgn0051116	410	389	289	321	699	710	TRUE	TRUE	TRUE	1	TRUE	TRUE	1	1
FBgn0051118	42	29	30	25	72	54	TRUE	TRUE	TRUE	1	TRUE	TRUE	1	1
FBgn0051119	80	76	72	68	152	144	TRUE	TRUE	TRUE	1	TRUE	TRUE	1	1
FBgn0051121	305	308	238	232	543	540	TRUE	TRUE	TRUE	1	TRUE	TRUE	1	1
FBgn0051122	283	275	204	192	487	467	TRUE	TRUE	TRUE	1	TRUE	TRUE	1	1
FBgn0051125	82	75	42	41	124	116	TRUE	TRUE	TRUE	1	TRUE	TRUE	1	1
FBgn0051126	43	44	35	37	78	81	TRUE	TRUE	TRUE	1	TRUE	TRUE	1	1
FBgn0051128	78	70	57	68	135	138	TRUE	TRUE	TRUE	1	TRUE	TRUE	1	1
FBgn0051130	32	19	25	20	57	39	FALSE	TRUE	FALSE	0	FALSE	TRUE	0	0
FBgn0051133	102	101	89	75	191	176	TRUE	TRUE	TRUE	1	TRUE	TRUE	1	1
FBgn0051139	27	19	13	24	40	43	TRUE	FALSE	TRUE	0	TRUE	FALSE	0	0
FBgn0051140	571	582	491	492	1062	1074	TRUE	TRUE	TRUE	1	TRUE	TRUE	1	1
FBgn0051141	19	29	22	27	41	56	TRUE	TRUE	TRUE	1	FALSE	TRUE	0	0
FBgn0051145	339	407	275	302	614	709	FALSE	TRUE	FALSE	0	TRUE	TRUE	1	0
FBgn0051146	311	319	260	243	571	562	TRUE	TRUE	TRUE	1	TRUE	TRUE	1	1
FBgn0051148	72	54	52	44	124	98	TRUE	TRUE	FALSE	0	TRUE	TRUE	1	0
FBgn0051151	212	207	190	159	402	366	TRUE	TRUE	TRUE	1	TRUE	TRUE	1	1
FBgn0051156	227	221	176	174	403	395	TRUE	TRUE	TRUE	1	TRUE	TRUE	1	1
FBgn0051157	68	55	37	44	105	99	TRUE	TRUE	TRUE	1	TRUE	TRUE	1	1
FBgn0051158	629	560	475	486	1104	1046	FALSE	TRUE	TRUE	0	TRUE	TRUE	1	0
FBgn0051159	209	166	134	133	343	299	FALSE	TRUE	FALSE	0	TRUE	TRUE	1	0
FBgn0051161	61	68	59	62	120	130	TRUE	TRUE	TRUE	1	TRUE	TRUE	1	1
FBgn0051163	541	581	484	514	1025	1095	TRUE	TRUE	TRUE	1	TRUE	TRUE	1	1
FBgn0051164	166	223	165	169	331	392	FALSE	TRUE	FALSE	0	TRUE	TRUE	1	0
FBgn0051174	93	95	89	61	182	156	TRUE	FALSE	TRUE	0	TRUE	TRUE	1	0
FBgn0051176	217	227	177	208	394	435	TRUE	TRUE	TRUE	1	TRUE	TRUE	1	1
FBgn0051183	341	293	287	261	628	554	FALSE	TRUE	FALSE	0	TRUE	TRUE	1	0
FBgn0051184	42	33	31	20	73	53	TRUE	TRUE	FALSE	0	TRUE	FALSE	0	0
FBgn0051189	56	55	53	48	109	103	TRUE	TRUE	TRUE	1	TRUE	TRUE	1	1
FBgn0051191	210	201	184	167	394	368	TRUE	TRUE	TRUE	1	TRUE	TRUE	1	1
FBgn0051195	189	189	152	151	341	340	TRUE	TRUE	TRUE	1	TRUE	TRUE	1	1
FBgn0051198	247	232	211	166	458	398	TRUE	FALSE	FALSE	0	TRUE	TRUE	1	0
FBgn0051199	119	119	95	96	214	215	TRUE	TRUE	TRUE	1	TRUE	TRUE	1	1
FBgn0051200	121	87	91	80	212	167	FALSE	TRUE	FALSE	0	TRUE	TRUE	1	0
FBgn0051201	202	187	187	165	389	352	TRUE	TRUE	TRUE	1	TRUE	TRUE	1	1
FBgn0051202	81	85	74	77	155	162	TRUE	TRUE	TRUE	1	TRUE	TRUE	1	1
FBgn0051204	104	124	72	96	176	220	TRUE	FALSE	FALSE	0	TRUE	TRUE	1	0
FBgn0051205	114	117	97	105	211	222	TRUE	TRUE	TRUE	1	TRUE	TRUE	1	1
FBgn0051206	92	110	95	84	187	194	TRUE	TRUE	TRUE	1	TRUE	TRUE	1	1
FBgn0051207	64	70	42	55	106	125	TRUE	TRUE	TRUE	1	TRUE	TRUE	1	1
FBgn0051211	167	178	137	157	304	335	TRUE	TRUE	TRUE	1	TRUE	TRUE	1	1
FBgn0051213	287	269	246	248	533	517	TRUE	TRUE	TRUE	1	TRUE	TRUE	1	1
FBgn0051215	27	15	23	18	50	33	FALSE	TRUE	FALSE	0	FALSE	TRUE	0	0
FBgn0051216	187	229	208	173	395	402	FALSE	FALSE	TRUE	0	TRUE	TRUE	1	0
FBgn0051217	92	116	129	96	221	212	TRUE	FALSE	TRUE	0	TRUE	TRUE	1	0
FBgn0051219	40	58	50	36	90	94	FALSE	TRUE	TRUE	0	TRUE	TRUE	1	0
FBgn0051220	164	179	138	131	302	310	TRUE	TRUE	TRUE	1	TRUE	TRUE	1	1
FBgn0051221	429	387	342	373	771	760	TRUE	TRUE	TRUE	1	TRUE	TRUE	1	1
FBgn0051223	29	24	50	44	79	68	TRUE	TRUE	TRUE	1	TRUE	TRUE	1	1
FBgn0051224	412	369	311	306	723	675	TRUE	TRUE	TRUE	1	TRUE	TRUE	1	1
FBgn0051225	157	176	141	137	298	313	TRUE	TRUE	TRUE	1	TRUE	TRUE	1	1
FBgn0051226	65	66	32	38	97	104	TRUE	TRUE	TRUE	1	TRUE	TRUE	1	1
FBgn0051229	28	30	22	27	50	57	TRUE	TRUE	TRUE	1	TRUE	TRUE	1	1
FBgn0051230	40	34	46	37	86	71	TRUE	TRUE	TRUE	1	TRUE	TRUE	1	1
FBgn0051231	176	126	138	126	314	252	FALSE	TRUE	FALSE	0	TRUE	TRUE	1	0
FBgn0051233	223	260	159	231	382	491	TRUE	FALSE	FALSE	0	TRUE	TRUE	1	0
FBgn0051244	90	101	84	80	174	181	TRUE	TRUE	TRUE	1	TRUE	TRUE	1	1
FBgn0051245	99	77	60	78	159	155	TRUE	TRUE	TRUE	1	TRUE	TRUE	1	1
FBgn0051248	44	55	34	41	78	96	TRUE	TRUE	TRUE	1	TRUE	TRUE	1	1
FBgn0051249	81	70	68	74	149	144	TRUE	TRUE	TRUE	1	TRUE	TRUE	1	1
FBgn0051251	82	68	74	65	156	133	TRUE	TRUE	TRUE	1	TRUE	TRUE	1	1
FBgn0051259	106	94	80	72	186	166	TRUE	TRUE	TRUE	1	TRUE	TRUE	1	1
FBgn0051262	281	274	216	218	497	492	TRUE	TRUE	TRUE	1	TRUE	TRUE	1	1
FBgn0051265	63	63	56	64	119	127	TRUE	TRUE	TRUE	1	TRUE	TRUE	1	1
FBgn0051266	65	87	58	84	123	171	FALSE	FALSE	FALSE	0	TRUE	TRUE	1	0
FBgn0051267	117	114	108	85	225	199	TRUE	TRUE	TRUE	1	TRUE	TRUE	1	1
FBgn0051272	77	89	90	77	167	166	TRUE	TRUE	TRUE	1	TRUE	TRUE	1	1
FBgn0051278	27	25	22	23	49	48	TRUE	TRUE	TRUE	1	TRUE	TRUE	1	1
FBgn0051279	102	103	85	82	187	185	TRUE	TRUE	TRUE	1	TRUE	TRUE	1	1
FBgn0051281	132	124	111	109	243	233	TRUE	TRUE	TRUE	1	TRUE	TRUE	1	1
FBgn0051286	85	65	40	51	125	116	TRUE	TRUE	TRUE	1	TRUE	TRUE	1	1
FBgn0051287	40	45	44	30	84	75	TRUE	TRUE	TRUE	1	TRUE	TRUE	1	1
FBgn0051288	158	154	138	103	296	257	TRUE	FALSE	TRUE	0	TRUE	TRUE	1	0
FBgn0051294	53	57	50	45	103	102	TRUE	TRUE	TRUE	1	TRUE	TRUE	1	1
FBgn0051296	37	40	17	32	54	72	TRUE	FALSE	TRUE	0	TRUE	FALSE	0	0
FBgn0051300	69	62	69	55	138	117	TRUE	TRUE	TRUE	1	TRUE	TRUE	1	1
FBgn0051320	305	298	229	229	534	527	TRUE	TRUE	TRUE	1	TRUE	TRUE	1	1
FBgn0051321	250	242	178	192	428	434	TRUE	TRUE	TRUE	1	TRUE	TRUE	1	1
FBgn0051323	130	162	129	125	259	287	FALSE	TRUE	TRUE	0	TRUE	TRUE	1	0
FBgn0051324	356	332	261	287	617	619	TRUE	TRUE	TRUE	1	TRUE	TRUE	1	1
FBgn0051326	158	178	143	140	301	318	TRUE	TRUE	TRUE	1	TRUE	TRUE	1	1
FBgn0051327	269	232	224	191	493	423	TRUE	TRUE	FALSE	0	TRUE	TRUE	1	0
FBgn0051333	30	38	25	22	55	60	TRUE	TRUE	TRUE	1	TRUE	TRUE	1	1
FBgn0051334	37	34	27	24	64	58	TRUE	TRUE	TRUE	1	TRUE	TRUE	1	1
FBgn0051337	68	62	52	41	120	103	TRUE	TRUE	TRUE	1	TRUE	TRUE	1	1
FBgn0051342	252	228	196	208	448	436	TRUE	TRUE	TRUE	1	TRUE	TRUE	1	1
FBgn0051343	253	285	202	233	455	518	TRUE	TRUE	FALSE	0	TRUE	TRUE	1	0
FBgn0051345	117	126	106	90	223	216	TRUE	TRUE	TRUE	1	TRUE	TRUE	1	1
FBgn0051347	20	24	19	18	39	42	TRUE	TRUE	TRUE	1	TRUE	TRUE	1	1
FBgn0051356	19	15	14	20	33	35	TRUE	TRUE	TRUE	1	TRUE	TRUE	1	1
FBgn0051360	27	40	25	28	52	68	TRUE	TRUE	TRUE	1	TRUE	TRUE	1	1
FBgn0051361	301	275	233	232	534	507	TRUE	TRUE	TRUE	1	TRUE	TRUE	1	1
FBgn0051363	158	134	124	129	282	263	TRUE	TRUE	TRUE	1	TRUE	TRUE	1	1
FBgn0051365	170	161	134	146	304	307	TRUE	TRUE	TRUE	1	TRUE	TRUE	1	1
FBgn0051368	149	159	142	126	291	285	TRUE	TRUE	TRUE	1	TRUE	TRUE	1	1
FBgn0051370	105	121	89	99	194	220	TRUE	TRUE	TRUE	1	TRUE	TRUE	1	1
FBgn0051371	218	235	203	176	421	411	TRUE	TRUE	TRUE	1	TRUE	TRUE	1	1
FBgn0051373	35	48	49	37	84	85	TRUE	TRUE	TRUE	1	TRUE	TRUE	1	1
FBgn0051380	103	124	88	92	191	216	TRUE	TRUE	TRUE	1	TRUE	TRUE	1	1
FBgn0051383	35	25	20	21	55	46	TRUE	TRUE	TRUE	1	TRUE	TRUE	1	1
FBgn0051386	262	253	202	199	464	452	TRUE	TRUE	TRUE	1	TRUE	TRUE	1	1
FBgn0051388	94	114	95	98	189	212	TRUE	TRUE	TRUE	1	TRUE	TRUE	1	1
FBgn0051390	46	47	36	25	82	72	TRUE	TRUE	TRUE	1	TRUE	TRUE	1	1
FBgn0051391	67	69	67	53	134	122	TRUE	TRUE	TRUE	1	TRUE	TRUE	1	1
FBgn0051404	79	57	52	66	131	123	FALSE	TRUE	TRUE	0	TRUE	TRUE	1	0
FBgn0051406	77	92	51	55	128	147	TRUE	TRUE	TRUE	1	TRUE	TRUE	1	1
FBgn0051413	54	53	50	67	104	120	TRUE	TRUE	TRUE	1	TRUE	TRUE	1	1
FBgn0051414	64	65	71	56	135	121	TRUE	TRUE	TRUE	1	TRUE	TRUE	1	1
FBgn0051418	58	45	50	28	108	73	TRUE	FALSE	FALSE	0	TRUE	FALSE	0	0
FBgn0051419	47	66	44	42	91	108	FALSE	TRUE	TRUE	0	TRUE	TRUE	1	0
FBgn0051423	136	148	125	119	261	267	TRUE	TRUE	TRUE	1	TRUE	TRUE	1	1
FBgn0051424	218	202	175	182	393	384	TRUE	TRUE	TRUE	1	TRUE	TRUE	1	1
FBgn0051427	130	146	107	107	237	253	TRUE	TRUE	TRUE	1	TRUE	TRUE	1	1
FBgn0051431	151	157	115	130	266	287	TRUE	TRUE	TRUE	1	TRUE	TRUE	1	1
FBgn0051436	130	141	140	116	270	257	TRUE	TRUE	TRUE	1	TRUE	TRUE	1	1
FBgn0051437	75	43	45	32	120	75	FALSE	TRUE	FALSE	0	FALSE	TRUE	0	0
FBgn0051438	78	60	60	50	138	110	TRUE	TRUE	FALSE	0	TRUE	TRUE	1	0
FBgn0051439	68	61	67	49	135	110	TRUE	TRUE	TRUE	1	TRUE	TRUE	1	1
FBgn0051441	65	59	58	60	123	119	TRUE	TRUE	TRUE	1	TRUE	TRUE	1	1
FBgn0051445	353	358	288	307	641	665	TRUE	TRUE	TRUE	1	TRUE	TRUE	1	1
FBgn0051446	84	83	65	69	149	152	TRUE	TRUE	TRUE	1	TRUE	TRUE	1	1
FBgn0051450	30	32	20	29	50	61	TRUE	TRUE	TRUE	1	TRUE	TRUE	1	1
FBgn0051451	37	32	24	24	61	56	TRUE	TRUE	TRUE	1	TRUE	TRUE	1	1
FBgn0051453	56	65	51	49	107	114	TRUE	TRUE	TRUE	1	TRUE	TRUE	1	1
FBgn0051454	60	68	65	54	125	122	TRUE	TRUE	TRUE	1	TRUE	TRUE	1	1
FBgn0051457	104	110	96	84	200	194	TRUE	TRUE	TRUE	1	TRUE	TRUE	1	1
FBgn0051459	123	116	102	97	225	213	TRUE	TRUE	TRUE	1	TRUE	TRUE	1	1
FBgn0051463	33	26	27	35	60	61	TRUE	TRUE	TRUE	1	TRUE	TRUE	1	1
FBgn0051467	59	65	73	60	132	125	TRUE	TRUE	TRUE	1	TRUE	TRUE	1	1
FBgn0051469	37	33	29	23	66	56	TRUE	TRUE	TRUE	1	TRUE	TRUE	1	1
FBgn0051472	26	22	24	23	50	45	TRUE	TRUE	TRUE	1	TRUE	TRUE	1	1
FBgn0051473	40	29	27	27	67	56	TRUE	TRUE	TRUE	1	TRUE	TRUE	1	1
FBgn0051475	183	189	166	169	349	358	TRUE	TRUE	TRUE	1	TRUE	TRUE	1	1
FBgn0051477	37	36	26	40	63	76	TRUE	TRUE	TRUE	1	TRUE	FALSE	0	0
FBgn0051480	29	18	22	20	51	38	TRUE	TRUE	TRUE	1	FALSE	TRUE	0	0
FBgn0051481	209	260	245	188	454	448	FALSE	FALSE	TRUE	0	TRUE	TRUE	1	0
FBgn0051485	22	32	25	25	47	57	TRUE	TRUE	TRUE	1	TRUE	TRUE	1	1
FBgn0051493	57	62	45	55	102	117	TRUE	TRUE	TRUE	1	TRUE	TRUE	1	1
FBgn0051495	137	128	87	94	224	222	TRUE	TRUE	TRUE	1	TRUE	TRUE	1	1
FBgn0051496	59	60	54	59	113	119	TRUE	TRUE	TRUE	1	TRUE	TRUE	1	1
FBgn0051497	39	37	29	29	68	66	TRUE	TRUE	TRUE	1	TRUE	TRUE	1	1
FBgn0051501	59	51	52	46	111	97	TRUE	TRUE	TRUE	1	TRUE	TRUE	1	1
FBgn0051506	17	38	16	26	33	64	FALSE	TRUE	FALSE	0	FALSE	FALSE	0	0
FBgn0051510	194	219	154	180	348	399	TRUE	TRUE	FALSE	0	TRUE	TRUE	1	0
FBgn0051514	37	31	19	25	56	56	TRUE	TRUE	TRUE	1	TRUE	TRUE	1	1
FBgn0051515	44	63	52	58	96	121	FALSE	TRUE	TRUE	0	TRUE	TRUE	1	0
FBgn0051518	18	26	27	26	45	52	TRUE	TRUE	TRUE	1	TRUE	TRUE	1	1
FBgn0051522	90	93	65	65	155	158	TRUE	TRUE	TRUE	1	TRUE	TRUE	1	1
FBgn0051523	109	120	93	91	202	211	TRUE	TRUE	TRUE	1	TRUE	TRUE	1	1
FBgn0051524	223	215	209	185	432	400	TRUE	TRUE	TRUE	1	TRUE	TRUE	1	1
FBgn0051526	39	33	29	37	68	70	TRUE	TRUE	TRUE	1	TRUE	TRUE	1	1
FBgn0051533	217	193	176	190	393	383	TRUE	TRUE	TRUE	1	TRUE	TRUE	1	1
FBgn0051538	105	101	64	59	169	160	TRUE	TRUE	TRUE	1	TRUE	TRUE	1	1
FBgn0051547	152	180	131	132	283	312	TRUE	TRUE	TRUE	1	TRUE	TRUE	1	1
FBgn0051549	26	20	19	18	45	38	TRUE	TRUE	TRUE	1	TRUE	TRUE	1	1
FBgn0051550	82	83	62	55	144	138	TRUE	TRUE	TRUE	1	TRUE	TRUE	1	1
FBgn0051551	57	46	48	26	105	72	TRUE	FALSE	FALSE	0	TRUE	FALSE	0	0
FBgn0051559	48	51	36	35	84	86	TRUE	TRUE	TRUE	1	TRUE	TRUE	1	1
FBgn0051560	54	60	77	74	131	134	TRUE	TRUE	TRUE	1	TRUE	TRUE	1	1
FBgn0051561	61	61	64	57	125	118	TRUE	TRUE	TRUE	1	TRUE	TRUE	1	1
FBgn0051562	17	16	15	22	32	38	TRUE	TRUE	TRUE	1	TRUE	TRUE	1	1
FBgn0051573	18	21	17	15	35	36	TRUE	TRUE	TRUE	1	TRUE	TRUE	1	1
FBgn0051576	19	26	18	19	37	45	TRUE	TRUE	TRUE	1	TRUE	TRUE	1	1
FBgn0051577	15	17	22	22	37	39	TRUE	TRUE	TRUE	1	TRUE	TRUE	1	1
FBgn0051588	13	18	18	16	31	34	TRUE	TRUE	TRUE	1	TRUE	TRUE	1	1
FBgn0051601	219	206	168	180	387	386	TRUE	TRUE	TRUE	1	TRUE	TRUE	1	1
FBgn0051602	18	18	12	24	30	42	TRUE	FALSE	TRUE	0	TRUE	FALSE	0	0
FBgn0051606	63	69	58	42	121	111	TRUE	TRUE	TRUE	1	TRUE	TRUE	1	1
FBgn0051609	36	28	21	27	57	55	TRUE	TRUE	TRUE	1	TRUE	TRUE	1	1
FBgn0051612	179	197	155	175	334	372	TRUE	TRUE	TRUE	1	TRUE	TRUE	1	1
FBgn0051619	251	250	232	214	483	464	TRUE	TRUE	TRUE	1	TRUE	TRUE	1	1
FBgn0051624	84	68	67	56	151	124	TRUE	TRUE	TRUE	1	TRUE	TRUE	1	1
FBgn0051626	24	33	37	35	61	68	TRUE	TRUE	TRUE	1	TRUE	TRUE	1	1
FBgn0051632	344	355	267	298	611	653	TRUE	TRUE	TRUE	1	TRUE	TRUE	1	1
FBgn0051633	77	97	75	86	152	183	TRUE	TRUE	TRUE	1	TRUE	TRUE	1	1
FBgn0051634	200	185	176	146	376	331	TRUE	TRUE	FALSE	0	TRUE	TRUE	1	0
FBgn0051635	420	444	359	329	779	773	TRUE	TRUE	TRUE	1	TRUE	TRUE	1	1
FBgn0051636	49	50	37	48	86	98	TRUE	TRUE	TRUE	1	TRUE	TRUE	1	1
FBgn0051637	163	147	119	116	282	263	TRUE	TRUE	TRUE	1	TRUE	TRUE	1	1
FBgn0051638	347	340	244	272	591	612	TRUE	TRUE	TRUE	1	TRUE	TRUE	1	1
FBgn0051639	69	63	47	64	116	127	TRUE	TRUE	TRUE	1	TRUE	TRUE	1	1
FBgn0051642	185	172	120	160	305	332	TRUE	FALSE	TRUE	0	TRUE	TRUE	1	0
FBgn0051643	181	203	186	171	367	374	TRUE	TRUE	TRUE	1	TRUE	TRUE	1	1
FBgn0051644	79	81	64	43	143	124	TRUE	FALSE	TRUE	0	TRUE	TRUE	1	0
FBgn0051646	328	343	296	289	624	632	TRUE	TRUE	TRUE	1	TRUE	TRUE	1	1
FBgn0051647	128	148	105	128	233	276	TRUE	TRUE	FALSE	0	TRUE	TRUE	1	0
FBgn0051648	78	83	51	53	129	136	TRUE	TRUE	TRUE	1	TRUE	TRUE	1	1
FBgn0051658	68	79	66	75	134	154	TRUE	TRUE	TRUE	1	TRUE	TRUE	1	1
FBgn0051659	58	86	54	60	112	146	FALSE	TRUE	FALSE	0	TRUE	TRUE	1	0
FBgn0051660	635	618	531	535	1166	1153	TRUE	TRUE	TRUE	1	TRUE	TRUE	1	1
FBgn0051661	78	95	83	76	161	171	TRUE	TRUE	TRUE	1	TRUE	TRUE	1	1
FBgn0051663	373	383	295	321	668	704	TRUE	TRUE	TRUE	1	TRUE	TRUE	1	1
FBgn0051664	47	69	38	42	85	111	FALSE	TRUE	FALSE	0	TRUE	TRUE	1	0
FBgn0051665	296	263	244	244	540	507	TRUE	TRUE	TRUE	1	TRUE	TRUE	1	1
FBgn0051668	193	240	187	223	380	463	FALSE	FALSE	FALSE	0	TRUE	TRUE	1	0
FBgn0051673	90	111	92	79	182	190	TRUE	TRUE	TRUE	1	TRUE	TRUE	1	1
FBgn0051674	39	36	28	29	67	65	TRUE	TRUE	TRUE	1	TRUE	TRUE	1	1
FBgn0051675	116	96	88	82	204	178	TRUE	TRUE	TRUE	1	TRUE	TRUE	1	1
FBgn0051676	104	104	92	88	196	192	TRUE	TRUE	TRUE	1	TRUE	TRUE	1	1
FBgn0051677	33	33	45	33	78	66	TRUE	TRUE	TRUE	1	TRUE	TRUE	1	1
FBgn0051678	229	256	181	179	410	435	TRUE	TRUE	TRUE	1	TRUE	TRUE	1	1
FBgn0051679	48	40	37	42	85	82	TRUE	TRUE	TRUE	1	TRUE	TRUE	1	1
FBgn0051680	30	34	32	24	62	58	TRUE	TRUE	TRUE	1	TRUE	TRUE	1	1
FBgn0051681	86	54	58	47	144	101	FALSE	TRUE	FALSE	0	FALSE	TRUE	0	0
FBgn0051682	78	91	63	64	141	155	TRUE	TRUE	TRUE	1	TRUE	TRUE	1	1
FBgn0051687	132	89	112	76	244	165	FALSE	FALSE	FALSE	0	TRUE	TRUE	1	0
FBgn0051690	215	235	165	175	380	410	TRUE	TRUE	TRUE	1	TRUE	TRUE	1	1
FBgn0051693	71	66	50	40	121	106	TRUE	TRUE	TRUE	1	TRUE	TRUE	1	1
FBgn0051694	128	101	106	103	234	204	FALSE	TRUE	TRUE	0	TRUE	TRUE	1	0
FBgn0051698	43	35	29	30	72	65	TRUE	TRUE	TRUE	1	TRUE	TRUE	1	1
FBgn0051700	69	93	57	86	126	179	FALSE	FALSE	FALSE	0	TRUE	FALSE	0	0
FBgn0051702	39	46	25	28	64	74	TRUE	TRUE	TRUE	1	TRUE	TRUE	1	1
FBgn0051703	28	37	44	51	72	88	TRUE	TRUE	TRUE	1	TRUE	TRUE	1	1
FBgn0051704	48	39	31	20	79	59	TRUE	TRUE	TRUE	1	TRUE	FALSE	0	0
FBgn0051706	216	188	156	157	372	345	TRUE	TRUE	TRUE	1	TRUE	TRUE	1	1
FBgn0051708	391	347	318	294	709	641	TRUE	TRUE	FALSE	0	TRUE	TRUE	1	0
FBgn0051709	127	158	71	84	198	242	FALSE	TRUE	FALSE	0	TRUE	TRUE	1	0
FBgn0051710	186	210	196	160	382	370	TRUE	FALSE	TRUE	0	TRUE	TRUE	1	0
FBgn0051712	60	69	67	50	127	119	TRUE	TRUE	TRUE	1	TRUE	TRUE	1	1
FBgn0051716	357	372	323	315	680	687	TRUE	TRUE	TRUE	1	TRUE	TRUE	1	1
FBgn0051717	29	31	16	16	45	47	TRUE	TRUE	TRUE	1	TRUE	TRUE	1	1
FBgn0051718	212	216	165	175	377	391	TRUE	TRUE	TRUE	1	TRUE	TRUE	1	1
FBgn0051719	367	352	309	297	676	649	TRUE	TRUE	TRUE	1	TRUE	TRUE	1	1
FBgn0051720	281	238	213	203	494	441	FALSE	TRUE	FALSE	0	TRUE	TRUE	1	0
FBgn0051721	371	386	298	304	669	690	TRUE	TRUE	TRUE	1	TRUE	TRUE	1	1
FBgn0051729	367	340	286	286	653	626	TRUE	TRUE	TRUE	1	TRUE	TRUE	1	1
FBgn0051730	77	75	83	71	160	146	TRUE	TRUE	TRUE	1	TRUE	TRUE	1	1
FBgn0051735	69	65	55	58	124	123	TRUE	TRUE	TRUE	1	TRUE	TRUE	1	1
FBgn0051739	148	147	123	111	271	258	TRUE	TRUE	TRUE	1	TRUE	TRUE	1	1
FBgn0051740	24	23	24	23	48	46	TRUE	TRUE	TRUE	1	TRUE	TRUE	1	1
FBgn0051741	117	117	97	93	214	210	TRUE	TRUE	TRUE	1	TRUE	TRUE	1	1
FBgn0051742	88	70	92	69	180	139	TRUE	FALSE	FALSE	0	TRUE	TRUE	1	0
FBgn0051752	108	102	93	63	201	165	TRUE	FALSE	FALSE	0	TRUE	TRUE	1	0
FBgn0051755	450	475	404	357	854	832	TRUE	FALSE	TRUE	0	TRUE	TRUE	1	0
FBgn0051759	189	184	143	158	332	342	TRUE	TRUE	TRUE	1	TRUE	TRUE	1	1
FBgn0051760	546	599	455	466	1001	1065	TRUE	TRUE	TRUE	1	TRUE	TRUE	1	1
FBgn0051769	91	99	88	88	179	187	TRUE	TRUE	TRUE	1	TRUE	TRUE	1	1
FBgn0051773	150	147	120	124	270	271	TRUE	TRUE	TRUE	1	TRUE	TRUE	1	1
FBgn0051774	733	716	616	599	1349	1315	TRUE	TRUE	TRUE	1	TRUE	TRUE	1	1
FBgn0051776	220	157	169	156	389	313	FALSE	TRUE	FALSE	0	TRUE	TRUE	1	0
FBgn0051777	36	23	32	11	68	34	TRUE	FALSE	FALSE	0	FALSE	FALSE	0	0
FBgn0051778	22	25	27	17	49	42	TRUE	TRUE	TRUE	1	TRUE	FALSE	0	0
FBgn0051779	86	73	59	67	145	140	TRUE	TRUE	TRUE	1	TRUE	TRUE	1	1
FBgn0051781	187	173	145	153	332	326	TRUE	TRUE	TRUE	1	TRUE	TRUE	1	1
FBgn0051784	124	139	115	157	239	296	TRUE	FALSE	FALSE	0	TRUE	TRUE	1	0
FBgn0051785	99	117	102	87	201	204	TRUE	TRUE	TRUE	1	TRUE	TRUE	1	1
FBgn0051787	54	66	51	62	105	128	TRUE	TRUE	TRUE	1	TRUE	TRUE	1	1
FBgn0051788	71	58	51	59	122	117	TRUE	TRUE	TRUE	1	TRUE	TRUE	1	1
FBgn0051789	78	93	53	77	131	170	TRUE	FALSE	FALSE	0	TRUE	TRUE	1	0
FBgn0051792	278	263	230	213	508	476	TRUE	TRUE	TRUE	1	TRUE	TRUE	1	1
FBgn0051793	235	236	183	204	418	440	TRUE	TRUE	TRUE	1	TRUE	TRUE	1	1
FBgn0051797	156	193	135	157	291	350	FALSE	TRUE	FALSE	0	TRUE	TRUE	1	0
FBgn0051798	193	210	173	161	366	371	TRUE	TRUE	TRUE	1	TRUE	TRUE	1	1
FBgn0051802	25	18	22	35	47	53	TRUE	TRUE	TRUE	1	TRUE	FALSE	0	0
FBgn0051803	37	35	27	29	64	64	TRUE	TRUE	TRUE	1	TRUE	TRUE	1	1
FBgn0051804	87	95	96	94	183	189	TRUE	TRUE	TRUE	1	TRUE	TRUE	1	1
FBgn0051805	26	35	22	26	48	61	TRUE	TRUE	TRUE	1	TRUE	TRUE	1	1
FBgn0051806	19	24	17	23	36	47	TRUE	TRUE	TRUE	1	TRUE	TRUE	1	1
FBgn0051809	34	44	41	37	75	81	TRUE	TRUE	TRUE	1	TRUE	TRUE	1	1
FBgn0051810	44	55	51	46	95	101	TRUE	TRUE	TRUE	1	TRUE	TRUE	1	1
FBgn0051812	31	47	34	55	65	102	FALSE	FALSE	FALSE	0	FALSE	FALSE	0	0
FBgn0051814	531	506	409	430	940	936	TRUE	TRUE	TRUE	1	TRUE	TRUE	1	1
FBgn0051815	162	183	136	144	298	327	TRUE	TRUE	TRUE	1	TRUE	TRUE	1	1
FBgn0051816	100	91	94	81	194	172	TRUE	TRUE	TRUE	1	TRUE	TRUE	1	1
FBgn0051820	28	32	47	35	75	67	TRUE	TRUE	TRUE	1	TRUE	TRUE	1	1
FBgn0051821	57	66	71	48	128	114	TRUE	FALSE	TRUE	0	TRUE	TRUE	1	0
FBgn0051822	84	80	83	83	167	163	TRUE	TRUE	TRUE	1	TRUE	TRUE	1	1
FBgn0051823	135	134	124	110	259	244	TRUE	TRUE	TRUE	1	TRUE	TRUE	1	1
FBgn0051824	22	24	26	28	48	52	TRUE	TRUE	TRUE	1	TRUE	TRUE	1	1
FBgn0051826	126	136	116	107	242	243	TRUE	TRUE	TRUE	1	TRUE	TRUE	1	1
FBgn0051832	75	88	59	81	134	169	TRUE	FALSE	FALSE	0	TRUE	TRUE	1	0
FBgn0051840	43	46	35	43	78	89	TRUE	TRUE	TRUE	1	TRUE	TRUE	1	1
FBgn0051845	50	53	44	42	94	95	TRUE	TRUE	TRUE	1	TRUE	TRUE	1	1
FBgn0051848	90	82	56	54	146	136	TRUE	TRUE	TRUE	1	TRUE	TRUE	1	1
FBgn0051849	125	127	84	88	209	215	TRUE	TRUE	TRUE	1	TRUE	TRUE	1	1
FBgn0051851	82	76	61	76	143	152	TRUE	TRUE	TRUE	1	TRUE	TRUE	1	1
FBgn0051852	78	91	46	51	124	142	TRUE	TRUE	TRUE	1	TRUE	TRUE	1	1
FBgn0051858	102	89	85	81	187	170	TRUE	TRUE	TRUE	1	TRUE	TRUE	1	1
FBgn0051860	202	223	152	171	354	394	TRUE	TRUE	TRUE	1	TRUE	TRUE	1	1
FBgn0051861	57	55	38	38	95	93	TRUE	TRUE	TRUE	1	TRUE	TRUE	1	1
FBgn0051862	90	100	87	104	177	204	TRUE	TRUE	TRUE	1	TRUE	TRUE	1	1
FBgn0051864	33	76	35	47	68	123	FALSE	TRUE	FALSE	0	FALSE	TRUE	0	0
FBgn0051866	1	32	1	32	2	64	FALSE	FALSE	FALSE	0	FALSE	FALSE	0	0
FBgn0051867	109	117	71	76	180	193	TRUE	TRUE	TRUE	1	TRUE	TRUE	1	1
FBgn0051869	293	281	230	241	523	522	TRUE	TRUE	TRUE	1	TRUE	TRUE	1	1
FBgn0051870	110	115	97	72	207	187	TRUE	FALSE	TRUE	0	TRUE	TRUE	1	0
FBgn0051871	169	160	157	147	326	307	TRUE	TRUE	TRUE	1	TRUE	TRUE	1	1
FBgn0051872	294	254	250	262	544	516	FALSE	TRUE	TRUE	0	TRUE	TRUE	1	0
FBgn0051874	140	123	106	93	246	216	TRUE	TRUE	TRUE	1	TRUE	TRUE	1	1
FBgn0051875	60	73	71	54	131	127	TRUE	TRUE	TRUE	1	TRUE	TRUE	1	1
FBgn0051876	77	92	53	51	130	143	TRUE	TRUE	TRUE	1	TRUE	TRUE	1	1
FBgn0051882	98	100	84	71	182	171	TRUE	TRUE	TRUE	1	TRUE	TRUE	1	1
FBgn0051885	22	29	23	25	45	54	TRUE	TRUE	TRUE	1	TRUE	TRUE	1	1
FBgn0051889	18	28	26	29	44	57	TRUE	TRUE	TRUE	1	FALSE	TRUE	0	0
FBgn0051896	33	33	26	22	59	55	TRUE	TRUE	TRUE	1	TRUE	TRUE	1	1
FBgn0051897	245	230	233	188	478	418	TRUE	FALSE	FALSE	0	TRUE	TRUE	1	0
FBgn0051898	84	91	78	76	162	167	TRUE	TRUE	TRUE	1	TRUE	TRUE	1	1
FBgn0051901	126	126	103	95	229	221	TRUE	TRUE	TRUE	1	TRUE	TRUE	1	1
FBgn0051902	143	145	103	131	246	276	TRUE	FALSE	TRUE	0	TRUE	TRUE	1	0
FBgn0051907	49	48	38	51	87	99	TRUE	TRUE	TRUE	1	TRUE	TRUE	1	1
FBgn0051908	148	128	115	112	263	240	TRUE	TRUE	TRUE	1	TRUE	TRUE	1	1
FBgn0051909	26	26	27	26	53	52	TRUE	TRUE	TRUE	1	TRUE	TRUE	1	1
FBgn0051910	43	47	59	40	102	87	TRUE	FALSE	TRUE	0	TRUE	TRUE	1	0
FBgn0051912	42	32	37	15	79	47	TRUE	FALSE	FALSE	0	TRUE	FALSE	0	0
FBgn0051913	72	82	66	73	138	155	TRUE	TRUE	TRUE	1	TRUE	TRUE	1	1
FBgn0051914	21	19	21	25	42	44	TRUE	TRUE	TRUE	1	TRUE	TRUE	1	1
FBgn0051915	224	232	169	214	393	446	TRUE	FALSE	FALSE	0	TRUE	TRUE	1	0
FBgn0051921	133	144	87	101	220	245	TRUE	TRUE	TRUE	1	TRUE	TRUE	1	1
FBgn0051924	43	56	46	36	89	92	TRUE	TRUE	TRUE	1	TRUE	TRUE	1	1
FBgn0051926	149	169	106	126	255	295	TRUE	TRUE	FALSE	0	TRUE	TRUE	1	0
FBgn0051928	120	133	99	97	219	230	TRUE	TRUE	TRUE	1	TRUE	TRUE	1	1
FBgn0051933	49	46	43	56	92	102	TRUE	TRUE	TRUE	1	TRUE	TRUE	1	1
FBgn0051935	269	228	206	234	475	462	FALSE	TRUE	TRUE	0	TRUE	TRUE	1	0
FBgn0051942	24	28	20	29	44	57	TRUE	TRUE	TRUE	1	TRUE	TRUE	1	1
FBgn0051944	21	19	25	24	46	43	TRUE	TRUE	TRUE	1	TRUE	TRUE	1	1
FBgn0051948	74	58	53	53	127	111	TRUE	TRUE	TRUE	1	TRUE	TRUE	1	1
FBgn0051949	68	66	57	46	125	112	TRUE	TRUE	TRUE	1	TRUE	TRUE	1	1
FBgn0051950	39	34	26	40	65	74	TRUE	TRUE	TRUE	1	TRUE	FALSE	0	0
FBgn0051952	66	70	55	67	121	137	TRUE	TRUE	TRUE	1	TRUE	TRUE	1	1
FBgn0051954	42	47	39	38	81	85	TRUE	TRUE	TRUE	1	TRUE	TRUE	1	1
FBgn0051955	39	48	37	33	76	81	TRUE	TRUE	TRUE	1	TRUE	TRUE	1	1
FBgn0051956	172	180	163	132	335	312	TRUE	FALSE	TRUE	0	TRUE	TRUE	1	0
FBgn0051957	63	88	52	52	115	140	FALSE	TRUE	TRUE	0	TRUE	TRUE	1	0
FBgn0051958	50	28	41	22	91	50	FALSE	FALSE	FALSE	0	FALSE	FALSE	0	0
FBgn0051960	49	90	43	65	92	155	FALSE	FALSE	FALSE	0	FALSE	FALSE	0	0
FBgn0051961	97	100	68	79	165	179	TRUE	TRUE	TRUE	1	TRUE	TRUE	1	1
FBgn0051971	26	22	25	20	51	42	TRUE	TRUE	TRUE	1	TRUE	TRUE	1	1
FBgn0051973	204	201	198	164	402	365	TRUE	FALSE	TRUE	0	TRUE	TRUE	1	0
FBgn0051988	60	44	46	41	106	85	TRUE	TRUE	TRUE	1	TRUE	TRUE	1	1
FBgn0051989	269	296	233	225	502	521	TRUE	TRUE	TRUE	1	TRUE	TRUE	1	1
FBgn0051992	25	22	26	20	51	42	TRUE	TRUE	TRUE	1	TRUE	TRUE	1	1
FBgn0051998	69	64	57	55	126	119	TRUE	TRUE	TRUE	1	TRUE	TRUE	1	1
FBgn0051999	61	50	57	52	118	102	TRUE	TRUE	TRUE	1	TRUE	TRUE	1	1
FBgn0052000	128	133	115	109	243	242	TRUE	TRUE	TRUE	1	TRUE	TRUE	1	1
FBgn0052006	48	51	37	42	85	93	TRUE	TRUE	TRUE	1	TRUE	TRUE	1	1
FBgn0052009	57	65	54	51	111	116	TRUE	TRUE	TRUE	1	TRUE	TRUE	1	1
FBgn0052010	40	12	41	12	81	24	FALSE	FALSE	FALSE	0	FALSE	FALSE	0	0
FBgn0052011	53	37	53	44	106	81	TRUE	TRUE	FALSE	0	TRUE	TRUE	1	0
FBgn0052016	36	41	49	44	85	85	TRUE	TRUE	TRUE	1	TRUE	TRUE	1	1
FBgn0052017	121	113	81	113	202	226	TRUE	FALSE	TRUE	0	TRUE	TRUE	1	0
FBgn0052023	55	43	41	33	96	76	TRUE	TRUE	TRUE	1	TRUE	TRUE	1	1
FBgn0052024	101	84	80	69	181	153	TRUE	TRUE	TRUE	1	TRUE	TRUE	1	1
FBgn0052026	111	107	101	95	212	202	TRUE	TRUE	TRUE	1	TRUE	TRUE	1	1
FBgn0052029	68	75	45	51	113	126	TRUE	TRUE	TRUE	1	TRUE	TRUE	1	1
FBgn0052036	92	91	74	71	166	162	TRUE	TRUE	TRUE	1	TRUE	TRUE	1	1
FBgn0052037	137	139	95	91	232	230	TRUE	TRUE	TRUE	1	TRUE	TRUE	1	1
FBgn0052039	86	79	62	58	148	137	TRUE	TRUE	TRUE	1	TRUE	TRUE	1	1
FBgn0052040	90	93	97	70	187	163	TRUE	FALSE	TRUE	0	TRUE	TRUE	1	0
FBgn0052053	169	166	131	145	300	311	TRUE	TRUE	TRUE	1	TRUE	TRUE	1	1
FBgn0052054	157	149	140	134	297	283	TRUE	TRUE	TRUE	1	TRUE	TRUE	1	1
FBgn0052055	214	158	156	157	370	315	FALSE	TRUE	FALSE	0	TRUE	TRUE	1	0
FBgn0052056	273	281	224	225	497	506	TRUE	TRUE	TRUE	1	TRUE	TRUE	1	1
FBgn0052057	250	293	215	207	465	500	FALSE	TRUE	TRUE	0	TRUE	TRUE	1	0
FBgn0052058	116	135	118	107	234	242	TRUE	TRUE	TRUE	1	TRUE	TRUE	1	1
FBgn0052061	92	70	92	63	184	133	FALSE	FALSE	FALSE	0	TRUE	TRUE	1	0
FBgn0052062	658	674	545	584	1203	1258	TRUE	TRUE	TRUE	1	TRUE	TRUE	1	1
FBgn0052064	138	146	129	112	267	258	TRUE	TRUE	TRUE	1	TRUE	TRUE	1	1
FBgn0052066	181	171	141	117	322	288	TRUE	TRUE	TRUE	1	TRUE	TRUE	1	1
FBgn0052068	76	79	59	73	135	152	TRUE	TRUE	TRUE	1	TRUE	TRUE	1	1
FBgn0052069	26	27	30	27	56	54	TRUE	TRUE	TRUE	1	TRUE	TRUE	1	1
FBgn0052071	57	68	44	41	101	109	TRUE	TRUE	TRUE	1	TRUE	TRUE	1	1
FBgn0052072	113	115	90	94	203	209	TRUE	TRUE	TRUE	1	TRUE	TRUE	1	1
FBgn0052073	57	67	60	51	117	118	TRUE	TRUE	TRUE	1	TRUE	TRUE	1	1
FBgn0052074	68	51	56	51	124	102	TRUE	TRUE	TRUE	1	TRUE	TRUE	1	1
FBgn0052075	115	82	101	92	216	174	FALSE	TRUE	FALSE	0	TRUE	TRUE	1	0
FBgn0052076	100	120	75	93	175	213	TRUE	TRUE	FALSE	0	TRUE	TRUE	1	0
FBgn0052079	179	162	150	146	329	308	TRUE	TRUE	TRUE	1	TRUE	TRUE	1	1
FBgn0052081	128	125	122	123	250	248	TRUE	TRUE	TRUE	1	TRUE	TRUE	1	1
FBgn0052082	404	387	322	340	726	727	TRUE	TRUE	TRUE	1	TRUE	TRUE	1	1
FBgn0052085	313	262	212	212	525	474	FALSE	TRUE	TRUE	0	TRUE	TRUE	1	0
FBgn0052086	139	116	108	97	247	213	TRUE	TRUE	TRUE	1	TRUE	TRUE	1	1
FBgn0052087	83	77	46	54	129	131	TRUE	TRUE	TRUE	1	TRUE	TRUE	1	1
FBgn0052088	276	272	235	204	511	476	TRUE	TRUE	TRUE	1	TRUE	TRUE	1	1
FBgn0052091	267	266	234	237	501	503	TRUE	TRUE	TRUE	1	TRUE	TRUE	1	1
FBgn0052093	25	44	20	27	45	71	FALSE	TRUE	FALSE	0	FALSE	TRUE	0	0
FBgn0052095	109	94	80	76	189	170	TRUE	TRUE	TRUE	1	TRUE	TRUE	1	1
FBgn0052099	116	126	106	85	222	211	TRUE	TRUE	TRUE	1	TRUE	TRUE	1	1
FBgn0052100	114	111	91	70	205	181	TRUE	TRUE	TRUE	1	TRUE	TRUE	1	1
FBgn0052102	46	41	39	42	85	83	TRUE	TRUE	TRUE	1	TRUE	TRUE	1	1
FBgn0052103	280	318	267	236	547	554	TRUE	TRUE	TRUE	1	TRUE	TRUE	1	1
FBgn0052104	371	381	336	314	707	695	TRUE	TRUE	TRUE	1	TRUE	TRUE	1	1
FBgn0052105	193	179	192	161	385	340	TRUE	TRUE	TRUE	1	TRUE	TRUE	1	1
FBgn0052106	412	520	396	394	808	914	FALSE	TRUE	FALSE	0	TRUE	TRUE	1	0
FBgn0052107	437	432	317	381	754	813	TRUE	FALSE	TRUE	0	TRUE	TRUE	1	0
FBgn0052109	105	97	95	99	200	196	TRUE	TRUE	TRUE	1	TRUE	TRUE	1	1
FBgn0052110	37	44	29	34	66	78	TRUE	TRUE	TRUE	1	TRUE	TRUE	1	1
FBgn0052111	508	502	421	393	929	895	TRUE	TRUE	TRUE	1	TRUE	TRUE	1	1
FBgn0052112	204	223	193	180	397	403	TRUE	TRUE	TRUE	1	TRUE	TRUE	1	1
FBgn0052113	946	929	831	837	1777	1766	TRUE	TRUE	TRUE	1	TRUE	TRUE	1	1
FBgn0052115	100	99	106	104	206	203	TRUE	TRUE	TRUE	1	TRUE	TRUE	1	1
FBgn0052117	35	44	29	34	64	78	TRUE	TRUE	TRUE	1	TRUE	TRUE	1	1
FBgn0052119	163	152	129	142	292	294	TRUE	TRUE	TRUE	1	TRUE	TRUE	1	1
FBgn0052121	119	128	102	86	221	214	TRUE	TRUE	TRUE	1	TRUE	TRUE	1	1
FBgn0052126	23	18	26	13	49	31	TRUE	FALSE	FALSE	0	TRUE	FALSE	0	0
FBgn0052127	19	28	20	14	39	42	TRUE	TRUE	TRUE	1	TRUE	TRUE	1	1
FBgn0052128	32	24	27	20	59	44	TRUE	TRUE	TRUE	1	TRUE	TRUE	1	1
FBgn0052133	344	335	236	294	580	629	TRUE	FALSE	TRUE	0	TRUE	TRUE	1	0
FBgn0052137	232	274	218	219	450	493	FALSE	TRUE	TRUE	0	TRUE	TRUE	1	0
FBgn0052150	114	106	87	97	201	203	TRUE	TRUE	TRUE	1	TRUE	TRUE	1	1
FBgn0052153	21	27	14	28	35	55	TRUE	FALSE	FALSE	0	TRUE	FALSE	0	0
FBgn0052160	155	177	131	136	286	313	TRUE	TRUE	TRUE	1	TRUE	TRUE	1	1
FBgn0052170	91	89	77	78	168	167	TRUE	TRUE	TRUE	1	TRUE	TRUE	1	1
FBgn0052173	19	32	12	24	31	56	FALSE	FALSE	FALSE	0	FALSE	FALSE	0	0
FBgn0052174	28	27	19	25	47	52	TRUE	TRUE	TRUE	1	TRUE	TRUE	1	1
FBgn0052176	106	110	101	96	207	206	TRUE	TRUE	TRUE	1	TRUE	TRUE	1	1
FBgn0052177	64	55	57	56	121	111	TRUE	TRUE	TRUE	1	TRUE	TRUE	1	1
FBgn0052181	274	260	225	238	499	498	TRUE	TRUE	TRUE	1	TRUE	TRUE	1	1
FBgn0052182	74	84	59	48	133	132	TRUE	TRUE	TRUE	1	TRUE	TRUE	1	1
FBgn0052183	264	258	221	199	485	457	TRUE	TRUE	TRUE	1	TRUE	TRUE	1	1
FBgn0052185	59	46	45	47	104	93	TRUE	TRUE	TRUE	1	TRUE	TRUE	1	1
FBgn0052187	124	109	89	81	213	190	TRUE	TRUE	TRUE	1	TRUE	TRUE	1	1
FBgn0052188	13	19	8	28	21	47	TRUE	FALSE	FALSE	0	TRUE	FALSE	0	0
FBgn0052190	58	52	37	59	95	111	TRUE	FALSE	TRUE	0	TRUE	FALSE	0	0
FBgn0052191	78	107	72	88	150	195	FALSE	TRUE	FALSE	0	TRUE	TRUE	1	0
FBgn0052192	135	130	124	94	259	224	TRUE	FALSE	TRUE	0	TRUE	TRUE	1	0
FBgn0052194	90	96	87	65	177	161	TRUE	FALSE	TRUE	0	TRUE	TRUE	1	0
FBgn0052195	418	410	364	325	782	735	TRUE	TRUE	TRUE	1	TRUE	TRUE	1	1
FBgn0052196	71	59	63	56	134	115	TRUE	TRUE	TRUE	1	TRUE	TRUE	1	1
FBgn0052198	47	51	45	60	92	111	TRUE	TRUE	TRUE	1	TRUE	TRUE	1	1
FBgn0052199	199	146	179	175	378	321	FALSE	TRUE	FALSE	0	TRUE	TRUE	1	0
FBgn0052201	209	214	187	150	396	364	TRUE	FALSE	TRUE	0	TRUE	TRUE	1	0
FBgn0052202	59	35	30	26	89	61	FALSE	TRUE	FALSE	0	FALSE	TRUE	0	0
FBgn0052203	77	73	59	70	136	143	TRUE	TRUE	TRUE	1	TRUE	TRUE	1	1
FBgn0052204	301	387	304	295	605	682	FALSE	TRUE	FALSE	0	TRUE	TRUE	1	0
FBgn0052205	95	103	83	100	178	203	TRUE	TRUE	TRUE	1	TRUE	TRUE	1	1
FBgn0052206	433	453	351	377	784	830	TRUE	TRUE	TRUE	1	TRUE	TRUE	1	1
FBgn0052207	26	20	14	24	40	44	TRUE	TRUE	TRUE	1	TRUE	FALSE	0	0
FBgn0052208	21	23	21	10	42	33	TRUE	FALSE	TRUE	0	TRUE	FALSE	0	0
FBgn0052214	57	41	36	26	93	67	TRUE	TRUE	FALSE	0	TRUE	TRUE	1	0
FBgn0052218	52	57	43	47	95	104	TRUE	TRUE	TRUE	1	TRUE	TRUE	1	1
FBgn0052219	58	57	60	55	118	112	TRUE	TRUE	TRUE	1	TRUE	TRUE	1	1
FBgn0052220	41	41	29	35	70	76	TRUE	TRUE	TRUE	1	TRUE	TRUE	1	1
FBgn0052221	29	37	26	30	55	67	TRUE	TRUE	TRUE	1	TRUE	TRUE	1	1
FBgn0052225	62	64	55	74	117	138	TRUE	TRUE	TRUE	1	TRUE	TRUE	1	1
FBgn0052226	48	39	48	33	96	72	TRUE	TRUE	FALSE	0	TRUE	TRUE	1	0
FBgn0052227	85	81	72	55	157	136	TRUE	TRUE	TRUE	1	TRUE	TRUE	1	1
FBgn0052232	119	97	113	99	232	196	TRUE	TRUE	FALSE	0	TRUE	TRUE	1	0
FBgn0052237	113	146	99	111	212	257	FALSE	TRUE	FALSE	0	TRUE	TRUE	1	0
FBgn0052238	146	149	134	112	280	261	TRUE	TRUE	TRUE	1	TRUE	TRUE	1	1
FBgn0052240	85	79	83	67	168	146	TRUE	TRUE	TRUE	1	TRUE	TRUE	1	1
FBgn0052241	81	86	60	66	141	152	TRUE	TRUE	TRUE	1	TRUE	TRUE	1	1
FBgn0052243	171	170	131	144	302	314	TRUE	TRUE	TRUE	1	TRUE	TRUE	1	1
FBgn0052246	45	50	39	33	84	83	TRUE	TRUE	TRUE	1	TRUE	TRUE	1	1
FBgn0052248	60	78	43	57	103	135	TRUE	TRUE	FALSE	0	TRUE	TRUE	1	0
FBgn0052249	63	88	64	60	127	148	FALSE	TRUE	TRUE	0	TRUE	TRUE	1	0
FBgn0052250	119	120	82	84	201	204	TRUE	TRUE	TRUE	1	TRUE	TRUE	1	1
FBgn0052251	412	396	325	334	737	730	TRUE	TRUE	TRUE	1	TRUE	TRUE	1	1
FBgn0052255	181	162	142	140	323	302	TRUE	TRUE	TRUE	1	TRUE	TRUE	1	1
FBgn0052259	54	29	35	44	89	73	FALSE	TRUE	TRUE	0	FALSE	TRUE	0	0
FBgn0052260	308	248	239	214	547	462	FALSE	TRUE	FALSE	0	TRUE	TRUE	1	0
FBgn0052262	58	69	64	61	122	130	TRUE	TRUE	TRUE	1	TRUE	TRUE	1	1
FBgn0052263	76	56	82	70	158	126	FALSE	TRUE	FALSE	0	TRUE	TRUE	1	0
FBgn0052264	1041	989	858	864	1899	1853	TRUE	TRUE	TRUE	1	TRUE	TRUE	1	1
FBgn0052266	71	84	81	87	152	171	TRUE	TRUE	TRUE	1	TRUE	TRUE	1	1
FBgn0052267	53	52	50	60	103	112	TRUE	TRUE	TRUE	1	TRUE	TRUE	1	1
FBgn0052268	50	47	33	36	83	83	TRUE	TRUE	TRUE	1	TRUE	TRUE	1	1
FBgn0052271	57	35	39	47	96	82	FALSE	TRUE	TRUE	0	FALSE	TRUE	0	0
FBgn0052273	23	22	19	24	42	46	TRUE	TRUE	TRUE	1	TRUE	TRUE	1	1
FBgn0052274	43	39	33	30	76	69	TRUE	TRUE	TRUE	1	TRUE	TRUE	1	1
FBgn0052277	71	69	53	58	124	127	TRUE	TRUE	TRUE	1	TRUE	TRUE	1	1
FBgn0052278	10	24	15	16	25	40	FALSE	TRUE	FALSE	0	FALSE	TRUE	0	0
FBgn0052279	67	64	47	46	114	110	TRUE	TRUE	TRUE	1	TRUE	TRUE	1	1
FBgn0052280	61	70	60	71	121	141	TRUE	TRUE	TRUE	1	TRUE	TRUE	1	1
FBgn0052281	72	70	58	59	130	129	TRUE	TRUE	TRUE	1	TRUE	TRUE	1	1
FBgn0052282	25	20	17	28	42	48	TRUE	TRUE	TRUE	1	TRUE	FALSE	0	0
FBgn0052283	32	25	26	23	58	48	TRUE	TRUE	TRUE	1	TRUE	TRUE	1	1
FBgn0052284	65	65	44	51	109	116	TRUE	TRUE	TRUE	1	TRUE	TRUE	1	1
FBgn0052287	12	24	11	20	23	44	FALSE	TRUE	FALSE	0	FALSE	FALSE	0	0
FBgn0052296	634	661	568	540	1202	1201	TRUE	TRUE	TRUE	1	TRUE	TRUE	1	1
FBgn0052301	287	296	178	206	465	502	TRUE	TRUE	TRUE	1	TRUE	TRUE	1	1
FBgn0052305	517	485	289	288	806	773	TRUE	TRUE	TRUE	1	TRUE	TRUE	1	1
FBgn0052311	890	900	697	779	1587	1679	TRUE	FALSE	TRUE	0	TRUE	TRUE	1	0
FBgn0052313	66	73	61	59	127	132	TRUE	TRUE	TRUE	1	TRUE	TRUE	1	1
FBgn0052319	111	109	101	72	212	181	TRUE	FALSE	TRUE	0	TRUE	TRUE	1	0
FBgn0052320	301	299	213	223	514	522	TRUE	TRUE	TRUE	1	TRUE	TRUE	1	1
FBgn0052333	39	46	32	33	71	79	TRUE	TRUE	TRUE	1	TRUE	TRUE	1	1
FBgn0052343	118	121	103	98	221	219	TRUE	TRUE	TRUE	1	TRUE	TRUE	1	1
FBgn0052344	164	146	104	116	268	262	TRUE	TRUE	TRUE	1	TRUE	TRUE	1	1
FBgn0052350	105	84	79	66	184	150	TRUE	TRUE	FALSE	0	TRUE	TRUE	1	0
FBgn0052351	157	148	112	127	269	275	TRUE	TRUE	TRUE	1	TRUE	TRUE	1	1
FBgn0052354	158	135	120	138	278	273	TRUE	TRUE	TRUE	1	TRUE	TRUE	1	1
FBgn0052364	36	46	31	38	67	84	TRUE	TRUE	TRUE	1	TRUE	TRUE	1	1
FBgn0052365	223	226	182	157	405	383	TRUE	TRUE	TRUE	1	TRUE	TRUE	1	1
FBgn0052368	60	64	45	59	105	123	TRUE	TRUE	TRUE	1	TRUE	TRUE	1	1
FBgn0052369	365	364	301	295	666	659	TRUE	TRUE	TRUE	1	TRUE	TRUE	1	1
FBgn0052371	57	88	56	54	113	142	FALSE	TRUE	FALSE	0	FALSE	TRUE	0	0
FBgn0052373	313	303	225	224	538	527	TRUE	TRUE	TRUE	1	TRUE	TRUE	1	1
FBgn0052374	79	66	77	48	156	114	TRUE	FALSE	FALSE	0	TRUE	FALSE	0	0
FBgn0052376	34	18	21	33	55	51	FALSE	TRUE	TRUE	0	FALSE	FALSE	0	0
FBgn0052379	126	110	121	136	247	246	TRUE	TRUE	TRUE	1	TRUE	TRUE	1	1
FBgn0052380	139	161	130	133	269	294	TRUE	TRUE	TRUE	1	TRUE	TRUE	1	1
FBgn0052382	118	95	98	89	216	184	TRUE	TRUE	TRUE	1	TRUE	TRUE	1	1
FBgn0052383	87	83	69	54	156	137	TRUE	TRUE	TRUE	1	TRUE	TRUE	1	1
FBgn0052392	152	171	162	133	314	304	TRUE	TRUE	TRUE	1	TRUE	TRUE	1	1
FBgn0052396	96	84	87	75	183	159	TRUE	TRUE	TRUE	1	TRUE	TRUE	1	1
FBgn0052404	55	59	52	66	107	125	TRUE	TRUE	TRUE	1	TRUE	TRUE	1	1
FBgn0052405	91	94	99	87	190	181	TRUE	TRUE	TRUE	1	TRUE	TRUE	1	1
FBgn0052406	312	300	257	234	569	534	TRUE	TRUE	TRUE	1	TRUE	TRUE	1	1
FBgn0052407	114	121	112	94	226	215	TRUE	TRUE	TRUE	1	TRUE	TRUE	1	1
FBgn0052409	59	81	60	43	119	124	FALSE	TRUE	TRUE	0	TRUE	TRUE	1	0
FBgn0052412	68	76	67	58	135	134	TRUE	TRUE	TRUE	1	TRUE	TRUE	1	1
FBgn0052413	140	123	96	98	236	221	TRUE	TRUE	TRUE	1	TRUE	TRUE	1	1
FBgn0052423	658	670	585	611	1243	1281	TRUE	TRUE	TRUE	1	TRUE	TRUE	1	1
FBgn0052425	93	71	69	56	162	127	TRUE	TRUE	FALSE	0	TRUE	TRUE	1	0
FBgn0052428	42	39	34	41	76	80	TRUE	TRUE	TRUE	1	TRUE	TRUE	1	1
FBgn0052432	244	236	188	193	432	429	TRUE	TRUE	TRUE	1	TRUE	TRUE	1	1
FBgn0052436	47	66	53	55	100	121	FALSE	TRUE	TRUE	0	TRUE	TRUE	1	0
FBgn0052437	123	115	82	89	205	204	TRUE	TRUE	TRUE	1	TRUE	TRUE	1	1
FBgn0052438	113	110	84	86	197	196	TRUE	TRUE	TRUE	1	TRUE	TRUE	1	1
FBgn0052440	49	44	44	49	93	93	TRUE	TRUE	TRUE	1	TRUE	TRUE	1	1
FBgn0052441	53	47	34	39	87	86	TRUE	TRUE	TRUE	1	TRUE	TRUE	1	1
FBgn0052445	28	23	19	23	47	46	TRUE	TRUE	TRUE	1	TRUE	TRUE	1	1
FBgn0052446	31	22	26	21	57	43	TRUE	TRUE	TRUE	1	TRUE	TRUE	1	1
FBgn0052447	89	67	62	55	151	122	FALSE	TRUE	FALSE	0	TRUE	TRUE	1	0
FBgn0052449	22	25	29	19	51	44	TRUE	TRUE	TRUE	1	TRUE	FALSE	0	0
FBgn0052451	189	194	136	158	325	352	TRUE	TRUE	TRUE	1	TRUE	TRUE	1	1
FBgn0052452	61	53	65	56	126	109	TRUE	TRUE	TRUE	1	TRUE	TRUE	1	1
FBgn0052453	45	35	23	32	68	67	TRUE	TRUE	TRUE	1	TRUE	TRUE	1	1
FBgn0052457	73	74	71	63	144	137	TRUE	TRUE	TRUE	1	TRUE	TRUE	1	1
FBgn0052459	44	47	52	51	96	98	TRUE	TRUE	TRUE	1	TRUE	TRUE	1	1
FBgn0052460	37	36	33	26	70	62	TRUE	TRUE	TRUE	1	TRUE	TRUE	1	1
FBgn0052461	32	32	22	23	54	55	TRUE	TRUE	TRUE	1	TRUE	TRUE	1	1
FBgn0052463	91	60	60	69	151	129	FALSE	TRUE	TRUE	0	FALSE	TRUE	0	0
FBgn0052473	306	302	258	262	564	564	TRUE	TRUE	TRUE	1	TRUE	TRUE	1	1
FBgn0052475	174	139	164	100	338	239	FALSE	FALSE	FALSE	0	TRUE	FALSE	0	0
FBgn0052476	35	41	26	31	61	72	TRUE	TRUE	TRUE	1	TRUE	TRUE	1	1
FBgn0052479	703	686	541	585	1244	1271	TRUE	TRUE	TRUE	1	TRUE	TRUE	1	1
FBgn0052480	27	25	17	22	44	47	TRUE	TRUE	TRUE	1	TRUE	TRUE	1	1
FBgn0052481	29	31	21	16	50	47	TRUE	TRUE	TRUE	1	TRUE	TRUE	1	1
FBgn0052482	28	29	27	21	55	50	TRUE	TRUE	TRUE	1	TRUE	TRUE	1	1
FBgn0052483	145	153	123	126	268	279	TRUE	TRUE	TRUE	1	TRUE	TRUE	1	1
FBgn0052484	77	75	48	79	125	154	TRUE	FALSE	FALSE	0	TRUE	FALSE	0	0
FBgn0052485	114	94	80	82	194	176	TRUE	TRUE	TRUE	1	TRUE	TRUE	1	1
FBgn0052487	74	81	56	66	130	147	TRUE	TRUE	TRUE	1	TRUE	TRUE	1	1
FBgn0052488	102	113	95	85	197	198	TRUE	TRUE	TRUE	1	TRUE	TRUE	1	1
FBgn0052829	54	79	52	48	106	127	FALSE	TRUE	TRUE	0	TRUE	TRUE	1	0
FBgn0052831	56	50	49	38	105	88	TRUE	TRUE	TRUE	1	TRUE	TRUE	1	1
FBgn0052832	34	46	38	31	72	77	TRUE	TRUE	TRUE	1	TRUE	TRUE	1	1
FBgn0052833	48	54	38	43	86	97	TRUE	TRUE	TRUE	1	TRUE	TRUE	1	1
FBgn0052834	112	108	94	103	206	211	TRUE	TRUE	TRUE	1	TRUE	TRUE	1	1
FBgn0052835	121	128	99	82	220	210	TRUE	TRUE	TRUE	1	TRUE	TRUE	1	1
FBgn0052843	350	323	268	295	618	618	TRUE	TRUE	TRUE	1	TRUE	TRUE	1	1
FBgn0052846	146	161	137	119	283	280	TRUE	TRUE	TRUE	1	TRUE	TRUE	1	1
FBgn0052847	68	40	43	30	111	70	FALSE	TRUE	FALSE	0	FALSE	TRUE	0	0
FBgn0052850	36	32	27	21	63	53	TRUE	TRUE	TRUE	1	TRUE	TRUE	1	1
FBgn0052855	103	131	85	118	188	249	FALSE	FALSE	FALSE	0	TRUE	TRUE	1	0
FBgn0052856	48	50	38	33	86	83	TRUE	TRUE	TRUE	1	TRUE	TRUE	1	1
FBgn0052865	74	23	72	10	146	33	FALSE	FALSE	FALSE	0	FALSE	FALSE	0	0
FBgn0052944	39	47	28	41	67	88	TRUE	TRUE	TRUE	1	TRUE	TRUE	1	1
FBgn0052971	112	101	89	76	201	177	TRUE	TRUE	TRUE	1	TRUE	TRUE	1	1
FBgn0052982	419	431	359	326	778	757	TRUE	TRUE	TRUE	1	TRUE	TRUE	1	1
FBgn0052984	132	112	95	118	227	230	TRUE	TRUE	TRUE	1	TRUE	TRUE	1	1
FBgn0052985	199	180	131	156	330	336	TRUE	TRUE	TRUE	1	TRUE	TRUE	1	1
FBgn0053002	102	107	81	106	183	213	TRUE	FALSE	TRUE	0	TRUE	TRUE	1	0
FBgn0053003	164	183	132	122	296	305	TRUE	TRUE	TRUE	1	TRUE	TRUE	1	1
FBgn0053012	204	190	184	195	388	385	TRUE	TRUE	TRUE	1	TRUE	TRUE	1	1
FBgn0053013	242	260	214	198	456	458	TRUE	TRUE	TRUE	1	TRUE	TRUE	1	1
FBgn0053017	418	465	388	360	806	825	TRUE	TRUE	TRUE	1	TRUE	TRUE	1	1
FBgn0053051	66	67	72	49	138	116	TRUE	FALSE	TRUE	0	TRUE	TRUE	1	0
FBgn0053052	87	73	64	66	151	139	TRUE	TRUE	TRUE	1	TRUE	TRUE	1	1
FBgn0053060	47	39	37	48	84	87	TRUE	TRUE	TRUE	1	TRUE	TRUE	1	1
FBgn0053061	142	111	93	101	235	212	FALSE	TRUE	TRUE	0	TRUE	TRUE	1	0
FBgn0053062	91	68	59	70	150	138	FALSE	TRUE	TRUE	0	TRUE	TRUE	1	0
FBgn0053087	699	731	604	569	1303	1300	TRUE	TRUE	TRUE	1	TRUE	TRUE	1	1
FBgn0053093	80	88	92	93	172	181	TRUE	TRUE	TRUE	1	TRUE	TRUE	1	1
FBgn0053094	154	135	134	139	288	274	TRUE	TRUE	TRUE	1	TRUE	TRUE	1	1
FBgn0053098	93	88	74	68	167	156	TRUE	TRUE	TRUE	1	TRUE	TRUE	1	1
FBgn0053099	151	138	106	112	257	250	TRUE	TRUE	TRUE	1	TRUE	TRUE	1	1
FBgn0053100	318	324	271	264	589	588	TRUE	TRUE	TRUE	1	TRUE	TRUE	1	1
FBgn0053107	108	114	95	79	203	193	TRUE	TRUE	TRUE	1	TRUE	TRUE	1	1
FBgn0053109	138	126	118	111	256	237	TRUE	TRUE	TRUE	1	TRUE	TRUE	1	1
FBgn0053110	198	181	137	158	335	339	TRUE	TRUE	TRUE	1	TRUE	TRUE	1	1
FBgn0053111	224	205	159	162	383	367	TRUE	TRUE	TRUE	1	TRUE	TRUE	1	1
FBgn0053113	416	394	366	321	782	715	TRUE	FALSE	FALSE	0	TRUE	TRUE	1	0
FBgn0053116	119	119	87	122	206	241	TRUE	FALSE	TRUE	0	TRUE	TRUE	1	0
FBgn0053117	57	57	42	40	99	97	TRUE	TRUE	TRUE	1	TRUE	TRUE	1	1
FBgn0053120	102	124	95	93	197	217	TRUE	TRUE	TRUE	1	TRUE	TRUE	1	1
FBgn0053121	130	151	109	126	239	277	TRUE	TRUE	TRUE	1	TRUE	TRUE	1	1
FBgn0053124	228	268	189	212	417	480	FALSE	TRUE	FALSE	0	TRUE	TRUE	1	0
FBgn0053125	368	367	318	327	686	694	TRUE	TRUE	TRUE	1	TRUE	TRUE	1	1
FBgn0053126	148	145	130	136	278	281	TRUE	TRUE	TRUE	1	TRUE	TRUE	1	1
FBgn0053127	32	33	30	41	62	74	TRUE	TRUE	TRUE	1	TRUE	TRUE	1	1
FBgn0053128	104	105	92	98	196	203	TRUE	TRUE	TRUE	1	TRUE	TRUE	1	1
FBgn0053129	334	286	278	248	612	534	FALSE	TRUE	FALSE	0	TRUE	TRUE	1	0
FBgn0053136	149	159	123	99	272	258	TRUE	TRUE	TRUE	1	TRUE	TRUE	1	1
FBgn0053137	61	59	65	47	126	106	TRUE	TRUE	TRUE	1	TRUE	TRUE	1	1
FBgn0053138	187	220	179	190	366	410	TRUE	TRUE	TRUE	1	TRUE	TRUE	1	1
FBgn0053140	52	46	28	29	80	75	TRUE	TRUE	TRUE	1	TRUE	TRUE	1	1
FBgn0053143	468	495	420	428	888	923	TRUE	TRUE	TRUE	1	TRUE	TRUE	1	1
FBgn0053144	322	367	274	275	596	642	FALSE	TRUE	TRUE	0	TRUE	TRUE	1	0
FBgn0053145	119	132	111	102	230	234	TRUE	TRUE	TRUE	1	TRUE	TRUE	1	1
FBgn0053147	404	484	339	385	743	869	FALSE	FALSE	FALSE	0	TRUE	TRUE	1	0
FBgn0053156	330	343	274	273	604	616	TRUE	TRUE	TRUE	1	TRUE	TRUE	1	1
FBgn0053158	305	316	256	275	561	591	TRUE	TRUE	TRUE	1	TRUE	TRUE	1	1
FBgn0053159	56	46	40	48	96	94	TRUE	TRUE	TRUE	1	TRUE	TRUE	1	1
FBgn0053160	83	72	70	68	153	140	TRUE	TRUE	TRUE	1	TRUE	TRUE	1	1
FBgn0053170	23	26	31	29	54	55	TRUE	TRUE	TRUE	1	TRUE	TRUE	1	1
FBgn0053179	186	191	153	165	339	356	TRUE	TRUE	TRUE	1	TRUE	TRUE	1	1
FBgn0053182	91	56	76	72	167	128	FALSE	TRUE	FALSE	0	FALSE	TRUE	0	0
FBgn0053189	60	51	51	48	111	99	TRUE	TRUE	TRUE	1	TRUE	TRUE	1	1
FBgn0053192	20	21	20	23	40	44	TRUE	TRUE	TRUE	1	TRUE	TRUE	1	1
FBgn0053193	178	183	132	117	310	300	TRUE	TRUE	TRUE	1	TRUE	TRUE	1	1
FBgn0053194	61	52	52	64	113	116	TRUE	TRUE	TRUE	1	TRUE	TRUE	1	1
FBgn0053196	4695	4732	3701	3892	8396	8624	TRUE	FALSE	FALSE	0	TRUE	TRUE	1	0
FBgn0053198	59	49	62	51	121	100	TRUE	TRUE	TRUE	1	TRUE	TRUE	1	1
FBgn0053199	43	32	14	31	57	63	TRUE	FALSE	TRUE	0	TRUE	FALSE	0	0
FBgn0053200	29	31	19	28	48	59	TRUE	TRUE	TRUE	1	TRUE	TRUE	1	1
FBgn0053202	239	265	219	217	458	482	TRUE	TRUE	TRUE	1	TRUE	TRUE	1	1
FBgn0053203	237	267	217	228	454	495	TRUE	TRUE	TRUE	1	TRUE	TRUE	1	1
FBgn0053207	204	188	188	197	392	385	TRUE	TRUE	TRUE	1	TRUE	TRUE	1	1
FBgn0053208	176	151	126	126	302	277	TRUE	TRUE	TRUE	1	TRUE	TRUE	1	1
FBgn0053213	87	77	73	66	160	143	TRUE	TRUE	TRUE	1	TRUE	TRUE	1	1
FBgn0053217	105	107	63	75	168	182	TRUE	TRUE	TRUE	1	TRUE	TRUE	1	1
FBgn0053225	103	114	68	92	171	206	TRUE	FALSE	FALSE	0	TRUE	TRUE	1	0
FBgn0053230	150	146	125	117	275	263	TRUE	TRUE	TRUE	1	TRUE	TRUE	1	1
FBgn0053233	162	159	164	126	326	285	TRUE	FALSE	TRUE	0	TRUE	TRUE	1	0
FBgn0053234	111	121	89	87	200	208	TRUE	TRUE	TRUE	1	TRUE	TRUE	1	1
FBgn0053257	50	53	30	53	80	106	TRUE	FALSE	FALSE	0	TRUE	FALSE	0	0
FBgn0053258	152	118	93	128	245	246	FALSE	FALSE	TRUE	0	TRUE	TRUE	1	0
FBgn0053260	60	41	63	51	123	92	FALSE	TRUE	FALSE	0	TRUE	TRUE	1	0
FBgn0053262	94	88	78	73	172	161	TRUE	TRUE	TRUE	1	TRUE	TRUE	1	1
FBgn0053263	114	108	91	85	205	193	TRUE	TRUE	TRUE	1	TRUE	TRUE	1	1
FBgn0053265	96	169	94	164	190	333	FALSE	FALSE	FALSE	0	FALSE	FALSE	0	0
FBgn0053267	35	41	37	41	72	82	TRUE	TRUE	TRUE	1	TRUE	TRUE	1	1
FBgn0053269	62	43	49	35	111	78	FALSE	TRUE	FALSE	0	TRUE	TRUE	1	0
FBgn0053270	35	48	50	35	85	83	TRUE	TRUE	TRUE	1	TRUE	TRUE	1	1
FBgn0053271	55	47	42	43	97	90	TRUE	TRUE	TRUE	1	TRUE	TRUE	1	1
FBgn0053272	36	24	23	32	59	56	TRUE	TRUE	TRUE	1	TRUE	TRUE	1	1
FBgn0053276	60	66	64	42	124	108	TRUE	FALSE	TRUE	0	TRUE	FALSE	0	0
FBgn0053278	106	85	103	77	209	162	TRUE	FALSE	FALSE	0	TRUE	TRUE	1	0
FBgn0053281	100	99	62	61	162	160	TRUE	TRUE	TRUE	1	TRUE	TRUE	1	1
FBgn0053282	174	152	137	132	311	284	TRUE	TRUE	TRUE	1	TRUE	TRUE	1	1
FBgn0053283	56	68	41	51	97	119	TRUE	TRUE	TRUE	1	TRUE	TRUE	1	1
FBgn0053284	24	27	23	36	47	63	TRUE	TRUE	TRUE	1	TRUE	FALSE	0	0
FBgn0053285	22	18	14	26	36	44	TRUE	FALSE	TRUE	0	TRUE	FALSE	0	0
FBgn0053286	118	128	117	108	235	236	TRUE	TRUE	TRUE	1	TRUE	TRUE	1	1
FBgn0053287	57	67	51	68	108	135	TRUE	TRUE	FALSE	0	TRUE	TRUE	1	0
FBgn0053288	109	111	85	101	194	212	TRUE	TRUE	TRUE	1	TRUE	TRUE	1	1
FBgn0053289	57	66	54	51	111	117	TRUE	TRUE	TRUE	1	TRUE	TRUE	1	1
FBgn0053290	49	45	33	42	82	87	TRUE	TRUE	TRUE	1	TRUE	TRUE	1	1
FBgn0053293	35	31	26	31	61	62	TRUE	TRUE	TRUE	1	TRUE	TRUE	1	1
FBgn0053294	88	101	66	70	154	171	TRUE	TRUE	TRUE	1	TRUE	TRUE	1	1
FBgn0053296	459	232	339	188	798	420	FALSE	FALSE	FALSE	0	FALSE	FALSE	0	0
FBgn0053299	78	94	72	73	150	167	TRUE	TRUE	TRUE	1	TRUE	TRUE	1	1
FBgn0053300	93	76	85	67	178	143	TRUE	TRUE	FALSE	0	TRUE	TRUE	1	0
FBgn0053301	137	164	121	114	258	278	TRUE	TRUE	TRUE	1	TRUE	TRUE	1	1
FBgn0053302	139	141	111	116	250	257	TRUE	TRUE	TRUE	1	TRUE	TRUE	1	1
FBgn0053303	163	169	140	145	303	314	TRUE	TRUE	TRUE	1	TRUE	TRUE	1	1
FBgn0053306	86	99	58	94	144	193	TRUE	FALSE	FALSE	0	TRUE	FALSE	0	0
FBgn0053307	141	119	122	95	263	214	TRUE	FALSE	FALSE	0	TRUE	TRUE	1	0
FBgn0053309	63	63	52	63	115	126	TRUE	TRUE	TRUE	1	TRUE	TRUE	1	1
FBgn0053310	197	180	177	155	374	335	TRUE	TRUE	TRUE	1	TRUE	TRUE	1	1
FBgn0053315	25	24	43	20	68	44	TRUE	FALSE	FALSE	0	TRUE	FALSE	0	0
FBgn0053317	16	17	24	18	40	35	TRUE	TRUE	TRUE	1	TRUE	TRUE	1	1
FBgn0053318	50	54	47	48	97	102	TRUE	TRUE	TRUE	1	TRUE	TRUE	1	1
FBgn0053322	91	103	110	79	201	182	TRUE	FALSE	TRUE	0	TRUE	TRUE	1	0
FBgn0053325	28	25	32	26	60	51	TRUE	TRUE	TRUE	1	TRUE	TRUE	1	1
FBgn0053329	52	58	53	54	105	112	TRUE	TRUE	TRUE	1	TRUE	TRUE	1	1
FBgn0053337	28	30	19	20	47	50	TRUE	TRUE	TRUE	1	TRUE	TRUE	1	1
FBgn0053339	103	96	99	87	202	183	TRUE	TRUE	TRUE	1	TRUE	TRUE	1	1
FBgn0053340	35	24	28	29	63	53	TRUE	TRUE	TRUE	1	TRUE	TRUE	1	1
FBgn0053341	87	83	66	93	153	176	TRUE	FALSE	TRUE	0	TRUE	TRUE	1	0
FBgn0053346	90	84	63	67	153	151	TRUE	TRUE	TRUE	1	TRUE	TRUE	1	1
FBgn0053348	33	33	26	40	59	73	TRUE	TRUE	TRUE	1	TRUE	FALSE	0	0
FBgn0053349	64	66	47	38	111	104	TRUE	TRUE	TRUE	1	TRUE	TRUE	1	1
FBgn0053440	71	82	57	64	128	146	TRUE	TRUE	TRUE	1	TRUE	TRUE	1	1
FBgn0053453	101	78	56	62	157	140	FALSE	TRUE	TRUE	0	TRUE	TRUE	1	0
FBgn0053454	57	46	37	32	94	78	TRUE	TRUE	TRUE	1	TRUE	TRUE	1	1
FBgn0053458	111	150	100	105	211	255	FALSE	TRUE	FALSE	0	TRUE	TRUE	1	0
FBgn0053459	107	128	133	99	240	227	TRUE	FALSE	TRUE	0	TRUE	TRUE	1	0
FBgn0053460	65	71	44	76	109	147	TRUE	FALSE	FALSE	0	TRUE	FALSE	0	0
FBgn0053461	77	93	55	54	132	147	TRUE	TRUE	TRUE	1	TRUE	TRUE	1	1
FBgn0053462	72	67	57	44	129	111	TRUE	TRUE	TRUE	1	TRUE	TRUE	1	1
FBgn0053463	34	23	30	26	64	49	TRUE	TRUE	TRUE	1	TRUE	TRUE	1	1
FBgn0053465	221	204	164	178	385	382	TRUE	TRUE	TRUE	1	TRUE	TRUE	1	1
FBgn0053467	76	88	66	69	142	157	TRUE	TRUE	TRUE	1	TRUE	TRUE	1	1
FBgn0053468	30	36	31	43	61	79	TRUE	TRUE	TRUE	1	TRUE	TRUE	1	1
FBgn0053471	78	83	88	70	166	153	TRUE	TRUE	TRUE	1	TRUE	TRUE	1	1
FBgn0053474	38	32	29	34	67	66	TRUE	TRUE	TRUE	1	TRUE	TRUE	1	1
FBgn0053475	45	36	45	31	90	67	TRUE	TRUE	FALSE	0	TRUE	TRUE	1	0
FBgn0053476	59	53	34	47	93	100	TRUE	TRUE	TRUE	1	TRUE	TRUE	1	1
FBgn0053477	59	46	46	36	105	82	TRUE	TRUE	TRUE	1	TRUE	TRUE	1	1
FBgn0053483	104	122	94	95	198	217	TRUE	TRUE	TRUE	1	TRUE	TRUE	1	1
FBgn0053489	146	152	131	128	277	280	TRUE	TRUE	TRUE	1	TRUE	TRUE	1	1
FBgn0053490	126	137	111	140	237	277	TRUE	FALSE	FALSE	0	TRUE	TRUE	1	0
FBgn0053493	35	40	28	26	63	66	TRUE	TRUE	TRUE	1	TRUE	TRUE	1	1
FBgn0053494	118	130	105	91	223	221	TRUE	TRUE	TRUE	1	TRUE	TRUE	1	1
FBgn0053500	25	23	20	20	45	43	TRUE	TRUE	TRUE	1	TRUE	TRUE	1	1
FBgn0053504	29	26	32	18	61	44	TRUE	FALSE	TRUE	0	TRUE	FALSE	0	0
FBgn0053505	161	179	137	147	298	326	TRUE	TRUE	TRUE	1	TRUE	TRUE	1	1
FBgn0053506	77	78	88	77	165	155	TRUE	TRUE	TRUE	1	TRUE	TRUE	1	1
FBgn0053508	121	95	85	80	206	175	FALSE	TRUE	TRUE	0	TRUE	TRUE	1	0
FBgn0053509	107	120	89	66	196	186	TRUE	FALSE	TRUE	0	TRUE	TRUE	1	0
FBgn0053510	103	97	95	88	198	185	TRUE	TRUE	TRUE	1	TRUE	TRUE	1	1
FBgn0053511	64	79	67	74	131	153	TRUE	TRUE	TRUE	1	TRUE	TRUE	1	1
FBgn0053512	144	147	134	144	278	291	TRUE	TRUE	TRUE	1	TRUE	TRUE	1	1
FBgn0053514	46	65	45	62	91	127	FALSE	TRUE	FALSE	0	TRUE	TRUE	1	0
FBgn0053516	276	273	255	237	531	510	TRUE	TRUE	TRUE	1	TRUE	TRUE	1	1
FBgn0053519	1200	1168	934	1013	2134	2181	TRUE	FALSE	TRUE	0	TRUE	TRUE	1	0
FBgn0053523	282	325	267	279	549	604	FALSE	TRUE	TRUE	0	TRUE	TRUE	1	0
FBgn0053526	311	325	270	272	581	597	TRUE	TRUE	TRUE	1	TRUE	TRUE	1	1
FBgn0053527	17	14	15	23	32	37	TRUE	TRUE	TRUE	1	TRUE	FALSE	0	0
FBgn0053530	50	46	54	41	104	87	TRUE	TRUE	TRUE	1	TRUE	TRUE	1	1
FBgn0053531	564	573	447	466	1011	1039	TRUE	TRUE	TRUE	1	TRUE	TRUE	1	1
FBgn0053533	43	39	37	29	80	68	TRUE	TRUE	TRUE	1	TRUE	TRUE	1	1
FBgn0053534	40	35	17	24	57	59	TRUE	TRUE	TRUE	1	TRUE	TRUE	1	1
FBgn0053535	11	27	22	15	33	42	FALSE	TRUE	TRUE	0	FALSE	TRUE	0	0
FBgn0053536	19	17	16	21	35	38	TRUE	TRUE	TRUE	1	TRUE	TRUE	1	1
FBgn0053537	29	14	16	18	45	32	FALSE	TRUE	TRUE	0	FALSE	TRUE	0	0
FBgn0053538	17	27	22	19	39	46	TRUE	TRUE	TRUE	1	FALSE	TRUE	0	0
FBgn0053543	135	134	119	130	254	264	TRUE	TRUE	TRUE	1	TRUE	TRUE	1	1
FBgn0053544	75	68	71	55	146	123	TRUE	TRUE	TRUE	1	TRUE	TRUE	1	1
FBgn0053547	991	996	805	845	1796	1841	TRUE	TRUE	TRUE	1	TRUE	TRUE	1	1
FBgn0053552	37	38	22	28	59	66	TRUE	TRUE	TRUE	1	TRUE	TRUE	1	1
FBgn0053554	605	583	491	526	1096	1109	TRUE	TRUE	TRUE	1	TRUE	TRUE	1	1
FBgn0053556	342	322	263	244	605	566	TRUE	TRUE	TRUE	1	TRUE	TRUE	1	1
FBgn0053558	229	238	201	170	430	408	TRUE	TRUE	TRUE	1	TRUE	TRUE	1	1
FBgn0053626	52	54	51	36	103	90	TRUE	TRUE	TRUE	1	TRUE	TRUE	1	1
FBgn0053627	86	57	57	37	143	94	FALSE	FALSE	FALSE	0	FALSE	FALSE	0	0
FBgn0053629	28	20	19	20	47	40	TRUE	TRUE	TRUE	1	TRUE	TRUE	1	1
FBgn0053630	62	48	43	53	105	101	TRUE	TRUE	TRUE	1	TRUE	TRUE	1	1
FBgn0053631	22	10	16	19	38	29	FALSE	TRUE	TRUE	0	FALSE	TRUE	0	0
FBgn0053640	80	90	81	81	161	171	TRUE	TRUE	TRUE	1	TRUE	TRUE	1	1
FBgn0053641	89	92	73	73	162	165	TRUE	TRUE	TRUE	1	TRUE	TRUE	1	1
FBgn0053642	88	123	84	80	172	203	FALSE	TRUE	TRUE	0	TRUE	TRUE	1	0
FBgn0053643	57	45	48	59	105	104	TRUE	TRUE	TRUE	1	TRUE	TRUE	1	1
FBgn0053644	56	57	45	47	101	104	TRUE	TRUE	TRUE	1	TRUE	TRUE	1	1
FBgn0053645	48	48	28	37	76	85	TRUE	TRUE	TRUE	1	TRUE	TRUE	1	1
FBgn0053647	59	73	66	68	125	141	TRUE	TRUE	TRUE	1	TRUE	TRUE	1	1
FBgn0053648	91	90	61	68	152	158	TRUE	TRUE	TRUE	1	TRUE	TRUE	1	1
FBgn0053653	195	200	179	137	374	337	TRUE	FALSE	TRUE	0	TRUE	TRUE	1	0
FBgn0053654	58	46	59	39	117	85	TRUE	FALSE	FALSE	0	TRUE	FALSE	0	0
FBgn0053658	68	71	49	52	117	123	TRUE	TRUE	TRUE	1	TRUE	TRUE	1	1
FBgn0053673	70	80	62	78	132	158	TRUE	TRUE	TRUE	1	TRUE	TRUE	1	1
FBgn0053679	49	23	26	14	75	37	FALSE	FALSE	FALSE	0	FALSE	FALSE	0	0
FBgn0053680	71	81	65	69	136	150	TRUE	TRUE	TRUE	1	TRUE	TRUE	1	1
FBgn0053687	97	103	76	76	173	179	TRUE	TRUE	TRUE	1	TRUE	TRUE	1	1
FBgn0053688	62	62	66	57	128	119	TRUE	TRUE	TRUE	1	TRUE	TRUE	1	1
FBgn0053689	57	53	42	58	99	111	TRUE	TRUE	TRUE	1	TRUE	TRUE	1	1
FBgn0053690	43	47	38	37	81	84	TRUE	TRUE	TRUE	1	TRUE	TRUE	1	1
FBgn0053696	286	281	253	269	539	550	TRUE	TRUE	TRUE	1	TRUE	TRUE	1	1
FBgn0053700	154	179	137	133	291	312	TRUE	TRUE	TRUE	1	TRUE	TRUE	1	1
FBgn0053701	49	62	37	43	86	105	TRUE	TRUE	TRUE	1	TRUE	TRUE	1	1
FBgn0053702	66	68	44	73	110	141	TRUE	FALSE	FALSE	0	TRUE	FALSE	0	0
FBgn0053703	40	33	38	26	78	59	TRUE	TRUE	TRUE	1	TRUE	TRUE	1	1
FBgn0053704	73	82	90	61	163	143	TRUE	FALSE	TRUE	0	TRUE	TRUE	1	0
FBgn0053710	47	56	48	52	95	108	TRUE	TRUE	TRUE	1	TRUE	TRUE	1	1
FBgn0053721	95	112	78	85	173	197	TRUE	TRUE	TRUE	1	TRUE	TRUE	1	1
FBgn0053723	66	64	48	48	114	112	TRUE	TRUE	TRUE	1	TRUE	TRUE	1	1
FBgn0053725	123	87	122	91	245	178	FALSE	FALSE	FALSE	0	TRUE	TRUE	1	0
FBgn0053752	64	80	60	72	124	152	TRUE	TRUE	TRUE	1	TRUE	TRUE	1	1
FBgn0053757	53	65	43	65	96	130	TRUE	FALSE	FALSE	0	TRUE	FALSE	0	0
FBgn0053758	73	69	49	42	122	111	TRUE	TRUE	TRUE	1	TRUE	TRUE	1	1
FBgn0053764	39	45	51	50	90	95	TRUE	TRUE	TRUE	1	TRUE	TRUE	1	1
FBgn0053768	28	43	36	43	64	86	FALSE	TRUE	FALSE	0	FALSE	TRUE	0	0
FBgn0053770	27	18	16	16	43	34	TRUE	TRUE	TRUE	1	TRUE	TRUE	1	1
FBgn0053771	42	46	23	35	65	81	TRUE	TRUE	TRUE	1	TRUE	FALSE	0	0
FBgn0053772	56	38	48	31	104	69	FALSE	FALSE	FALSE	0	TRUE	FALSE	0	0
FBgn0053773	65	70	62	57	127	127	TRUE	TRUE	TRUE	1	TRUE	TRUE	1	1
FBgn0053775	31	33	27	21	58	54	TRUE	TRUE	TRUE	1	TRUE	TRUE	1	1
FBgn0053777	61	63	62	77	123	140	TRUE	TRUE	TRUE	1	TRUE	TRUE	1	1
FBgn0053792	77	93	88	93	165	186	TRUE	TRUE	TRUE	1	TRUE	TRUE	1	1
FBgn0053796	23	13	14	19	37	32	TRUE	TRUE	TRUE	1	FALSE	TRUE	0	0
FBgn0053798	64	84	72	59	136	143	TRUE	TRUE	TRUE	1	TRUE	TRUE	1	1
FBgn0053804	207	121	222	159	429	280	FALSE	FALSE	FALSE	0	FALSE	TRUE	0	0
FBgn0053912	53	61	43	39	96	100	TRUE	TRUE	TRUE	1	TRUE	TRUE	1	1
FBgn0053914	139	170	93	124	232	294	FALSE	FALSE	FALSE	0	TRUE	TRUE	1	0
FBgn0053919	43	35	52	49	95	84	TRUE	TRUE	TRUE	1	TRUE	TRUE	1	1
FBgn0053920	77	89	55	71	132	160	TRUE	TRUE	TRUE	1	TRUE	TRUE	1	1
FBgn0053922	80	97	93	69	173	166	TRUE	FALSE	TRUE	0	TRUE	TRUE	1	0
FBgn0053923	79	89	66	88	145	177	TRUE	FALSE	FALSE	0	TRUE	TRUE	1	0
FBgn0053926	113	110	104	101	217	211	TRUE	TRUE	TRUE	1	TRUE	TRUE	1	1
FBgn0053928	85	70	76	73	161	143	TRUE	TRUE	TRUE	1	TRUE	TRUE	1	1
FBgn0053929	81	72	67	73	148	145	TRUE	TRUE	TRUE	1	TRUE	TRUE	1	1
FBgn0053958	281	261	237	224	518	485	TRUE	TRUE	TRUE	1	TRUE	TRUE	1	1
FBgn0053965	104	91	86	77	190	168	TRUE	TRUE	TRUE	1	TRUE	TRUE	1	1
FBgn0053966	90	97	81	66	171	163	TRUE	TRUE	TRUE	1	TRUE	TRUE	1	1
FBgn0053970	328	318	288	297	616	615	TRUE	TRUE	TRUE	1	TRUE	TRUE	1	1
FBgn0053971	75	89	67	68	142	157	TRUE	TRUE	TRUE	1	TRUE	TRUE	1	1
FBgn0053978	232	238	184	200	416	438	TRUE	TRUE	TRUE	1	TRUE	TRUE	1	1
FBgn0053983	61	70	47	46	108	116	TRUE	TRUE	TRUE	1	TRUE	TRUE	1	1
FBgn0053987	19	14	22	10	41	24	TRUE	FALSE	FALSE	0	TRUE	FALSE	0	0
FBgn0053988	130	146	106	109	236	255	TRUE	TRUE	TRUE	1	TRUE	TRUE	1	1
FBgn0053993	226	279	202	194	428	473	FALSE	TRUE	TRUE	0	TRUE	TRUE	1	0
FBgn0053998	47	57	47	41	94	98	TRUE	TRUE	TRUE	1	TRUE	TRUE	1	1
FBgn0054001	44	44	32	28	76	72	TRUE	TRUE	TRUE	1	TRUE	TRUE	1	1
FBgn0054002	88	41	60	46	148	87	FALSE	TRUE	FALSE	0	FALSE	TRUE	0	0
FBgn0054003	72	55	53	65	125	120	TRUE	TRUE	TRUE	1	TRUE	TRUE	1	1
FBgn0054005	61	83	58	64	119	147	FALSE	TRUE	FALSE	0	TRUE	TRUE	1	0
FBgn0054006	121	131	107	114	228	245	TRUE	TRUE	TRUE	1	TRUE	TRUE	1	1
FBgn0054007	74	73	61	57	135	130	TRUE	TRUE	TRUE	1	TRUE	TRUE	1	1
FBgn0054008	36	62	36	44	72	106	FALSE	TRUE	FALSE	0	FALSE	TRUE	0	0
FBgn0054010	99	112	79	77	178	189	TRUE	TRUE	TRUE	1	TRUE	TRUE	1	1
FBgn0054011	127	101	102	95	229	196	FALSE	TRUE	TRUE	0	TRUE	TRUE	1	0
FBgn0054012	44	47	55	51	99	98	TRUE	TRUE	TRUE	1	TRUE	TRUE	1	1
FBgn0054024	81	67	61	73	142	140	TRUE	TRUE	TRUE	1	TRUE	TRUE	1	1
FBgn0054025	107	105	93	89	200	194	TRUE	TRUE	TRUE	1	TRUE	TRUE	1	1
FBgn0054027	421	341	366	347	787	688	FALSE	TRUE	FALSE	0	TRUE	TRUE	1	0
FBgn0054029	53	49	42	55	95	104	TRUE	TRUE	TRUE	1	TRUE	TRUE	1	1
FBgn0054030	167	153	129	104	296	257	TRUE	TRUE	TRUE	1	TRUE	TRUE	1	1
FBgn0054031	41	51	46	30	87	81	TRUE	FALSE	TRUE	0	TRUE	FALSE	0	0
FBgn0054033	67	69	42	49	109	118	TRUE	TRUE	TRUE	1	TRUE	TRUE	1	1
FBgn0054034	135	90	102	97	237	187	FALSE	TRUE	FALSE	0	TRUE	TRUE	1	0
FBgn0054039	76	72	46	65	122	137	TRUE	FALSE	TRUE	0	TRUE	TRUE	1	0
FBgn0054040	110	128	98	117	208	245	TRUE	TRUE	FALSE	0	TRUE	TRUE	1	0
FBgn0054041	215	208	187	213	402	421	TRUE	TRUE	TRUE	1	TRUE	TRUE	1	1
FBgn0054043	142	179	113	124	255	303	FALSE	TRUE	FALSE	0	TRUE	TRUE	1	0
FBgn0054044	36	46	30	29	66	75	TRUE	TRUE	TRUE	1	TRUE	TRUE	1	1
FBgn0054045	105	88	64	95	169	183	TRUE	FALSE	TRUE	0	TRUE	TRUE	1	0
FBgn0054047	109	116	90	108	199	224	TRUE	TRUE	TRUE	1	TRUE	TRUE	1	1
FBgn0054049	102	114	96	92	198	206	TRUE	TRUE	TRUE	1	TRUE	TRUE	1	1
FBgn0054051	23	21	21	21	44	42	TRUE	TRUE	TRUE	1	TRUE	TRUE	1	1
FBgn0054054	92	76	71	68	163	144	TRUE	TRUE	TRUE	1	TRUE	TRUE	1	1
FBgn0054056	116	127	111	84	227	211	TRUE	FALSE	TRUE	0	TRUE	TRUE	1	0
FBgn0054057	145	161	124	101	269	262	TRUE	TRUE	TRUE	1	TRUE	TRUE	1	1
FBgn0058002	38	67	20	58	58	125	FALSE	FALSE	FALSE	0	FALSE	FALSE	0	0
FBgn0058005	24	50	36	37	60	87	FALSE	TRUE	FALSE	0	FALSE	TRUE	0	0
FBgn0058006	79	55	78	63	157	118	FALSE	TRUE	FALSE	0	TRUE	TRUE	1	0
FBgn0058068	30	26	31	14	61	40	TRUE	FALSE	FALSE	0	TRUE	FALSE	0	0
FBgn0058100	22	23	27	19	49	42	TRUE	TRUE	TRUE	1	TRUE	TRUE	1	1
FBgn0058160	138	122	110	104	248	226	TRUE	TRUE	TRUE	1	TRUE	TRUE	1	1
FBgn0058172	42	37	55	45	97	82	TRUE	TRUE	TRUE	1	TRUE	TRUE	1	1
FBgn0058178	113	110	78	80	191	190	TRUE	TRUE	TRUE	1	TRUE	TRUE	1	1
FBgn0058191	46	50	49	36	95	86	TRUE	TRUE	TRUE	1	TRUE	TRUE	1	1
FBgn0058263	105	84	87	77	192	161	TRUE	TRUE	TRUE	1	TRUE	TRUE	1	1
FBgn0058298	61	57	38	49	99	106	TRUE	TRUE	TRUE	1	TRUE	TRUE	1	1
FBgn0058354	87	68	74	62	161	130	TRUE	TRUE	FALSE	0	TRUE	TRUE	1	0
FBgn0060296	73	64	60	68	133	132	TRUE	TRUE	TRUE	1	TRUE	TRUE	1	1
FBgn0061188	74	61	42	51	116	112	TRUE	TRUE	TRUE	1	TRUE	TRUE	1	1
FBgn0061197	165	181	131	157	296	338	TRUE	TRUE	TRUE	1	TRUE	TRUE	1	1
FBgn0061198	33	34	23	15	56	49	TRUE	TRUE	TRUE	1	TRUE	FALSE	0	0
FBgn0061356	116	111	95	84	211	195	TRUE	TRUE	TRUE	1	TRUE	TRUE	1	1
FBgn0061435	55	53	57	59	112	112	TRUE	TRUE	TRUE	1	TRUE	TRUE	1	1
FBgn0061469	197	178	148	176	345	354	TRUE	TRUE	TRUE	1	TRUE	TRUE	1	1
FBgn0061476	141	152	112	136	253	288	TRUE	TRUE	TRUE	1	TRUE	TRUE	1	1
FBgn0061492	164	130	115	82	279	212	FALSE	FALSE	FALSE	0	TRUE	TRUE	1	0
FBgn0061515	37	35	37	28	74	63	TRUE	TRUE	TRUE	1	TRUE	TRUE	1	1
FBgn0062411	62	85	67	61	129	146	FALSE	TRUE	TRUE	0	TRUE	TRUE	1	0
FBgn0062412	28	44	30	23	58	67	FALSE	TRUE	TRUE	0	FALSE	TRUE	0	0
FBgn0062440	33	23	15	17	48	40	TRUE	TRUE	TRUE	1	TRUE	TRUE	1	1
FBgn0062442	53	50	30	40	83	90	TRUE	TRUE	TRUE	1	TRUE	TRUE	1	1
FBgn0062449	290	271	222	228	512	499	TRUE	TRUE	TRUE	1	TRUE	TRUE	1	1
FBgn0062928	39	38	21	21	60	59	TRUE	TRUE	TRUE	1	TRUE	TRUE	1	1
FBgn0062961	83	76	55	77	138	153	TRUE	FALSE	TRUE	0	TRUE	TRUE	1	0
FBgn0062978	49	57	49	42	98	99	TRUE	TRUE	TRUE	1	TRUE	TRUE	1	1
FBgn0063083	57	70	47	50	104	120	TRUE	TRUE	TRUE	1	TRUE	TRUE	1	1
FBgn0063127	37	38	21	30	58	68	TRUE	TRUE	TRUE	1	TRUE	TRUE	1	1
FBgn0063261	31	33	26	29	57	62	TRUE	TRUE	TRUE	1	TRUE	TRUE	1	1
FBgn0063449	20	31	25	28	45	59	TRUE	TRUE	TRUE	1	FALSE	TRUE	0	0
FBgn0063491	58	48	47	32	105	80	TRUE	TRUE	FALSE	0	TRUE	TRUE	1	0
FBgn0063492	91	107	77	81	168	188	TRUE	TRUE	TRUE	1	TRUE	TRUE	1	1
FBgn0063493	49	70	49	41	98	111	FALSE	TRUE	TRUE	0	TRUE	TRUE	1	0
FBgn0063494	35	36	28	41	63	77	TRUE	TRUE	TRUE	1	TRUE	TRUE	1	1
FBgn0063495	87	71	60	79	147	150	TRUE	TRUE	TRUE	1	TRUE	TRUE	1	1
FBgn0063496	86	77	79	76	165	153	TRUE	TRUE	TRUE	1	TRUE	TRUE	1	1
FBgn0063497	90	95	68	69	158	164	TRUE	TRUE	TRUE	1	TRUE	TRUE	1	1
FBgn0063498	95	74	68	73	163	147	TRUE	TRUE	TRUE	1	TRUE	TRUE	1	1
FBgn0063499	100	95	88	111	188	206	TRUE	TRUE	TRUE	1	TRUE	TRUE	1	1
FBgn0063649	318	328	257	277	575	605	TRUE	TRUE	TRUE	1	TRUE	TRUE	1	1
FBgn0063667	97	118	89	95	186	213	TRUE	TRUE	TRUE	1	TRUE	TRUE	1	1
FBgn0063670	46	51	47	40	93	91	TRUE	TRUE	TRUE	1	TRUE	TRUE	1	1
FBgn0064225	194	160	141	144	335	304	FALSE	TRUE	TRUE	0	TRUE	TRUE	1	0
FBgn0064237	148	139	113	116	261	255	TRUE	TRUE	TRUE	1	TRUE	TRUE	1	1
FBgn0064766	266	339	238	237	504	576	FALSE	TRUE	FALSE	0	TRUE	TRUE	1	0
FBgn0064912	72	99	73	78	145	177	FALSE	TRUE	FALSE	0	TRUE	TRUE	1	0
FBgn0065048	29	42	21	55	50	97	TRUE	FALSE	FALSE	0	TRUE	FALSE	0	0
FBgn0065098	42	29	31	31	73	60	TRUE	TRUE	TRUE	1	TRUE	TRUE	1	1
FBgn0065099	23	39	24	33	47	72	FALSE	TRUE	FALSE	0	FALSE	TRUE	0	0
FBgn0065110	226	211	159	193	385	404	TRUE	FALSE	TRUE	0	TRUE	TRUE	1	0
FBgn0066084	21	21	18	14	39	35	TRUE	TRUE	TRUE	1	TRUE	TRUE	1	1
FBgn0066101	568	580	465	478	1033	1058	TRUE	TRUE	TRUE	1	TRUE	TRUE	1	1
FBgn0066292	30	34	27	22	57	56	TRUE	TRUE	TRUE	1	TRUE	TRUE	1	1
FBgn0066293	57	62	48	41	105	103	TRUE	TRUE	TRUE	1	TRUE	TRUE	1	1
FBgn0066365	296	259	251	240	547	499	TRUE	TRUE	TRUE	1	TRUE	TRUE	1	1
FBgn0067102	165	181	156	148	321	329	TRUE	TRUE	TRUE	1	TRUE	TRUE	1	1
FBgn0067311	68	75	70	51	138	126	TRUE	TRUE	TRUE	1	TRUE	TRUE	1	1
FBgn0067312	22	27	17	36	39	63	TRUE	FALSE	FALSE	0	TRUE	FALSE	0	0
FBgn0067317	25	20	16	23	41	43	TRUE	TRUE	TRUE	1	TRUE	TRUE	1	1
FBgn0067407	29	44	37	30	66	74	TRUE	TRUE	TRUE	1	FALSE	TRUE	0	0
FBgn0067628	23	37	20	22	43	59	FALSE	TRUE	TRUE	0	FALSE	TRUE	0	0
FBgn0067629	22	22	28	14	50	36	TRUE	FALSE	TRUE	0	TRUE	FALSE	0	0
FBgn0067779	47	44	42	36	89	80	TRUE	TRUE	TRUE	1	TRUE	TRUE	1	1
FBgn0067783	89	83	97	82	186	165	TRUE	TRUE	TRUE	1	TRUE	TRUE	1	1
FBgn0067864	79	65	77	68	156	133	TRUE	TRUE	TRUE	1	TRUE	TRUE	1	1
FBgn0067905	19	32	21	27	40	59	FALSE	TRUE	FALSE	0	FALSE	TRUE	0	0
FBgn0069056	19	46	29	29	48	75	FALSE	TRUE	FALSE	0	FALSE	TRUE	0	0
FBgn0069354	99	81	78	68	177	149	TRUE	TRUE	TRUE	1	TRUE	TRUE	1	1
FBgn0069913	98	76	64	49	162	125	TRUE	TRUE	FALSE	0	TRUE	TRUE	1	0
FBgn0069923	34	22	26	27	60	49	TRUE	TRUE	TRUE	1	FALSE	TRUE	0	0
FBgn0069969	40	28	45	34	85	62	TRUE	TRUE	FALSE	0	TRUE	TRUE	1	0
FBgn0082582	656	587	496	495	1152	1082	FALSE	TRUE	TRUE	0	TRUE	TRUE	1	0
FBgn0082585	197	196	192	176	389	372	TRUE	TRUE	TRUE	1	TRUE	TRUE	1	1
FBgn0082598	135	99	107	102	242	201	FALSE	TRUE	FALSE	0	TRUE	TRUE	1	0
FBgn0082831	269	297	222	185	491	482	TRUE	FALSE	TRUE	0	TRUE	TRUE	1	0
FBgn0083039	17	17	19	27	36	44	TRUE	TRUE	TRUE	1	TRUE	TRUE	1	1
FBgn0083123	37	29	32	32	69	61	TRUE	TRUE	TRUE	1	TRUE	TRUE	1	1
FBgn0083141	120	110	82	98	202	208	TRUE	TRUE	TRUE	1	TRUE	TRUE	1	1
FBgn0083936	43	39	43	38	86	77	TRUE	TRUE	TRUE	1	TRUE	TRUE	1	1
FBgn0083938	62	52	62	52	124	104	TRUE	TRUE	TRUE	1	TRUE	TRUE	1	1
FBgn0083943	48	47	30	44	78	91	TRUE	TRUE	TRUE	1	TRUE	TRUE	1	1
FBgn0083945	436	438	365	353	801	791	TRUE	TRUE	TRUE	1	TRUE	TRUE	1	1
FBgn0083946	293	283	224	200	517	483	TRUE	TRUE	TRUE	1	TRUE	TRUE	1	1
FBgn0083949	291	275	222	216	513	491	TRUE	TRUE	TRUE	1	TRUE	TRUE	1	1
FBgn0083950	549	473	421	414	970	887	FALSE	TRUE	FALSE	0	TRUE	TRUE	1	0
FBgn0083951	98	71	61	76	159	147	FALSE	TRUE	TRUE	0	TRUE	TRUE	1	0
FBgn0083960	466	388	319	315	785	703	FALSE	TRUE	FALSE	0	TRUE	TRUE	1	0
FBgn0083961	44	46	41	37	85	83	TRUE	TRUE	TRUE	1	TRUE	TRUE	1	1
FBgn0083962	493	503	401	347	894	850	TRUE	FALSE	TRUE	0	TRUE	TRUE	1	0
FBgn0083963	273	252	224	221	497	473	TRUE	TRUE	TRUE	1	TRUE	TRUE	1	1
FBgn0083965	41	41	33	36	74	77	TRUE	TRUE	TRUE	1	TRUE	TRUE	1	1
FBgn0083966	59	77	60	59	119	136	TRUE	TRUE	TRUE	1	TRUE	TRUE	1	1
FBgn0083968	44	37	34	41	78	78	TRUE	TRUE	TRUE	1	TRUE	TRUE	1	1
FBgn0083969	253	218	196	193	449	411	TRUE	TRUE	TRUE	1	TRUE	TRUE	1	1
FBgn0083972	35	42	38	29	73	71	TRUE	TRUE	TRUE	1	TRUE	TRUE	1	1
FBgn0083973	38	40	30	42	68	82	TRUE	TRUE	TRUE	1	TRUE	TRUE	1	1
FBgn0083974	93	87	82	70	175	157	TRUE	TRUE	TRUE	1	TRUE	TRUE	1	1
FBgn0083975	467	477	419	401	886	878	TRUE	TRUE	TRUE	1	TRUE	TRUE	1	1
FBgn0083977	177	208	144	167	321	375	TRUE	TRUE	FALSE	0	TRUE	TRUE	1	0
FBgn0083978	154	136	144	109	298	245	TRUE	FALSE	FALSE	0	TRUE	TRUE	1	0
FBgn0083983	32	40	25	22	57	62	TRUE	TRUE	TRUE	1	TRUE	TRUE	1	1
FBgn0083985	75	71	53	61	128	132	TRUE	TRUE	TRUE	1	TRUE	TRUE	1	1
FBgn0083986	43	51	31	42	74	93	TRUE	TRUE	TRUE	1	TRUE	TRUE	1	1
FBgn0083990	32	26	24	15	56	41	TRUE	TRUE	TRUE	1	TRUE	FALSE	0	0
FBgn0083991	231	230	219	172	450	402	TRUE	FALSE	TRUE	0	TRUE	TRUE	1	0
FBgn0084001	100	118	88	107	188	225	TRUE	TRUE	FALSE	0	TRUE	TRUE	1	0
FBgn0084008	65	68	50	69	115	137	TRUE	FALSE	TRUE	0	TRUE	TRUE	1	0
FBgn0084049	56	39	48	41	104	80	TRUE	TRUE	FALSE	0	TRUE	TRUE	1	0
FBgn0085188	115	96	79	96	194	192	TRUE	TRUE	TRUE	1	TRUE	TRUE	1	1
FBgn0085190	77	112	100	73	177	185	FALSE	FALSE	TRUE	0	TRUE	TRUE	1	0
FBgn0085194	57	71	71	51	128	122	TRUE	FALSE	TRUE	0	TRUE	TRUE	1	0
FBgn0085195	60	50	34	29	94	79	TRUE	TRUE	TRUE	1	TRUE	TRUE	1	1
FBgn0085196	29	25	27	22	56	47	TRUE	TRUE	TRUE	1	TRUE	TRUE	1	1
FBgn0085197	27	31	30	21	57	52	TRUE	TRUE	TRUE	1	TRUE	TRUE	1	1
FBgn0085198	17	28	28	25	45	53	TRUE	TRUE	TRUE	1	FALSE	TRUE	0	0
FBgn0085199	15	19	17	17	32	36	TRUE	TRUE	TRUE	1	TRUE	TRUE	1	1
FBgn0085200	51	53	37	50	88	103	TRUE	TRUE	TRUE	1	TRUE	TRUE	1	1
FBgn0085201	46	31	34	35	80	66	TRUE	TRUE	TRUE	1	TRUE	TRUE	1	1
FBgn0085202	62	71	70	54	132	125	TRUE	TRUE	TRUE	1	TRUE	TRUE	1	1
FBgn0085203	40	34	30	23	70	57	TRUE	TRUE	TRUE	1	TRUE	TRUE	1	1
FBgn0085205	67	77	70	56	137	133	TRUE	TRUE	TRUE	1	TRUE	TRUE	1	1
FBgn0085209	20	15	13	26	33	41	TRUE	FALSE	TRUE	0	TRUE	FALSE	0	0
FBgn0085210	72	67	62	76	134	143	TRUE	TRUE	TRUE	1	TRUE	TRUE	1	1
FBgn0085211	31	27	39	14	70	41	TRUE	FALSE	FALSE	0	TRUE	FALSE	0	0
FBgn0085212	45	35	50	45	95	80	TRUE	TRUE	TRUE	1	TRUE	TRUE	1	1
FBgn0085213	88	78	72	48	160	126	TRUE	FALSE	FALSE	0	TRUE	TRUE	1	0
FBgn0085217	54	59	83	42	137	101	TRUE	FALSE	FALSE	0	TRUE	FALSE	0	0
FBgn0085218	60	47	27	27	87	74	TRUE	TRUE	TRUE	1	TRUE	TRUE	1	1
FBgn0085219	17	14	24	15	41	29	TRUE	TRUE	TRUE	1	TRUE	FALSE	0	0
FBgn0085220	42	38	32	33	74	71	TRUE	TRUE	TRUE	1	TRUE	TRUE	1	1
FBgn0085222	112	111	85	72	197	183	TRUE	TRUE	TRUE	1	TRUE	TRUE	1	1
FBgn0085223	35	48	36	36	71	84	TRUE	TRUE	TRUE	1	TRUE	TRUE	1	1
FBgn0085224	106	99	84	92	190	191	TRUE	TRUE	TRUE	1	TRUE	TRUE	1	1
FBgn0085225	71	73	43	54	114	127	TRUE	TRUE	TRUE	1	TRUE	TRUE	1	1
FBgn0085227	36	45	54	51	90	96	TRUE	TRUE	TRUE	1	TRUE	TRUE	1	1
FBgn0085228	62	76	51	57	113	133	TRUE	TRUE	TRUE	1	TRUE	TRUE	1	1
FBgn0085230	145	123	116	114	261	237	TRUE	TRUE	TRUE	1	TRUE	TRUE	1	1
FBgn0085231	107	112	91	97	198	209	TRUE	TRUE	TRUE	1	TRUE	TRUE	1	1
FBgn0085232	64	39	31	45	95	84	FALSE	TRUE	TRUE	0	FALSE	TRUE	0	0
FBgn0085233	39	41	27	37	66	78	TRUE	TRUE	TRUE	1	TRUE	TRUE	1	1
FBgn0085234	60	71	43	54	103	125	TRUE	TRUE	TRUE	1	TRUE	TRUE	1	1
FBgn0085235	91	86	86	83	177	169	TRUE	TRUE	TRUE	1	TRUE	TRUE	1	1
FBgn0085237	31	24	38	27	69	51	TRUE	TRUE	TRUE	1	TRUE	TRUE	1	1
FBgn0085239	87	94	63	64	150	158	TRUE	TRUE	TRUE	1	TRUE	TRUE	1	1
FBgn0085241	55	55	48	40	103	95	TRUE	TRUE	TRUE	1	TRUE	TRUE	1	1
FBgn0085242	59	61	61	57	120	118	TRUE	TRUE	TRUE	1	TRUE	TRUE	1	1
FBgn0085244	45	39	42	31	87	70	TRUE	TRUE	TRUE	1	TRUE	TRUE	1	1
FBgn0085245	73	54	50	55	123	109	TRUE	TRUE	TRUE	1	TRUE	TRUE	1	1
FBgn0085246	58	52	31	55	89	107	TRUE	FALSE	TRUE	0	TRUE	FALSE	0	0
FBgn0085249	125	137	99	92	224	229	TRUE	TRUE	TRUE	1	TRUE	TRUE	1	1
FBgn0085250	94	124	91	113	185	237	FALSE	TRUE	FALSE	0	TRUE	TRUE	1	0
FBgn0085253	54	55	59	45	113	100	TRUE	TRUE	TRUE	1	TRUE	TRUE	1	1
FBgn0085254	66	84	49	49	115	133	TRUE	TRUE	TRUE	1	TRUE	TRUE	1	1
FBgn0085256	34	44	38	25	72	69	TRUE	TRUE	TRUE	1	TRUE	FALSE	0	0
FBgn0085257	48	38	36	30	84	68	TRUE	TRUE	TRUE	1	TRUE	TRUE	1	1
FBgn0085259	56	71	43	65	99	136	TRUE	FALSE	FALSE	0	TRUE	FALSE	0	0
FBgn0085260	42	40	28	32	70	72	TRUE	TRUE	TRUE	1	TRUE	TRUE	1	1
FBgn0085265	87	111	106	78	193	189	TRUE	FALSE	TRUE	0	TRUE	TRUE	1	0
FBgn0085267	96	71	69	66	165	137	FALSE	TRUE	TRUE	0	TRUE	TRUE	1	0
FBgn0085271	60	40	31	50	91	90	FALSE	FALSE	TRUE	0	TRUE	FALSE	0	0
FBgn0085273	62	64	42	45	104	109	TRUE	TRUE	TRUE	1	TRUE	TRUE	1	1
FBgn0085274	56	60	53	57	109	117	TRUE	TRUE	TRUE	1	TRUE	TRUE	1	1
FBgn0085277	44	49	36	46	80	95	TRUE	TRUE	TRUE	1	TRUE	TRUE	1	1
FBgn0085279	29	35	29	24	58	59	TRUE	TRUE	TRUE	1	TRUE	TRUE	1	1
FBgn0085280	156	159	148	144	304	303	TRUE	TRUE	TRUE	1	TRUE	TRUE	1	1
FBgn0085283	111	83	74	96	185	179	FALSE	TRUE	TRUE	0	TRUE	TRUE	1	0
FBgn0085285	56	52	73	63	129	115	TRUE	TRUE	TRUE	1	TRUE	TRUE	1	1
FBgn0085287	49	64	42	53	91	117	TRUE	TRUE	FALSE	0	TRUE	TRUE	1	0
FBgn0085288	168	164	131	132	299	296	TRUE	TRUE	TRUE	1	TRUE	TRUE	1	1
FBgn0085289	54	51	38	43	92	94	TRUE	TRUE	TRUE	1	TRUE	TRUE	1	1
FBgn0085294	107	92	66	61	173	153	TRUE	TRUE	TRUE	1	TRUE	TRUE	1	1
FBgn0085295	30	18	22	25	52	43	TRUE	TRUE	TRUE	1	FALSE	TRUE	0	0
FBgn0085296	40	76	37	62	77	138	FALSE	FALSE	FALSE	0	FALSE	FALSE	0	0
FBgn0085297	30	27	28	21	58	48	TRUE	TRUE	TRUE	1	TRUE	TRUE	1	1
FBgn0085298	67	74	47	56	114	130	TRUE	TRUE	TRUE	1	TRUE	TRUE	1	1
FBgn0085300	52	65	53	39	105	104	TRUE	TRUE	TRUE	1	TRUE	TRUE	1	1
FBgn0085303	60	56	51	41	111	97	TRUE	TRUE	TRUE	1	TRUE	TRUE	1	1
FBgn0085305	68	62	50	55	118	117	TRUE	TRUE	TRUE	1	TRUE	TRUE	1	1
FBgn0085307	65	43	42	38	107	81	FALSE	TRUE	FALSE	0	FALSE	TRUE	0	0
FBgn0085308	25	24	21	15	46	39	TRUE	TRUE	TRUE	1	TRUE	TRUE	1	1
FBgn0085309	21	25	20	22	41	47	TRUE	TRUE	TRUE	1	TRUE	TRUE	1	1
FBgn0085310	43	37	37	40	80	77	TRUE	TRUE	TRUE	1	TRUE	TRUE	1	1
FBgn0085311	59	90	27	53	86	143	FALSE	FALSE	FALSE	0	FALSE	FALSE	0	0
FBgn0085312	79	77	58	58	137	135	TRUE	TRUE	TRUE	1	TRUE	TRUE	1	1
FBgn0085313	55	56	54	71	109	127	TRUE	TRUE	TRUE	1	TRUE	TRUE	1	1
FBgn0085314	216	196	171	166	387	362	TRUE	TRUE	TRUE	1	TRUE	TRUE	1	1
FBgn0085315	32	34	23	26	55	60	TRUE	TRUE	TRUE	1	TRUE	TRUE	1	1
FBgn0085316	38	34	27	20	65	54	TRUE	TRUE	TRUE	1	TRUE	TRUE	1	1
FBgn0085317	41	31	30	31	71	62	TRUE	TRUE	TRUE	1	TRUE	TRUE	1	1
FBgn0085319	83	76	60	78	143	154	TRUE	TRUE	TRUE	1	TRUE	TRUE	1	1
FBgn0085320	45	35	27	27	72	62	TRUE	TRUE	TRUE	1	TRUE	TRUE	1	1
FBgn0085321	72	68	54	49	126	117	TRUE	TRUE	TRUE	1	TRUE	TRUE	1	1
FBgn0085324	108	91	57	82	165	173	TRUE	FALSE	TRUE	0	TRUE	TRUE	1	0
FBgn0085325	43	40	36	33	79	73	TRUE	TRUE	TRUE	1	TRUE	TRUE	1	1
FBgn0085326	36	38	55	33	91	71	TRUE	FALSE	TRUE	0	TRUE	FALSE	0	0
FBgn0085327	42	48	39	34	81	82	TRUE	TRUE	TRUE	1	TRUE	TRUE	1	1
FBgn0085328	118	141	108	105	226	246	TRUE	TRUE	TRUE	1	TRUE	TRUE	1	1
FBgn0085329	49	62	38	54	87	116	TRUE	TRUE	FALSE	0	TRUE	TRUE	1	0
FBgn0085332	63	60	46	40	109	100	TRUE	TRUE	TRUE	1	TRUE	TRUE	1	1
FBgn0085336	48	31	34	18	82	49	FALSE	FALSE	FALSE	0	FALSE	FALSE	0	0
FBgn0085337	36	52	34	30	70	82	TRUE	TRUE	TRUE	1	TRUE	TRUE	1	1
FBgn0085345	17	14	12	20	29	34	TRUE	TRUE	TRUE	1	TRUE	FALSE	0	0
FBgn0085369	334	333	261	300	595	633	TRUE	TRUE	TRUE	1	TRUE	TRUE	1	1
FBgn0085370	715	637	569	612	1284	1249	FALSE	TRUE	TRUE	0	TRUE	TRUE	1	0
FBgn0085371	186	207	158	163	344	370	TRUE	TRUE	TRUE	1	TRUE	TRUE	1	1
FBgn0085374	192	177	172	183	364	360	TRUE	TRUE	TRUE	1	TRUE	TRUE	1	1
FBgn0085376	473	499	388	376	861	875	TRUE	TRUE	TRUE	1	TRUE	TRUE	1	1
FBgn0085380	349	357	297	291	646	648	TRUE	TRUE	TRUE	1	TRUE	TRUE	1	1
FBgn0085382	383	336	307	293	690	629	FALSE	TRUE	FALSE	0	TRUE	TRUE	1	0
FBgn0085383	113	114	104	90	217	204	TRUE	TRUE	TRUE	1	TRUE	TRUE	1	1
FBgn0085384	453	460	378	364	831	824	TRUE	TRUE	TRUE	1	TRUE	TRUE	1	1
FBgn0085385	604	610	549	509	1153	1119	TRUE	TRUE	TRUE	1	TRUE	TRUE	1	1
FBgn0085386	99	104	81	94	180	198	TRUE	TRUE	TRUE	1	TRUE	TRUE	1	1
FBgn0085390	465	496	379	385	844	881	TRUE	TRUE	TRUE	1	TRUE	TRUE	1	1
FBgn0085391	601	606	549	571	1150	1177	TRUE	TRUE	TRUE	1	TRUE	TRUE	1	1
FBgn0085395	513	585	505	535	1018	1120	FALSE	TRUE	FALSE	0	TRUE	TRUE	1	0
FBgn0085396	207	211	178	153	385	364	TRUE	TRUE	TRUE	1	TRUE	TRUE	1	1
FBgn0085397	502	519	461	472	963	991	TRUE	TRUE	TRUE	1	TRUE	TRUE	1	1
FBgn0085398	223	255	207	230	430	485	TRUE	TRUE	FALSE	0	TRUE	TRUE	1	0
FBgn0085399	460	487	391	362	851	849	TRUE	TRUE	TRUE	1	TRUE	TRUE	1	1
FBgn0085400	579	600	532	464	1111	1064	TRUE	FALSE	TRUE	0	TRUE	TRUE	1	0
FBgn0085404	219	195	171	164	390	359	TRUE	TRUE	TRUE	1	TRUE	TRUE	1	1
FBgn0085405	176	174	174	135	350	309	TRUE	FALSE	TRUE	0	TRUE	TRUE	1	0
FBgn0085407	534	531	485	453	1019	984	TRUE	TRUE	TRUE	1	TRUE	TRUE	1	1
FBgn0085408	478	482	401	413	879	895	TRUE	TRUE	TRUE	1	TRUE	TRUE	1	1
FBgn0085409	497	464	429	397	926	861	TRUE	TRUE	TRUE	1	TRUE	TRUE	1	1
FBgn0085410	386	379	319	317	705	696	TRUE	TRUE	TRUE	1	TRUE	TRUE	1	1
FBgn0085411	218	253	177	179	395	432	TRUE	TRUE	TRUE	1	TRUE	TRUE	1	1
FBgn0085412	716	676	641	581	1357	1257	TRUE	FALSE	FALSE	0	TRUE	TRUE	1	0
FBgn0085413	389	411	356	343	745	754	TRUE	TRUE	TRUE	1	TRUE	TRUE	1	1
FBgn0085414	171	180	148	137	319	317	TRUE	TRUE	TRUE	1	TRUE	TRUE	1	1
FBgn0085415	184	199	160	191	344	390	TRUE	TRUE	FALSE	0	TRUE	TRUE	1	0
FBgn0085417	59	60	49	47	108	107	TRUE	TRUE	TRUE	1	TRUE	TRUE	1	1
FBgn0085419	461	390	374	350	835	740	FALSE	TRUE	FALSE	0	TRUE	TRUE	1	0
FBgn0085420	159	153	126	128	285	281	TRUE	TRUE	TRUE	1	TRUE	TRUE	1	1
FBgn0085421	497	527	459	387	956	914	TRUE	FALSE	TRUE	0	TRUE	TRUE	1	0
FBgn0085422	365	352	307	301	672	653	TRUE	TRUE	TRUE	1	TRUE	TRUE	1	1
FBgn0085423	307	324	255	262	562	586	TRUE	TRUE	TRUE	1	TRUE	TRUE	1	1
FBgn0085424	412	400	390	367	802	767	TRUE	TRUE	TRUE	1	TRUE	TRUE	1	1
FBgn0085425	419	402	323	334	742	736	TRUE	TRUE	TRUE	1	TRUE	TRUE	1	1
FBgn0085426	455	412	358	400	813	812	TRUE	TRUE	TRUE	1	TRUE	TRUE	1	1
FBgn0085427	607	695	526	524	1133	1219	FALSE	TRUE	FALSE	0	TRUE	TRUE	1	0
FBgn0085428	542	479	479	430	1021	909	FALSE	TRUE	FALSE	0	TRUE	TRUE	1	0
FBgn0085431	165	150	152	146	317	296	TRUE	TRUE	TRUE	1	TRUE	TRUE	1	1
FBgn0085432	366	353	280	275	646	628	TRUE	TRUE	TRUE	1	TRUE	TRUE	1	1
FBgn0085434	430	398	321	318	751	716	TRUE	TRUE	TRUE	1	TRUE	TRUE	1	1
FBgn0085436	319	277	238	236	557	513	FALSE	TRUE	TRUE	0	TRUE	TRUE	1	0
FBgn0085442	169	184	153	139	322	323	TRUE	TRUE	TRUE	1	TRUE	TRUE	1	1
FBgn0085444	327	322	267	274	594	596	TRUE	TRUE	TRUE	1	TRUE	TRUE	1	1
FBgn0085447	350	361	318	299	668	660	TRUE	TRUE	TRUE	1	TRUE	TRUE	1	1
FBgn0085450	423	425	312	366	735	791	TRUE	FALSE	TRUE	0	TRUE	TRUE	1	0
FBgn0085453	48	45	34	48	82	93	TRUE	TRUE	TRUE	1	TRUE	TRUE	1	1
FBgn0085455	88	96	65	84	153	180	TRUE	TRUE	TRUE	1	TRUE	TRUE	1	1
FBgn0085456	83	86	69	62	152	148	TRUE	TRUE	TRUE	1	TRUE	TRUE	1	1
FBgn0085457	113	91	88	92	201	183	TRUE	TRUE	TRUE	1	TRUE	TRUE	1	1
FBgn0085458	44	46	41	37	85	83	TRUE	TRUE	TRUE	1	TRUE	TRUE	1	1
FBgn0085459	64	51	54	58	118	109	TRUE	TRUE	TRUE	1	TRUE	TRUE	1	1
FBgn0085460	145	172	123	161	268	333	TRUE	FALSE	FALSE	0	TRUE	TRUE	1	0
FBgn0085461	64	66	71	58	135	124	TRUE	TRUE	TRUE	1	TRUE	TRUE	1	1
FBgn0085462	75	64	58	44	133	108	TRUE	TRUE	TRUE	1	TRUE	TRUE	1	1
FBgn0085465	105	102	80	78	185	180	TRUE	TRUE	TRUE	1	TRUE	TRUE	1	1
FBgn0085466	59	55	55	46	114	101	TRUE	TRUE	TRUE	1	TRUE	TRUE	1	1
FBgn0085468	62	55	45	42	107	97	TRUE	TRUE	TRUE	1	TRUE	TRUE	1	1
FBgn0085471	23	26	14	21	37	47	TRUE	TRUE	TRUE	1	TRUE	TRUE	1	1
FBgn0085472	63	55	58	51	121	106	TRUE	TRUE	TRUE	1	TRUE	TRUE	1	1
FBgn0085473	102	91	86	82	188	173	TRUE	TRUE	TRUE	1	TRUE	TRUE	1	1
FBgn0085474	35	40	23	25	58	65	TRUE	TRUE	TRUE	1	TRUE	TRUE	1	1
FBgn0085475	24	13	19	12	43	25	FALSE	TRUE	FALSE	0	FALSE	FALSE	0	0
FBgn0085476	192	158	122	129	314	287	FALSE	TRUE	TRUE	0	TRUE	TRUE	1	0
FBgn0085477	135	107	103	122	238	229	FALSE	TRUE	TRUE	0	TRUE	TRUE	1	0
FBgn0085480	102	110	110	102	212	212	TRUE	TRUE	TRUE	1	TRUE	TRUE	1	1
FBgn0085481	96	93	66	52	162	145	TRUE	TRUE	TRUE	1	TRUE	TRUE	1	1
FBgn0085482	28	34	27	27	55	61	TRUE	TRUE	TRUE	1	TRUE	TRUE	1	1
FBgn0085484	116	135	104	115	220	250	TRUE	TRUE	TRUE	1	TRUE	TRUE	1	1
FBgn0085486	150	123	97	123	247	246	TRUE	FALSE	TRUE	0	TRUE	TRUE	1	0
FBgn0085487	74	99	63	58	137	157	FALSE	TRUE	TRUE	0	TRUE	TRUE	1	0
FBgn0085488	155	141	139	131	294	272	TRUE	TRUE	TRUE	1	TRUE	TRUE	1	1
FBgn0085489	81	65	55	34	136	99	TRUE	FALSE	FALSE	0	TRUE	FALSE	0	0
FBgn0085491	97	101	95	91	192	192	TRUE	TRUE	TRUE	1	TRUE	TRUE	1	1
FBgn0085734	43	45	49	55	92	100	TRUE	TRUE	TRUE	1	TRUE	TRUE	1	1
FBgn0085736	14	25	7	24	21	49	TRUE	FALSE	FALSE	0	FALSE	FALSE	0	0
FBgn0085753	54	21	52	5	106	26	FALSE	FALSE	FALSE	0	FALSE	FALSE	0	0
FBgn0085786	24	25	35	37	59	62	TRUE	TRUE	TRUE	1	TRUE	TRUE	1	1
FBgn0085812	17	29	22	15	39	44	TRUE	TRUE	TRUE	1	FALSE	TRUE	0	0
FBgn0086030	25	40	30	34	55	74	FALSE	TRUE	TRUE	0	FALSE	TRUE	0	0
FBgn0086032	22	34	24	32	46	66	TRUE	TRUE	FALSE	0	FALSE	TRUE	0	0
FBgn0086033	31	18	21	10	52	28	FALSE	FALSE	FALSE	0	FALSE	FALSE	0	0
FBgn0086037	16	28	25	24	41	52	FALSE	TRUE	TRUE	0	FALSE	TRUE	0	0
FBgn0086038	31	42	30	23	61	65	TRUE	TRUE	TRUE	1	TRUE	TRUE	1	1
FBgn0086040	36	15	29	17	65	32	FALSE	TRUE	FALSE	0	FALSE	FALSE	0	0
FBgn0086073	39	31	30	32	69	63	TRUE	TRUE	TRUE	1	TRUE	TRUE	1	1
FBgn0086076	21	14	23	14	44	28	TRUE	TRUE	FALSE	0	TRUE	FALSE	0	0
FBgn0086081	43	40	36	35	79	75	TRUE	TRUE	TRUE	1	TRUE	TRUE	1	1
FBgn0086129	178	166	170	139	348	305	TRUE	FALSE	TRUE	0	TRUE	TRUE	1	0
FBgn0086130	63	43	33	38	96	81	FALSE	TRUE	TRUE	0	TRUE	TRUE	1	0
FBgn0086134	86	80	74	80	160	160	TRUE	TRUE	TRUE	1	TRUE	TRUE	1	1
FBgn0086200	102	100	90	105	192	205	TRUE	TRUE	TRUE	1	TRUE	TRUE	1	1
FBgn0086251	111	102	105	91	216	193	TRUE	TRUE	TRUE	1	TRUE	TRUE	1	1
FBgn0086253	47	28	29	28	76	56	FALSE	TRUE	FALSE	0	FALSE	TRUE	0	0
FBgn0086254	188	184	147	158	335	342	TRUE	TRUE	TRUE	1	TRUE	TRUE	1	1
FBgn0086265	167	194	143	162	310	356	TRUE	TRUE	FALSE	0	TRUE	TRUE	1	0
FBgn0086266	26	45	20	30	46	75	FALSE	TRUE	FALSE	0	FALSE	TRUE	0	0
FBgn0086346	172	145	140	127	312	272	TRUE	TRUE	TRUE	1	TRUE	TRUE	1	1
FBgn0086347	391	362	305	273	696	635	TRUE	TRUE	TRUE	1	TRUE	TRUE	1	1
FBgn0086348	67	52	47	52	114	104	TRUE	TRUE	TRUE	1	TRUE	TRUE	1	1
FBgn0086350	89	68	70	69	159	137	TRUE	TRUE	TRUE	1	TRUE	TRUE	1	1
FBgn0086355	132	134	94	98	226	232	TRUE	TRUE	TRUE	1	TRUE	TRUE	1	1
FBgn0086356	170	166	145	125	315	291	TRUE	TRUE	TRUE	1	TRUE	TRUE	1	1
FBgn0086357	100	113	96	98	196	211	TRUE	TRUE	TRUE	1	TRUE	TRUE	1	1
FBgn0086358	328	364	242	247	570	611	TRUE	TRUE	TRUE	1	TRUE	TRUE	1	1
FBgn0086359	152	140	122	105	274	245	TRUE	TRUE	TRUE	1	TRUE	TRUE	1	1
FBgn0086361	199	220	151	166	350	386	TRUE	TRUE	TRUE	1	TRUE	TRUE	1	1
FBgn0086362	133	90	97	94	230	184	FALSE	TRUE	FALSE	0	TRUE	TRUE	1	0
FBgn0086365	228	262	172	202	400	464	TRUE	TRUE	FALSE	0	TRUE	TRUE	1	0
FBgn0086370	167	173	143	130	310	303	TRUE	TRUE	TRUE	1	TRUE	TRUE	1	1
FBgn0086371	139	152	124	113	263	265	TRUE	TRUE	TRUE	1	TRUE	TRUE	1	1
FBgn0086372	125	125	119	117	244	242	TRUE	TRUE	TRUE	1	TRUE	TRUE	1	1
FBgn0086378	38	86	18	68	56	154	FALSE	FALSE	FALSE	0	FALSE	FALSE	0	0
FBgn0086408	418	402	342	348	760	750	TRUE	TRUE	TRUE	1	TRUE	TRUE	1	1
FBgn0086442	143	146	116	84	259	230	TRUE	FALSE	TRUE	0	TRUE	TRUE	1	0
FBgn0086443	142	159	122	121	264	280	TRUE	TRUE	TRUE	1	TRUE	TRUE	1	1
FBgn0086444	123	150	103	101	226	251	TRUE	TRUE	TRUE	1	TRUE	TRUE	1	1
FBgn0086445	118	110	110	121	228	231	TRUE	TRUE	TRUE	1	TRUE	TRUE	1	1
FBgn0086446	50	45	41	34	91	79	TRUE	TRUE	TRUE	1	TRUE	TRUE	1	1
FBgn0086447	42	47	44	42	86	89	TRUE	TRUE	TRUE	1	TRUE	TRUE	1	1
FBgn0086451	562	518	473	464	1035	982	TRUE	TRUE	TRUE	1	TRUE	TRUE	1	1
FBgn0086472	68	63	64	66	132	129	TRUE	TRUE	TRUE	1	TRUE	TRUE	1	1
FBgn0086519	28	39	15	26	43	65	TRUE	TRUE	FALSE	0	TRUE	FALSE	0	0
FBgn0086604	563	629	496	546	1059	1175	FALSE	TRUE	FALSE	0	TRUE	TRUE	1	0
FBgn0086605	45	26	26	30	71	56	FALSE	TRUE	TRUE	0	FALSE	TRUE	0	0
FBgn0086610	56	46	37	44	93	90	TRUE	TRUE	TRUE	1	TRUE	TRUE	1	1
FBgn0086611	21	30	15	27	36	57	TRUE	FALSE	FALSE	0	TRUE	FALSE	0	0
FBgn0086613	435	401	374	384	809	785	TRUE	TRUE	TRUE	1	TRUE	TRUE	1	1
FBgn0086655	300	318	269	256	569	574	TRUE	TRUE	TRUE	1	TRUE	TRUE	1	1
FBgn0086656	31	37	35	23	66	60	TRUE	TRUE	TRUE	1	TRUE	FALSE	0	0
FBgn0086657	73	61	53	56	126	117	TRUE	TRUE	TRUE	1	TRUE	TRUE	1	1
FBgn0086673	188	220	175	178	363	398	TRUE	TRUE	TRUE	1	TRUE	TRUE	1	1
FBgn0086676	378	374	340	305	718	679	TRUE	TRUE	TRUE	1	TRUE	TRUE	1	1
FBgn0086677	520	517	431	399	951	916	TRUE	TRUE	TRUE	1	TRUE	TRUE	1	1
FBgn0086679	85	81	59	63	144	144	TRUE	TRUE	TRUE	1	TRUE	TRUE	1	1
FBgn0086680	325	286	245	210	570	496	TRUE	TRUE	FALSE	0	TRUE	TRUE	1	0
FBgn0086681	113	124	113	97	226	221	TRUE	TRUE	TRUE	1	TRUE	TRUE	1	1
FBgn0086683	61	42	49	26	110	68	FALSE	FALSE	FALSE	0	TRUE	FALSE	0	0
FBgn0086687	133	123	112	86	245	209	TRUE	FALSE	TRUE	0	TRUE	TRUE	1	0
FBgn0086690	851	787	707	714	1558	1501	TRUE	TRUE	TRUE	1	TRUE	TRUE	1	1
FBgn0086691	102	96	88	93	190	189	TRUE	TRUE	TRUE	1	TRUE	TRUE	1	1
FBgn0086694	257	246	183	183	440	429	TRUE	TRUE	TRUE	1	TRUE	TRUE	1	1
FBgn0086695	56	61	51	49	107	110	TRUE	TRUE	TRUE	1	TRUE	TRUE	1	1
FBgn0086698	276	268	258	247	534	515	TRUE	TRUE	TRUE	1	TRUE	TRUE	1	1
FBgn0086704	219	221	203	156	422	377	TRUE	FALSE	TRUE	0	TRUE	TRUE	1	0
FBgn0086706	168	188	156	158	324	346	TRUE	TRUE	TRUE	1	TRUE	TRUE	1	1
FBgn0086707	211	240	204	183	415	423	TRUE	TRUE	TRUE	1	TRUE	TRUE	1	1
FBgn0086708	140	138	132	101	272	239	TRUE	FALSE	TRUE	0	TRUE	TRUE	1	0
FBgn0086710	24	25	27	16	51	41	TRUE	TRUE	TRUE	1	TRUE	FALSE	0	0
FBgn0086711	361	383	342	323	703	706	TRUE	TRUE	TRUE	1	TRUE	TRUE	1	1
FBgn0086712	130	159	116	111	246	270	FALSE	TRUE	TRUE	0	TRUE	TRUE	1	0
FBgn0086757	200	217	167	147	367	364	TRUE	TRUE	TRUE	1	TRUE	TRUE	1	1
FBgn0086758	776	762	609	648	1385	1410	TRUE	TRUE	TRUE	1	TRUE	TRUE	1	1
FBgn0086768	50	40	44	33	94	73	TRUE	TRUE	TRUE	1	TRUE	TRUE	1	1
FBgn0086779	169	189	174	167	343	356	TRUE	TRUE	TRUE	1	TRUE	TRUE	1	1
FBgn0086784	177	118	131	130	308	248	FALSE	TRUE	FALSE	0	TRUE	TRUE	1	0
FBgn0086785	37	47	34	32	71	79	TRUE	TRUE	TRUE	1	TRUE	TRUE	1	1
FBgn0086855	55	44	25	36	80	80	TRUE	TRUE	TRUE	1	TRUE	TRUE	1	1
FBgn0086856	36	25	29	24	65	49	TRUE	TRUE	TRUE	1	TRUE	TRUE	1	1
FBgn0086895	147	159	125	85	272	244	TRUE	FALSE	TRUE	0	TRUE	TRUE	1	0
FBgn0086898	152	144	119	101	271	245	TRUE	TRUE	TRUE	1	TRUE	TRUE	1	1
FBgn0086904	93	84	97	82	190	166	TRUE	TRUE	TRUE	1	TRUE	TRUE	1	1
FBgn0086906	3347	3417	2993	2937	6340	6354	TRUE	TRUE	TRUE	1	TRUE	TRUE	1	1
FBgn0086907	32	30	20	32	52	62	TRUE	TRUE	TRUE	1	TRUE	FALSE	0	0
FBgn0086909	147	154	130	132	277	286	TRUE	TRUE	TRUE	1	TRUE	TRUE	1	1
FBgn0086912	49	64	65	54	114	118	TRUE	TRUE	TRUE	1	TRUE	TRUE	1	1
FBgn0086913	147	146	113	123	260	269	TRUE	TRUE	TRUE	1	TRUE	TRUE	1	1
FBgn0086915	24	21	15	26	39	47	TRUE	TRUE	TRUE	1	TRUE	FALSE	0	0
FBgn0086916	179	162	177	155	356	317	TRUE	TRUE	TRUE	1	TRUE	TRUE	1	1
FBgn0086917	15	18	16	15	31	33	TRUE	TRUE	TRUE	1	TRUE	TRUE	1	1
FBgn0087002	154	154	106	140	260	294	TRUE	FALSE	TRUE	0	TRUE	TRUE	1	0
FBgn0087007	627	628	508	479	1135	1107	TRUE	TRUE	TRUE	1	TRUE	TRUE	1	1
FBgn0087011	83	101	69	104	152	205	TRUE	FALSE	FALSE	0	TRUE	FALSE	0	0
FBgn0087012	109	84	74	77	183	161	FALSE	TRUE	TRUE	0	TRUE	TRUE	1	0
FBgn0087013	24	34	27	29	51	63	TRUE	TRUE	TRUE	1	TRUE	TRUE	1	1
FBgn0087021	82	72	57	68	139	140	TRUE	TRUE	TRUE	1	TRUE	TRUE	1	1
FBgn0087035	43	57	44	34	87	91	TRUE	TRUE	TRUE	1	TRUE	TRUE	1	1
FBgn0087039	84	54	65	55	149	109	FALSE	TRUE	FALSE	0	FALSE	TRUE	0	0
FBgn0087040	160	162	171	151	331	313	TRUE	TRUE	TRUE	1	TRUE	TRUE	1	1
FBgn0243486	342	350	281	330	623	680	TRUE	FALSE	TRUE	0	TRUE	TRUE	1	0
FBgn0243511	230	260	194	171	424	431	TRUE	TRUE	TRUE	1	TRUE	TRUE	1	1
FBgn0243512	57	27	31	29	88	56	FALSE	TRUE	FALSE	0	FALSE	TRUE	0	0
FBgn0243513	16	23	18	22	34	45	TRUE	TRUE	TRUE	1	TRUE	TRUE	1	1
FBgn0243514	178	181	133	171	311	352	TRUE	FALSE	TRUE	0	TRUE	TRUE	1	0
FBgn0243516	456	494	349	381	805	875	TRUE	TRUE	FALSE	0	TRUE	TRUE	1	0
FBgn0243586	107	94	71	70	178	164	TRUE	TRUE	TRUE	1	TRUE	TRUE	1	1
FBgn0250732	140	165	117	140	257	305	TRUE	TRUE	FALSE	0	TRUE	TRUE	1	0
FBgn0250746	18	15	26	24	44	39	TRUE	TRUE	TRUE	1	TRUE	TRUE	1	1
FBgn0250753	40	50	49	48	89	98	TRUE	TRUE	TRUE	1	TRUE	TRUE	1	1
FBgn0250754	282	312	238	254	520	566	TRUE	TRUE	TRUE	1	TRUE	TRUE	1	1
FBgn0250755	83	74	77	84	160	158	TRUE	TRUE	TRUE	1	TRUE	TRUE	1	1
FBgn0250757	919	933	732	754	1651	1687	TRUE	TRUE	TRUE	1	TRUE	TRUE	1	1
FBgn0250785	222	212	180	179	402	391	TRUE	TRUE	TRUE	1	TRUE	TRUE	1	1
FBgn0250786	359	357	263	287	622	644	TRUE	TRUE	TRUE	1	TRUE	TRUE	1	1
FBgn0250789	173	169	175	147	348	316	TRUE	TRUE	TRUE	1	TRUE	TRUE	1	1
FBgn0250791	93	116	87	74	180	190	TRUE	TRUE	TRUE	1	TRUE	TRUE	1	1
FBgn0250815	95	65	83	63	178	128	FALSE	TRUE	FALSE	0	TRUE	TRUE	1	0
FBgn0250816	154	152	168	135	322	287	TRUE	FALSE	TRUE	0	TRUE	TRUE	1	0
FBgn0250817	34	34	33	36	67	70	TRUE	TRUE	TRUE	1	TRUE	TRUE	1	1
FBgn0250819	56	65	61	50	117	115	TRUE	TRUE	TRUE	1	TRUE	TRUE	1	1
FBgn0250820	125	155	120	113	245	268	FALSE	TRUE	TRUE	0	TRUE	TRUE	1	0
FBgn0250823	456	441	395	362	851	803	TRUE	TRUE	TRUE	1	TRUE	TRUE	1	1
FBgn0250826	81	74	63	68	144	142	TRUE	TRUE	TRUE	1	TRUE	TRUE	1	1
FBgn0250827	36	43	36	26	72	69	TRUE	TRUE	TRUE	1	TRUE	TRUE	1	1
FBgn0250830	78	60	71	57	149	117	TRUE	TRUE	FALSE	0	TRUE	TRUE	1	0
FBgn0250831	59	74	55	56	114	130	TRUE	TRUE	TRUE	1	TRUE	TRUE	1	1
FBgn0250832	30	37	23	30	53	67	TRUE	TRUE	TRUE	1	TRUE	TRUE	1	1
FBgn0250833	161	154	103	121	264	275	TRUE	TRUE	TRUE	1	TRUE	TRUE	1	1
FBgn0250834	99	109	77	97	176	206	TRUE	TRUE	TRUE	1	TRUE	TRUE	1	1
FBgn0250835	82	85	84	86	166	171	TRUE	TRUE	TRUE	1	TRUE	TRUE	1	1
FBgn0250836	70	75	62	64	132	139	TRUE	TRUE	TRUE	1	TRUE	TRUE	1	1
FBgn0250839	30	26	25	26	55	52	TRUE	TRUE	TRUE	1	TRUE	TRUE	1	1
FBgn0250841	133	136	106	90	239	226	TRUE	TRUE	TRUE	1	TRUE	TRUE	1	1
FBgn0250842	124	110	98	71	222	181	TRUE	FALSE	FALSE	0	TRUE	TRUE	1	0
FBgn0250843	17	19	29	31	46	50	TRUE	TRUE	TRUE	1	TRUE	TRUE	1	1
FBgn0250844	118	141	107	107	225	248	TRUE	TRUE	TRUE	1	TRUE	TRUE	1	1
FBgn0250845	19	16	19	32	38	48	TRUE	FALSE	TRUE	0	TRUE	FALSE	0	0
FBgn0250846	83	66	73	77	156	143	TRUE	TRUE	TRUE	1	TRUE	TRUE	1	1
FBgn0250847	115	151	110	107	225	258	FALSE	TRUE	TRUE	0	TRUE	TRUE	1	0
FBgn0250848	122	170	128	131	250	301	FALSE	TRUE	FALSE	0	TRUE	TRUE	1	0
FBgn0250850	395	411	317	318	712	729	TRUE	TRUE	TRUE	1	TRUE	TRUE	1	1
FBgn0250867	284	300	242	248	526	548	TRUE	TRUE	TRUE	1	TRUE	TRUE	1	1
FBgn0250906	57	77	67	62	124	139	TRUE	TRUE	TRUE	1	TRUE	TRUE	1	1
FBgn0250907	99	96	88	103	187	199	TRUE	TRUE	TRUE	1	TRUE	TRUE	1	1
FBgn0250908	501	495	482	412	983	907	TRUE	FALSE	FALSE	0	TRUE	TRUE	1	0
FBgn0250910	304	277	261	193	565	470	TRUE	FALSE	FALSE	0	TRUE	TRUE	1	0
FBgn0259099	312	335	229	250	541	585	TRUE	TRUE	TRUE	1	TRUE	TRUE	1	1
FBgn0259111	760	757	611	590	1371	1347	TRUE	TRUE	TRUE	1	TRUE	TRUE	1	1
FBgn0259112	61	57	44	41	105	98	TRUE	TRUE	TRUE	1	TRUE	TRUE	1	1
FBgn0259113	350	339	273	308	623	647	TRUE	TRUE	TRUE	1	TRUE	TRUE	1	1
FBgn0259139	82	73	53	78	135	151	TRUE	FALSE	TRUE	0	TRUE	TRUE	1	0
FBgn0259140	792	827	701	622	1493	1449	TRUE	FALSE	TRUE	0	TRUE	TRUE	1	0
FBgn0259145	422	439	375	405	797	844	TRUE	TRUE	TRUE	1	TRUE	TRUE	1	1
FBgn0259146	455	397	336	371	791	768	FALSE	TRUE	TRUE	0	TRUE	TRUE	1	0
FBgn0259148	101	85	93	79	194	164	TRUE	TRUE	TRUE	1	TRUE	TRUE	1	1
FBgn0259151	168	190	169	141	337	331	TRUE	TRUE	TRUE	1	TRUE	TRUE	1	1
FBgn0259152	93	83	100	77	193	160	TRUE	FALSE	FALSE	0	TRUE	TRUE	1	0
FBgn0259163	721	732	678	639	1399	1371	TRUE	TRUE	TRUE	1	TRUE	TRUE	1	1
FBgn0259164	211	211	178	169	389	380	TRUE	TRUE	TRUE	1	TRUE	TRUE	1	1
FBgn0259167	145	152	129	137	274	289	TRUE	TRUE	TRUE	1	TRUE	TRUE	1	1
FBgn0259173	504	499	447	420	951	919	TRUE	TRUE	TRUE	1	TRUE	TRUE	1	1
FBgn0259174	376	393	327	319	703	712	TRUE	TRUE	TRUE	1	TRUE	TRUE	1	1
FBgn0259175	296	275	201	217	497	492	TRUE	TRUE	TRUE	1	TRUE	TRUE	1	1
FBgn0259176	819	777	698	635	1517	1412	TRUE	FALSE	FALSE	0	TRUE	TRUE	1	0
FBgn0259178	252	264	248	235	500	499	TRUE	TRUE	TRUE	1	TRUE	TRUE	1	1
FBgn0259179	148	95	93	102	241	197	FALSE	TRUE	FALSE	0	FALSE	TRUE	0	0
FBgn0259183	84	68	63	60	147	128	TRUE	TRUE	TRUE	1	TRUE	TRUE	1	1
FBgn0259184	68	78	60	47	128	125	TRUE	TRUE	TRUE	1	TRUE	TRUE	1	1
FBgn0259185	95	109	85	97	180	206	TRUE	TRUE	TRUE	1	TRUE	TRUE	1	1
FBgn0259186	81	78	58	52	139	130	TRUE	TRUE	TRUE	1	TRUE	TRUE	1	1
FBgn0259187	123	119	78	95	201	214	TRUE	TRUE	TRUE	1	TRUE	TRUE	1	1
FBgn0259192	21	36	35	24	56	60	FALSE	TRUE	TRUE	0	FALSE	TRUE	0	0
FBgn0259193	129	137	143	117	272	254	TRUE	TRUE	TRUE	1	TRUE	TRUE	1	1
FBgn0259194	159	177	147	146	306	323	TRUE	TRUE	TRUE	1	TRUE	TRUE	1	1
FBgn0259209	229	223	224	171	453	394	TRUE	FALSE	FALSE	0	TRUE	TRUE	1	0
FBgn0259210	314	319	267	233	581	552	TRUE	TRUE	TRUE	1	TRUE	TRUE	1	1
FBgn0259211	741	758	642	669	1383	1427	TRUE	TRUE	TRUE	1	TRUE	TRUE	1	1
FBgn0259212	195	180	155	148	350	328	TRUE	TRUE	TRUE	1	TRUE	TRUE	1	1
FBgn0259213	502	484	451	456	953	940	TRUE	TRUE	TRUE	1	TRUE	TRUE	1	1
FBgn0259214	140	143	122	81	262	224	TRUE	FALSE	FALSE	0	TRUE	FALSE	0	0
FBgn0259215	116	108	75	90	191	198	TRUE	TRUE	TRUE	1	TRUE	TRUE	1	1
FBgn0259216	206	196	172	135	378	331	TRUE	FALSE	FALSE	0	TRUE	TRUE	1	0
FBgn0259219	310	299	210	241	520	540	TRUE	TRUE	TRUE	1	TRUE	TRUE	1	1
FBgn0259221	835	846	715	694	1550	1540	TRUE	TRUE	TRUE	1	TRUE	TRUE	1	1
FBgn0259222	265	252	209	222	474	474	TRUE	TRUE	TRUE	1	TRUE	TRUE	1	1
FBgn0259224	495	537	411	411	906	948	TRUE	TRUE	TRUE	1	TRUE	TRUE	1	1
FBgn0259226	402	392	304	260	706	652	TRUE	FALSE	TRUE	0	TRUE	TRUE	1	0
FBgn0259227	363	402	301	335	664	737	TRUE	TRUE	FALSE	0	TRUE	TRUE	1	0
FBgn0259229	343	333	269	304	612	637	TRUE	TRUE	TRUE	1	TRUE	TRUE	1	1
FBgn0259230	42	35	48	35	90	70	TRUE	TRUE	TRUE	1	TRUE	TRUE	1	1
FBgn0259233	446	421	322	344	768	765	TRUE	TRUE	TRUE	1	TRUE	TRUE	1	1
FBgn0259234	687	691	554	570	1241	1261	TRUE	TRUE	TRUE	1	TRUE	TRUE	1	1
FBgn0259236	156	171	131	111	287	282	TRUE	TRUE	TRUE	1	TRUE	TRUE	1	1
FBgn0259237	277	276	239	243	516	519	TRUE	TRUE	TRUE	1	TRUE	TRUE	1	1
FBgn0259238	149	142	117	121	266	263	TRUE	TRUE	TRUE	1	TRUE	TRUE	1	1
FBgn0259239	33	23	22	18	55	41	TRUE	TRUE	TRUE	1	TRUE	TRUE	1	1
FBgn0259243	273	230	210	245	483	475	FALSE	TRUE	TRUE	0	TRUE	TRUE	1	0
FBgn0259244	524	481	406	451	930	932	TRUE	TRUE	TRUE	1	TRUE	TRUE	1	1
FBgn0259246	830	906	737	739	1567	1645	FALSE	TRUE	TRUE	0	TRUE	TRUE	1	0
FBgn0259481	334	357	290	308	624	665	TRUE	TRUE	TRUE	1	TRUE	TRUE	1	1
FBgn0259482	74	99	74	74	148	173	FALSE	TRUE	TRUE	0	TRUE	TRUE	1	0
FBgn0259483	45	62	36	31	81	93	TRUE	TRUE	TRUE	1	TRUE	TRUE	1	1
FBgn0259678	451	481	399	439	850	920	TRUE	TRUE	TRUE	1	TRUE	TRUE	1	1
FBgn0259682	272	249	241	234	513	483	TRUE	TRUE	TRUE	1	TRUE	TRUE	1	1
FBgn0259683	175	155	138	167	313	322	TRUE	TRUE	TRUE	1	TRUE	TRUE	1	1
FBgn0259685	454	431	389	383	843	814	TRUE	TRUE	TRUE	1	TRUE	TRUE	1	1
FBgn0259697	27	26	37	26	64	52	TRUE	TRUE	TRUE	1	TRUE	TRUE	1	1
FBgn0259701	43	30	33	16	76	46	TRUE	FALSE	FALSE	0	TRUE	FALSE	0	0
FBgn0259702	148	116	119	100	267	216	FALSE	TRUE	FALSE	0	TRUE	TRUE	1	0
FBgn0259703	108	85	77	62	185	147	TRUE	TRUE	FALSE	0	TRUE	TRUE	1	0
FBgn0259704	59	66	45	58	104	124	TRUE	TRUE	TRUE	1	TRUE	TRUE	1	1
FBgn0259705	24	29	30	23	54	52	TRUE	TRUE	TRUE	1	TRUE	TRUE	1	1
FBgn0259710	19	19	15	26	34	45	TRUE	TRUE	TRUE	1	TRUE	FALSE	0	0
FBgn0259711	67	64	65	48	132	112	TRUE	TRUE	TRUE	1	TRUE	TRUE	1	1
FBgn0259712	348	316	254	288	602	604	TRUE	TRUE	TRUE	1	TRUE	TRUE	1	1
FBgn0259713	56	61	45	55	101	116	TRUE	TRUE	TRUE	1	TRUE	TRUE	1	1
FBgn0259714	315	321	256	297	571	618	TRUE	FALSE	TRUE	0	TRUE	TRUE	1	0
FBgn0259715	185	139	114	139	299	278	FALSE	TRUE	TRUE	0	TRUE	TRUE	1	0
FBgn0259716	105	133	93	89	198	222	FALSE	TRUE	TRUE	0	TRUE	TRUE	1	0
FBgn0259729	70	49	45	49	115	98	FALSE	TRUE	TRUE	0	TRUE	TRUE	1	0
FBgn0259735	497	493	374	361	871	854	TRUE	TRUE	TRUE	1	TRUE	TRUE	1	1
FBgn0259736	520	508	392	450	912	958	TRUE	FALSE	TRUE	0	TRUE	TRUE	1	0
FBgn0259737	24	36	31	26	55	62	TRUE	TRUE	TRUE	1	TRUE	TRUE	1	1
FBgn0259739	125	129	115	114	240	243	TRUE	TRUE	TRUE	1	TRUE	TRUE	1	1
FBgn0259740	56	55	50	36	106	91	TRUE	TRUE	TRUE	1	TRUE	TRUE	1	1
FBgn0259742	117	114	96	99	213	213	TRUE	TRUE	TRUE	1	TRUE	TRUE	1	1
FBgn0259745	189	215	187	177	376	392	TRUE	TRUE	TRUE	1	TRUE	TRUE	1	1
FBgn0259748	42	46	35	38	77	84	TRUE	TRUE	TRUE	1	TRUE	TRUE	1	1
FBgn0259749	187	208	194	186	381	394	TRUE	TRUE	TRUE	1	TRUE	TRUE	1	1
FBgn0259785	114	115	72	72	186	187	TRUE	TRUE	TRUE	1	TRUE	TRUE	1	1
FBgn0259791	138	118	98	104	236	222	TRUE	TRUE	TRUE	1	TRUE	TRUE	1	1
FBgn0259794	69	56	48	43	117	99	TRUE	TRUE	TRUE	1	TRUE	TRUE	1	1
FBgn0259795	126	153	104	121	230	274	TRUE	TRUE	FALSE	0	TRUE	TRUE	1	0
FBgn0259818	67	72	53	44	120	116	TRUE	TRUE	TRUE	1	TRUE	TRUE	1	1
FBgn0259821	79	53	75	68	154	121	FALSE	TRUE	FALSE	0	TRUE	TRUE	1	0
FBgn0259822	569	557	472	428	1041	985	TRUE	TRUE	TRUE	1	TRUE	TRUE	1	1
FBgn0259823	302	347	280	302	582	649	FALSE	TRUE	FALSE	0	TRUE	TRUE	1	0
FBgn0259824	171	179	138	158	309	337	TRUE	TRUE	TRUE	1	TRUE	TRUE	1	1
FBgn0259831	28	26	25	27	53	53	TRUE	TRUE	TRUE	1	TRUE	TRUE	1	1
FBgn0259832	35	33	30	33	65	66	TRUE	TRUE	TRUE	1	TRUE	TRUE	1	1
FBgn0259876	200	191	159	154	359	345	TRUE	TRUE	TRUE	1	TRUE	TRUE	1	1
FBgn0259878	215	204	164	156	379	360	TRUE	TRUE	TRUE	1	TRUE	TRUE	1	1
FBgn0259896	287	298	247	240	534	538	TRUE	TRUE	TRUE	1	TRUE	TRUE	1	1
FBgn0259916	115	81	85	103	200	184	FALSE	TRUE	TRUE	0	TRUE	TRUE	1	0
FBgn0259917	56	41	36	38	92	79	TRUE	TRUE	TRUE	1	TRUE	TRUE	1	1
FBgn0259922	79	86	68	73	147	159	TRUE	TRUE	TRUE	1	TRUE	TRUE	1	1
FBgn0259935	358	320	300	270	658	590	TRUE	TRUE	FALSE	0	TRUE	TRUE	1	0
FBgn0259936	43	30	26	26	69	56	TRUE	TRUE	TRUE	1	TRUE	TRUE	1	1
FBgn0259937	70	76	70	74	140	150	TRUE	TRUE	TRUE	1	TRUE	TRUE	1	1
FBgn0259938	211	154	148	148	359	302	FALSE	TRUE	FALSE	0	TRUE	TRUE	1	0
FBgn0259949	39	29	34	21	73	50	TRUE	TRUE	FALSE	0	TRUE	FALSE	0	0
FBgn0259950	76	73	57	63	133	136	TRUE	TRUE	TRUE	1	TRUE	TRUE	1	1
FBgn0259951	65	76	36	44	101	120	TRUE	TRUE	TRUE	1	TRUE	TRUE	1	1
FBgn0259952	67	63	47	47	114	110	TRUE	TRUE	TRUE	1	TRUE	TRUE	1	1
FBgn0259953	58	41	35	46	93	87	TRUE	TRUE	TRUE	1	TRUE	TRUE	1	1
FBgn0259954	34	29	35	44	69	73	TRUE	TRUE	TRUE	1	TRUE	TRUE	1	1
FBgn0259955	42	40	48	25	90	65	TRUE	FALSE	FALSE	0	TRUE	FALSE	0	0
FBgn0259956	40	41	23	34	63	75	TRUE	TRUE	TRUE	1	TRUE	TRUE	1	1
FBgn0259957	32	35	27	39	59	74	TRUE	TRUE	TRUE	1	TRUE	TRUE	1	1
FBgn0259958	33	32	23	28	56	60	TRUE	TRUE	TRUE	1	TRUE	TRUE	1	1
FBgn0259959	35	31	32	25	67	56	TRUE	TRUE	TRUE	1	TRUE	TRUE	1	1
FBgn0259960	67	73	55	47	122	120	TRUE	TRUE	TRUE	1	TRUE	TRUE	1	1
FBgn0259962	37	38	39	35	76	73	TRUE	TRUE	TRUE	1	TRUE	TRUE	1	1
FBgn0259963	45	39	32	32	77	71	TRUE	TRUE	TRUE	1	TRUE	TRUE	1	1
FBgn0259964	53	48	34	44	87	92	TRUE	TRUE	TRUE	1	TRUE	TRUE	1	1
FBgn0259965	48	79	62	67	110	146	FALSE	TRUE	FALSE	0	FALSE	TRUE	0	0
FBgn0259966	49	52	50	51	99	103	TRUE	TRUE	TRUE	1	TRUE	TRUE	1	1
FBgn0259967	84	114	98	91	182	205	FALSE	TRUE	TRUE	0	TRUE	TRUE	1	0
FBgn0259968	50	70	51	50	101	120	FALSE	TRUE	TRUE	0	TRUE	TRUE	1	0
FBgn0259970	42	25	28	25	70	50	FALSE	TRUE	FALSE	0	FALSE	TRUE	0	0
FBgn0259971	11	26	21	16	32	42	FALSE	TRUE	TRUE	0	FALSE	TRUE	0	0
FBgn0259972	27	30	20	25	47	55	TRUE	TRUE	TRUE	1	TRUE	TRUE	1	1
FBgn0259975	51	58	61	51	112	109	TRUE	TRUE	TRUE	1	TRUE	TRUE	1	1
FBgn0259977	86	79	63	57	149	136	TRUE	TRUE	TRUE	1	TRUE	TRUE	1	1
FBgn0259978	138	132	109	112	247	244	TRUE	TRUE	TRUE	1	TRUE	TRUE	1	1
FBgn0259979	73	81	84	65	157	146	TRUE	TRUE	TRUE	1	TRUE	TRUE	1	1
FBgn0259982	55	56	62	45	117	101	TRUE	TRUE	TRUE	1	TRUE	TRUE	1	1
FBgn0259984	493	523	404	374	897	897	TRUE	TRUE	TRUE	1	TRUE	TRUE	1	1
FBgn0259985	139	129	127	106	266	235	TRUE	TRUE	TRUE	1	TRUE	TRUE	1	1
FBgn0259986	282	317	219	218	501	535	TRUE	TRUE	TRUE	1	TRUE	TRUE	1	1
FBgn0259992	46	41	41	30	87	71	TRUE	TRUE	TRUE	1	TRUE	TRUE	1	1
FBgn0259996	50	46	53	41	103	87	TRUE	TRUE	TRUE	1	TRUE	TRUE	1	1
FBgn0259998	90	92	74	69	164	161	TRUE	TRUE	TRUE	1	TRUE	TRUE	1	1
FBgn0260000	44	39	22	53	66	92	TRUE	FALSE	FALSE	0	TRUE	FALSE	0	0
FBgn0260003	1763	1875	1527	1524	3290	3399	FALSE	TRUE	TRUE	0	TRUE	TRUE	1	0
FBgn0260004	226	212	208	197	434	409	TRUE	TRUE	TRUE	1	TRUE	TRUE	1	1
FBgn0260005	113	151	104	114	217	265	FALSE	TRUE	FALSE	0	TRUE	TRUE	1	0
FBgn0260007	46	38	33	52	79	90	TRUE	FALSE	TRUE	0	TRUE	FALSE	0	0
FBgn0260008	75	66	67	51	142	117	TRUE	TRUE	TRUE	1	TRUE	TRUE	1	1
FBgn0260011	106	122	99	70	205	192	TRUE	FALSE	TRUE	0	TRUE	TRUE	1	0
FBgn0260012	321	320	257	292	578	612	TRUE	TRUE	TRUE	1	TRUE	TRUE	1	1
FBgn0260026	81	83	82	88	163	171	TRUE	TRUE	TRUE	1	TRUE	TRUE	1	1
FBgn0260027	48	53	52	40	100	93	TRUE	TRUE	TRUE	1	TRUE	TRUE	1	1
FBgn0260049	180	201	126	135	306	336	TRUE	TRUE	TRUE	1	TRUE	TRUE	1	1
FBgn0260226	35	42	38	20	73	62	TRUE	FALSE	TRUE	0	TRUE	FALSE	0	0
FBgn0260243	70	83	56	65	126	148	TRUE	TRUE	TRUE	1	TRUE	TRUE	1	1
FBgn0260386	52	41	39	43	91	84	TRUE	TRUE	TRUE	1	TRUE	TRUE	1	1
FBgn0260388	133	143	141	142	274	285	TRUE	TRUE	TRUE	1	TRUE	TRUE	1	1
FBgn0260393	41	57	45	43	86	100	TRUE	TRUE	TRUE	1	TRUE	TRUE	1	1
FBgn0260396	63	79	51	54	114	133	TRUE	TRUE	TRUE	1	TRUE	TRUE	1	1
FBgn0260397	101	108	86	113	187	221	TRUE	FALSE	TRUE	0	TRUE	TRUE	1	0
FBgn0260399	222	238	201	208	423	446	TRUE	TRUE	TRUE	1	TRUE	TRUE	1	1
FBgn0260407	52	56	36	46	88	102	TRUE	TRUE	TRUE	1	TRUE	TRUE	1	1
FBgn0260428	68	73	47	50	115	123	TRUE	TRUE	TRUE	1	TRUE	TRUE	1	1
FBgn0260429	184	176	171	144	355	320	TRUE	TRUE	TRUE	1	TRUE	TRUE	1	1
FBgn0260430	82	77	48	83	130	160	TRUE	FALSE	FALSE	0	TRUE	FALSE	0	0
FBgn0260431	22	23	22	20	44	43	TRUE	TRUE	TRUE	1	TRUE	TRUE	1	1
FBgn0260437	82	77	73	73	155	150	TRUE	TRUE	TRUE	1	TRUE	TRUE	1	1
FBgn0260439	268	239	227	239	495	478	TRUE	TRUE	TRUE	1	TRUE	TRUE	1	1
FBgn0260440	185	199	161	141	346	340	TRUE	TRUE	TRUE	1	TRUE	TRUE	1	1
FBgn0260442	1095	1129	903	901	1998	2030	TRUE	TRUE	TRUE	1	TRUE	TRUE	1	1
FBgn0260444	88	92	89	89	177	181	TRUE	TRUE	TRUE	1	TRUE	TRUE	1	1
FBgn0260446	469	464	372	384	841	848	TRUE	TRUE	TRUE	1	TRUE	TRUE	1	1
FBgn0260452	48	53	39	53	87	106	TRUE	TRUE	TRUE	1	TRUE	TRUE	1	1
FBgn0260456	51	55	48	37	99	92	TRUE	TRUE	TRUE	1	TRUE	TRUE	1	1
FBgn0260459	103	95	77	85	180	180	TRUE	TRUE	TRUE	1	TRUE	TRUE	1	1
FBgn0260462	77	75	51	49	128	124	TRUE	TRUE	TRUE	1	TRUE	TRUE	1	1
FBgn0260474	91	139	95	102	186	241	FALSE	TRUE	FALSE	0	FALSE	TRUE	0	0
FBgn0260477	76	61	50	49	126	110	TRUE	TRUE	TRUE	1	TRUE	TRUE	1	1
FBgn0260480	59	58	34	45	93	103	TRUE	TRUE	TRUE	1	TRUE	TRUE	1	1
FBgn0260481	60	50	42	43	102	93	TRUE	TRUE	TRUE	1	TRUE	TRUE	1	1
FBgn0260486	755	762	674	664	1429	1426	TRUE	TRUE	TRUE	1	TRUE	TRUE	1	1
FBgn0260487	454	469	342	346	796	815	TRUE	TRUE	TRUE	1	TRUE	TRUE	1	1
FBgn0260499	351	362	287	285	638	647	TRUE	TRUE	TRUE	1	TRUE	TRUE	1	1
FBgn0260632	379	375	305	297	684	672	TRUE	TRUE	TRUE	1	TRUE	TRUE	1	1
FBgn0260634	341	321	249	257	590	578	TRUE	TRUE	TRUE	1	TRUE	TRUE	1	1
FBgn0260635	177	186	141	151	318	337	TRUE	TRUE	TRUE	1	TRUE	TRUE	1	1
FBgn0260639	94	116	72	102	166	218	TRUE	FALSE	FALSE	0	TRUE	TRUE	1	0
FBgn0260642	308	293	217	210	525	503	TRUE	TRUE	TRUE	1	TRUE	TRUE	1	1
FBgn0260643	93	77	79	72	172	149	TRUE	TRUE	TRUE	1	TRUE	TRUE	1	1
FBgn0260644	49	34	37	22	86	56	TRUE	FALSE	FALSE	0	TRUE	FALSE	0	0
FBgn0260646	46	46	36	45	82	91	TRUE	TRUE	TRUE	1	TRUE	TRUE	1	1
FBgn0260653	187	195	143	157	330	352	TRUE	TRUE	TRUE	1	TRUE	TRUE	1	1
FBgn0260655	109	131	78	84	187	215	TRUE	TRUE	TRUE	1	TRUE	TRUE	1	1
FBgn0260657	447	448	380	415	827	863	TRUE	TRUE	TRUE	1	TRUE	TRUE	1	1
FBgn0260659	89	48	59	42	148	90	FALSE	TRUE	FALSE	0	FALSE	TRUE	0	0
FBgn0260660	728	686	632	530	1360	1216	TRUE	FALSE	FALSE	0	TRUE	TRUE	1	0
FBgn0260718	34	30	25	20	59	50	TRUE	TRUE	TRUE	1	TRUE	TRUE	1	1
FBgn0260719	20	24	12	20	32	44	TRUE	TRUE	TRUE	1	TRUE	FALSE	0	0
FBgn0260720	47	60	53	44	100	104	TRUE	TRUE	TRUE	1	TRUE	TRUE	1	1
FBgn0260721	57	56	50	40	107	96	TRUE	TRUE	TRUE	1	TRUE	TRUE	1	1
FBgn0260722	111	103	88	83	199	186	TRUE	TRUE	TRUE	1	TRUE	TRUE	1	1
FBgn0260741	67	91	65	50	132	141	FALSE	TRUE	TRUE	0	TRUE	TRUE	1	0
FBgn0260742	161	119	106	95	267	214	FALSE	TRUE	FALSE	0	TRUE	TRUE	1	0
FBgn0260743	77	61	76	62	153	123	TRUE	TRUE	FALSE	0	TRUE	TRUE	1	0
FBgn0260744	38	42	32	37	70	79	TRUE	TRUE	TRUE	1	TRUE	TRUE	1	1
FBgn0260745	231	230	197	228	428	458	TRUE	TRUE	TRUE	1	TRUE	TRUE	1	1
FBgn0260746	185	197	159	136	344	333	TRUE	TRUE	TRUE	1	TRUE	TRUE	1	1
FBgn0260749	459	410	374	376	833	786	TRUE	TRUE	TRUE	1	TRUE	TRUE	1	1
FBgn0260750	106	135	118	87	224	222	FALSE	FALSE	TRUE	0	TRUE	TRUE	1	0
FBgn0260755	145	120	115	125	260	245	TRUE	TRUE	TRUE	1	TRUE	TRUE	1	1
FBgn0260756	81	67	57	67	138	134	TRUE	TRUE	TRUE	1	TRUE	TRUE	1	1
FBgn0260758	32	31	14	28	46	59	TRUE	FALSE	TRUE	0	TRUE	FALSE	0	0
FBgn0260763	79	91	87	91	166	182	TRUE	TRUE	TRUE	1	TRUE	TRUE	1	1
FBgn0260764	85	84	73	70	158	154	TRUE	TRUE	TRUE	1	TRUE	TRUE	1	1
FBgn0260766	94	91	59	69	153	160	TRUE	TRUE	TRUE	1	TRUE	TRUE	1	1
FBgn0260768	65	67	60	45	125	112	TRUE	TRUE	TRUE	1	TRUE	TRUE	1	1
FBgn0260776	181	154	135	141	316	295	TRUE	TRUE	TRUE	1	TRUE	TRUE	1	1
FBgn0260777	69	78	62	68	131	146	TRUE	TRUE	TRUE	1	TRUE	TRUE	1	1
FBgn0260779	106	85	110	91	216	176	TRUE	TRUE	FALSE	0	TRUE	TRUE	1	0
FBgn0260793	277	267	224	220	501	487	TRUE	TRUE	TRUE	1	TRUE	TRUE	1	1
FBgn0260794	319	272	226	229	545	501	FALSE	TRUE	TRUE	0	TRUE	TRUE	1	0
FBgn0260795	300	250	239	267	539	517	FALSE	TRUE	TRUE	0	TRUE	TRUE	1	0
FBgn0260798	92	92	74	75	166	167	TRUE	TRUE	TRUE	1	TRUE	TRUE	1	1
FBgn0260799	74	90	71	72	145	162	TRUE	TRUE	TRUE	1	TRUE	TRUE	1	1
FBgn0260817	146	158	118	138	264	296	TRUE	TRUE	TRUE	1	TRUE	TRUE	1	1
FBgn0260857	44	30	22	39	66	69	TRUE	FALSE	TRUE	0	TRUE	FALSE	0	0
FBgn0260860	129	125	103	106	232	231	TRUE	TRUE	TRUE	1	TRUE	TRUE	1	1
FBgn0260861	26	35	33	40	59	75	TRUE	TRUE	TRUE	1	TRUE	TRUE	1	1
FBgn0260862	82	48	57	61	139	109	FALSE	TRUE	FALSE	0	FALSE	TRUE	0	0
FBgn0260866	243	264	196	191	439	455	TRUE	TRUE	TRUE	1	TRUE	TRUE	1	1
FBgn0260874	39	40	45	48	84	88	TRUE	TRUE	TRUE	1	TRUE	TRUE	1	1
FBgn0260932	43	59	38	43	81	102	TRUE	TRUE	TRUE	1	TRUE	TRUE	1	1
FBgn0260933	417	405	347	353	764	758	TRUE	TRUE	TRUE	1	TRUE	TRUE	1	1
FBgn0260934	521	523	436	460	957	983	TRUE	TRUE	TRUE	1	TRUE	TRUE	1	1
FBgn0260935	240	223	175	204	415	427	TRUE	TRUE	TRUE	1	TRUE	TRUE	1	1
FBgn0260936	205	213	139	161	344	374	TRUE	TRUE	TRUE	1	TRUE	TRUE	1	1
FBgn0260940	65	60	65	49	130	109	TRUE	TRUE	TRUE	1	TRUE	TRUE	1	1
FBgn0260941	664	672	561	574	1225	1246	TRUE	TRUE	TRUE	1	TRUE	TRUE	1	1
FBgn0260942	143	125	96	109	239	234	TRUE	TRUE	TRUE	1	TRUE	TRUE	1	1
FBgn0260943	772	805	705	616	1477	1421	TRUE	FALSE	TRUE	0	TRUE	TRUE	1	0
FBgn0260944	61	50	40	42	101	92	TRUE	TRUE	TRUE	1	TRUE	TRUE	1	1
FBgn0260945	272	251	222	184	494	435	TRUE	FALSE	FALSE	0	TRUE	TRUE	1	0
FBgn0260955	25	36	36	27	61	63	TRUE	TRUE	TRUE	1	TRUE	TRUE	1	1
FBgn0260959	301	319	271	257	572	576	TRUE	TRUE	TRUE	1	TRUE	TRUE	1	1
FBgn0260960	153	146	131	164	284	310	TRUE	FALSE	TRUE	0	TRUE	TRUE	1	0
FBgn0260962	129	123	113	114	242	237	TRUE	TRUE	TRUE	1	TRUE	TRUE	1	1
FBgn0260964	504	509	452	417	956	926	TRUE	TRUE	TRUE	1	TRUE	TRUE	1	1
FBgn0260965	973	897	754	751	1727	1648	FALSE	TRUE	TRUE	0	TRUE	TRUE	1	0
FBgn0260967	97	76	68	88	165	164	TRUE	TRUE	TRUE	1	TRUE	TRUE	1	1
FBgn0260968	22	30	12	21	34	51	TRUE	TRUE	FALSE	0	TRUE	FALSE	0	0
FBgn0260969	26	31	21	25	47	56	TRUE	TRUE	TRUE	1	TRUE	TRUE	1	1
FBgn0260972	24	26	23	15	47	41	TRUE	TRUE	TRUE	1	TRUE	FALSE	0	0
FBgn0260985	105	108	79	93	184	201	TRUE	TRUE	TRUE	1	TRUE	TRUE	1	1
FBgn0260987	138	157	122	107	260	264	TRUE	TRUE	TRUE	1	TRUE	TRUE	1	1
FBgn0260990	231	243	214	186	445	429	TRUE	TRUE	TRUE	1	TRUE	TRUE	1	1
FBgn0260991	81	86	62	64	143	150	TRUE	TRUE	TRUE	1	TRUE	TRUE	1	1
FBgn0260996	78	82	52	58	130	140	TRUE	TRUE	TRUE	1	TRUE	TRUE	1	1
FBgn0260997	22	39	18	35	40	74	FALSE	FALSE	FALSE	0	FALSE	FALSE	0	0
FBgn0261004	46	32	25	34	71	66	TRUE	TRUE	TRUE	1	TRUE	TRUE	1	1
FBgn0261015	41	42	52	32	93	74	TRUE	FALSE	TRUE	0	TRUE	FALSE	0	0
FBgn0261016	277	275	239	250	516	525	TRUE	TRUE	TRUE	1	TRUE	TRUE	1	1
FBgn0261020	161	173	126	150	287	323	TRUE	TRUE	TRUE	1	TRUE	TRUE	1	1
FBgn0261041	588	616	519	506	1107	1122	TRUE	TRUE	TRUE	1	TRUE	TRUE	1	1
FBgn0261046	1042	1017	930	858	1972	1875	TRUE	FALSE	TRUE	0	TRUE	TRUE	1	0
FBgn0261053	391	309	339	332	730	641	FALSE	TRUE	FALSE	0	TRUE	TRUE	1	0
FBgn0261054	88	81	88	85	176	166	TRUE	TRUE	TRUE	1	TRUE	TRUE	1	1
FBgn0261055	34	35	27	25	61	60	TRUE	TRUE	TRUE	1	TRUE	TRUE	1	1
FBgn0261057	31	48	38	43	69	91	FALSE	TRUE	FALSE	0	FALSE	TRUE	0	0
FBgn0261058	46	58	54	46	100	104	TRUE	TRUE	TRUE	1	TRUE	TRUE	1	1
FBgn0261060	56	66	56	40	112	106	TRUE	TRUE	TRUE	1	TRUE	TRUE	1	1
FBgn0261061	29	25	19	18	48	43	TRUE	TRUE	TRUE	1	TRUE	TRUE	1	1
FBgn0261064	122	113	88	64	210	177	TRUE	FALSE	TRUE	0	TRUE	TRUE	1	0
FBgn0261065	178	160	158	133	336	293	TRUE	TRUE	FALSE	0	TRUE	TRUE	1	0
FBgn0261067	53	58	44	52	97	110	TRUE	TRUE	TRUE	1	TRUE	TRUE	1	1
FBgn0261068	48	36	41	38	89	74	TRUE	TRUE	TRUE	1	TRUE	TRUE	1	1
FBgn0261089	327	306	255	268	582	574	TRUE	TRUE	TRUE	1	TRUE	TRUE	1	1
FBgn0261090	345	419	342	320	687	739	FALSE	TRUE	TRUE	0	TRUE	TRUE	1	0
FBgn0261109	27	33	16	19	43	52	TRUE	TRUE	TRUE	1	TRUE	TRUE	1	1
FBgn0261111	92	101	83	83	175	184	TRUE	TRUE	TRUE	1	TRUE	TRUE	1	1
FBgn0261112	65	110	83	61	148	171	FALSE	FALSE	TRUE	0	FALSE	TRUE	0	0
FBgn0261113	307	314	257	282	564	596	TRUE	TRUE	TRUE	1	TRUE	TRUE	1	1
FBgn0261119	132	114	84	94	216	208	TRUE	TRUE	TRUE	1	TRUE	TRUE	1	1
FBgn0261238	362	339	287	288	649	627	TRUE	TRUE	TRUE	1	TRUE	TRUE	1	1
FBgn0261239	100	108	96	88	196	196	TRUE	TRUE	TRUE	1	TRUE	TRUE	1	1
FBgn0261243	328	333	280	267	608	600	TRUE	TRUE	TRUE	1	TRUE	TRUE	1	1
FBgn0261258	78	77	69	71	147	148	TRUE	TRUE	TRUE	1	TRUE	TRUE	1	1
FBgn0261261	106	86	73	65	179	151	TRUE	TRUE	TRUE	1	TRUE	TRUE	1	1
FBgn0261262	302	278	282	258	584	536	TRUE	TRUE	TRUE	1	TRUE	TRUE	1	1
FBgn0261267	26	26	25	16	51	42	TRUE	TRUE	TRUE	1	TRUE	FALSE	0	0
FBgn0261268	248	248	215	198	463	446	TRUE	TRUE	TRUE	1	TRUE	TRUE	1	1
FBgn0261269	267	263	221	193	488	456	TRUE	TRUE	TRUE	1	TRUE	TRUE	1	1
FBgn0261270	75	71	83	67	158	138	TRUE	TRUE	TRUE	1	TRUE	TRUE	1	1
FBgn0261274	275	244	190	226	465	470	TRUE	FALSE	TRUE	0	TRUE	TRUE	1	0
FBgn0261276	215	181	201	168	416	349	FALSE	FALSE	FALSE	0	TRUE	TRUE	1	0
FBgn0261278	159	142	128	104	287	246	TRUE	TRUE	FALSE	0	TRUE	TRUE	1	0
FBgn0261279	492	447	356	363	848	810	TRUE	TRUE	TRUE	1	TRUE	TRUE	1	1
FBgn0261283	109	115	95	77	204	192	TRUE	TRUE	TRUE	1	TRUE	TRUE	1	1
FBgn0261285	295	268	244	212	539	480	TRUE	TRUE	FALSE	0	TRUE	TRUE	1	0
FBgn0261286	167	232	199	166	366	398	FALSE	FALSE	TRUE	0	TRUE	TRUE	1	0
FBgn0261287	254	238	210	163	464	401	TRUE	FALSE	FALSE	0	TRUE	TRUE	1	0
FBgn0261289	54	52	44	33	98	85	TRUE	TRUE	TRUE	1	TRUE	TRUE	1	1
FBgn0261290	37	24	23	11	60	35	TRUE	FALSE	FALSE	0	FALSE	FALSE	0	0
FBgn0261291	56	66	65	43	121	109	TRUE	FALSE	TRUE	0	TRUE	FALSE	0	0
FBgn0261292	104	86	82	92	186	178	TRUE	TRUE	TRUE	1	TRUE	TRUE	1	1
FBgn0261293	80	91	88	95	168	186	TRUE	TRUE	TRUE	1	TRUE	TRUE	1	1
FBgn0261294	31	43	43	33	74	76	TRUE	TRUE	TRUE	1	TRUE	TRUE	1	1
FBgn0261341	163	157	117	136	280	293	TRUE	TRUE	TRUE	1	TRUE	TRUE	1	1
FBgn0261349	85	96	92	73	177	169	TRUE	TRUE	TRUE	1	TRUE	TRUE	1	1
FBgn0261356	92	97	82	96	174	193	TRUE	TRUE	TRUE	1	TRUE	TRUE	1	1
FBgn0261363	201	199	171	173	372	372	TRUE	TRUE	TRUE	1	TRUE	TRUE	1	1
FBgn0261380	65	63	72	58	137	121	TRUE	TRUE	TRUE	1	TRUE	TRUE	1	1
FBgn0261385	78	88	72	68	150	156	TRUE	TRUE	TRUE	1	TRUE	TRUE	1	1
FBgn0261387	119	126	107	114	226	240	TRUE	TRUE	TRUE	1	TRUE	TRUE	1	1
FBgn0261393	29	32	20	23	49	55	TRUE	TRUE	TRUE	1	TRUE	TRUE	1	1
FBgn0261394	137	97	75	89	212	186	FALSE	TRUE	TRUE	0	TRUE	TRUE	1	0
FBgn0261395	58	57	40	46	98	103	TRUE	TRUE	TRUE	1	TRUE	TRUE	1	1
FBgn0261396	38	51	59	49	97	100	TRUE	TRUE	TRUE	1	TRUE	TRUE	1	1
FBgn0261397	173	181	127	148	300	329	TRUE	TRUE	TRUE	1	TRUE	TRUE	1	1
FBgn0261401	163	183	158	185	321	368	TRUE	TRUE	FALSE	0	TRUE	TRUE	1	0
FBgn0261402	176	160	132	124	308	284	TRUE	TRUE	TRUE	1	TRUE	TRUE	1	1
FBgn0261403	109	114	109	75	218	189	TRUE	FALSE	TRUE	0	TRUE	TRUE	1	0
FBgn0261429	204	192	179	170	383	362	TRUE	TRUE	TRUE	1	TRUE	TRUE	1	1
FBgn0261436	44	49	43	30	87	79	TRUE	TRUE	TRUE	1	TRUE	TRUE	1	1
FBgn0261437	101	79	73	69	174	148	TRUE	TRUE	TRUE	1	TRUE	TRUE	1	1
FBgn0261439	245	220	231	176	476	396	TRUE	FALSE	FALSE	0	TRUE	TRUE	1	0
FBgn0261445	176	182	138	162	314	344	TRUE	TRUE	TRUE	1	TRUE	TRUE	1	1
FBgn0261456	214	204	167	167	381	371	TRUE	TRUE	TRUE	1	TRUE	TRUE	1	1
FBgn0261458	254	255	184	200	438	455	TRUE	TRUE	TRUE	1	TRUE	TRUE	1	1
FBgn0261477	200	202	163	141	363	343	TRUE	TRUE	TRUE	1	TRUE	TRUE	1	1
FBgn0261501	44	41	27	28	71	69	TRUE	TRUE	TRUE	1	TRUE	TRUE	1	1
FBgn0261502	46	37	40	31	86	68	TRUE	TRUE	TRUE	1	TRUE	TRUE	1	1
FBgn0261503	110	98	69	77	179	175	TRUE	TRUE	TRUE	1	TRUE	TRUE	1	1
FBgn0261506	41	63	38	40	79	103	FALSE	TRUE	FALSE	0	FALSE	TRUE	0	0
FBgn0261509	638	647	547	571	1185	1218	TRUE	TRUE	TRUE	1	TRUE	TRUE	1	1
FBgn0261514	231	242	194	184	425	426	TRUE	TRUE	TRUE	1	TRUE	TRUE	1	1
FBgn0261523	77	73	64	70	141	143	TRUE	TRUE	TRUE	1	TRUE	TRUE	1	1
FBgn0261526	391	359	299	287	690	646	TRUE	TRUE	TRUE	1	TRUE	TRUE	1	1
FBgn0261529	475	503	382	373	857	876	TRUE	TRUE	TRUE	1	TRUE	TRUE	1	1
FBgn0261530	212	195	164	186	376	381	TRUE	TRUE	TRUE	1	TRUE	TRUE	1	1
FBgn0261532	189	204	125	159	314	363	TRUE	FALSE	FALSE	0	TRUE	TRUE	1	0
FBgn0261534	24	34	36	29	60	63	TRUE	TRUE	TRUE	1	TRUE	TRUE	1	1
FBgn0261535	169	186	158	137	327	323	TRUE	TRUE	TRUE	1	TRUE	TRUE	1	1
FBgn0261545	311	377	264	277	575	654	FALSE	TRUE	FALSE	0	TRUE	TRUE	1	0
FBgn0261547	637	635	499	489	1136	1124	TRUE	TRUE	TRUE	1	TRUE	TRUE	1	1
FBgn0261550	328	299	257	227	585	526	TRUE	TRUE	FALSE	0	TRUE	TRUE	1	0
FBgn0261552	416	415	349	363	765	778	TRUE	TRUE	TRUE	1	TRUE	TRUE	1	1
FBgn0261553	594	620	500	528	1094	1148	TRUE	TRUE	TRUE	1	TRUE	TRUE	1	1
FBgn0261554	320	322	259	268	579	590	TRUE	TRUE	TRUE	1	TRUE	TRUE	1	1
FBgn0261555	434	468	376	361	810	829	TRUE	TRUE	TRUE	1	TRUE	TRUE	1	1
FBgn0261556	473	474	383	383	856	857	TRUE	TRUE	TRUE	1	TRUE	TRUE	1	1
FBgn0261560	91	92	75	84	166	176	TRUE	TRUE	TRUE	1	TRUE	TRUE	1	1
FBgn0261562	152	139	108	98	260	237	TRUE	TRUE	TRUE	1	TRUE	TRUE	1	1
FBgn0261563	1134	1167	870	927	2004	2094	TRUE	TRUE	TRUE	1	TRUE	TRUE	1	1
FBgn0261564	288	271	249	255	537	526	TRUE	TRUE	TRUE	1	TRUE	TRUE	1	1
FBgn0261565	1063	1021	848	842	1911	1863	TRUE	TRUE	TRUE	1	TRUE	TRUE	1	1
FBgn0261566	32	45	40	26	72	71	TRUE	TRUE	TRUE	1	TRUE	FALSE	0	0
FBgn0261567	44	52	48	48	92	100	TRUE	TRUE	TRUE	1	TRUE	TRUE	1	1
FBgn0261571	288	247	254	229	542	476	FALSE	TRUE	FALSE	0	TRUE	TRUE	1	0
FBgn0261574	300	286	243	275	543	561	TRUE	TRUE	TRUE	1	TRUE	TRUE	1	1
FBgn0261575	71	63	48	48	119	111	TRUE	TRUE	TRUE	1	TRUE	TRUE	1	1
FBgn0261581	34	25	29	24	63	49	TRUE	TRUE	TRUE	1	TRUE	TRUE	1	1
FBgn0261582	99	96	70	81	169	177	TRUE	TRUE	TRUE	1	TRUE	TRUE	1	1
FBgn0261583	26	41	26	32	52	73	FALSE	TRUE	FALSE	0	FALSE	TRUE	0	0
FBgn0261584	99	110	79	103	178	213	TRUE	FALSE	FALSE	0	TRUE	TRUE	1	0
FBgn0261586	12	24	21	15	33	39	FALSE	TRUE	TRUE	0	FALSE	TRUE	0	0
FBgn0261587	50	60	45	50	95	110	TRUE	TRUE	TRUE	1	TRUE	TRUE	1	1
FBgn0261588	344	288	225	236	569	524	FALSE	TRUE	TRUE	0	TRUE	TRUE	1	0
FBgn0261596	36	39	25	23	61	62	TRUE	TRUE	TRUE	1	TRUE	TRUE	1	1
FBgn0261597	177	184	168	182	345	366	TRUE	TRUE	TRUE	1	TRUE	TRUE	1	1
FBgn0261599	27	27	20	15	47	42	TRUE	TRUE	TRUE	1	TRUE	TRUE	1	1
FBgn0261602	149	110	105	102	254	212	FALSE	TRUE	FALSE	0	TRUE	TRUE	1	0
FBgn0261608	64	34	38	39	102	73	FALSE	TRUE	FALSE	0	FALSE	TRUE	0	0
FBgn0261611	191	212	215	171	406	383	TRUE	FALSE	TRUE	0	TRUE	TRUE	1	0
FBgn0261612	527	516	443	440	970	956	TRUE	TRUE	TRUE	1	TRUE	TRUE	1	1
FBgn0261614	64	70	40	60	104	130	TRUE	FALSE	TRUE	0	TRUE	TRUE	1	0
FBgn0261618	501	526	450	438	951	964	TRUE	TRUE	TRUE	1	TRUE	TRUE	1	1
FBgn0261625	389	371	382	338	771	709	TRUE	TRUE	TRUE	1	TRUE	TRUE	1	1
FBgn0261627	76	65	53	48	129	113	TRUE	TRUE	TRUE	1	TRUE	TRUE	1	1
FBgn0261628	129	121	90	104	219	225	TRUE	TRUE	TRUE	1	TRUE	TRUE	1	1
FBgn0261630	104	121	83	109	187	230	TRUE	FALSE	FALSE	0	TRUE	TRUE	1	0
FBgn0261631	52	36	35	43	87	79	TRUE	TRUE	TRUE	1	TRUE	TRUE	1	1
FBgn0261632	47	69	41	51	88	120	FALSE	TRUE	FALSE	0	TRUE	TRUE	1	0
FBgn0261633	70	72	60	46	130	118	TRUE	TRUE	TRUE	1	TRUE	TRUE	1	1
FBgn0261634	27	28	15	23	42	51	TRUE	TRUE	TRUE	1	TRUE	FALSE	0	0
FBgn0261635	79	51	67	56	146	107	FALSE	TRUE	FALSE	0	FALSE	TRUE	0	0
FBgn0261636	57	53	43	44	100	97	TRUE	TRUE	TRUE	1	TRUE	TRUE	1	1
FBgn0261638	104	95	90	84	194	179	TRUE	TRUE	TRUE	1	TRUE	TRUE	1	1
FBgn0261641	121	126	92	107	213	233	TRUE	TRUE	TRUE	1	TRUE	TRUE	1	1
FBgn0261647	298	236	230	209	528	445	FALSE	TRUE	FALSE	0	TRUE	TRUE	1	0
FBgn0261648	377	350	336	326	713	676	TRUE	TRUE	TRUE	1	TRUE	TRUE	1	1
FBgn0261649	717	689	597	563	1314	1252	TRUE	TRUE	TRUE	1	TRUE	TRUE	1	1
FBgn0261671	710	732	548	588	1258	1320	TRUE	TRUE	TRUE	1	TRUE	TRUE	1	1
FBgn0261673	326	329	259	260	585	589	TRUE	TRUE	TRUE	1	TRUE	TRUE	1	1
FBgn0261674	203	191	201	155	404	346	TRUE	FALSE	FALSE	0	TRUE	TRUE	1	0
FBgn0261681	32	21	22	21	54	42	TRUE	TRUE	TRUE	1	FALSE	TRUE	0	0
FBgn0261682	30	21	27	16	57	37	TRUE	TRUE	FALSE	0	TRUE	FALSE	0	0
FBgn0261686	46	59	43	33	89	92	TRUE	TRUE	TRUE	1	TRUE	TRUE	1	1
FBgn0261698	665	665	570	475	1235	1140	TRUE	FALSE	FALSE	0	TRUE	TRUE	1	0
FBgn0261700	63	74	56	55	119	129	TRUE	TRUE	TRUE	1	TRUE	TRUE	1	1
FBgn0261705	258	268	207	194	465	462	TRUE	TRUE	TRUE	1	TRUE	TRUE	1	1
FBgn0261707	59	58	68	58	127	116	TRUE	TRUE	TRUE	1	TRUE	TRUE	1	1
FBgn0261709	18	19	24	15	42	34	TRUE	TRUE	TRUE	1	TRUE	FALSE	0	0
FBgn0261714	224	224	188	175	412	399	TRUE	TRUE	TRUE	1	TRUE	TRUE	1	1
FBgn0261722	203	209	164	177	367	386	TRUE	TRUE	TRUE	1	TRUE	TRUE	1	1
FBgn0261723	243	270	193	199	436	469	TRUE	TRUE	TRUE	1	TRUE	TRUE	1	1
FBgn0261786	248	237	183	213	431	450	TRUE	TRUE	TRUE	1	TRUE	TRUE	1	1
FBgn0261787	188	182	170	165	358	347	TRUE	TRUE	TRUE	1	TRUE	TRUE	1	1
FBgn0261788	1853	1662	1547	1441	3400	3103	FALSE	FALSE	FALSE	0	TRUE	TRUE	1	0
FBgn0261792	74	98	75	73	149	171	FALSE	TRUE	TRUE	0	TRUE	TRUE	1	0
FBgn0261794	314	332	283	300	597	632	TRUE	TRUE	TRUE	1	TRUE	TRUE	1	1
FBgn0261797	875	858	653	664	1528	1522	TRUE	TRUE	TRUE	1	TRUE	TRUE	1	1
FBgn0261799	279	289	222	214	501	503	TRUE	TRUE	TRUE	1	TRUE	TRUE	1	1
FBgn0261800	543	528	457	413	1000	941	TRUE	TRUE	TRUE	1	TRUE	TRUE	1	1
FBgn0261801	271	262	254	249	525	511	TRUE	TRUE	TRUE	1	TRUE	TRUE	1	1
FBgn0261802	713	716	597	578	1310	1294	TRUE	TRUE	TRUE	1	TRUE	TRUE	1	1
FBgn0261804	408	420	330	347	738	767	TRUE	TRUE	TRUE	1	TRUE	TRUE	1	1
FBgn0261805	71	72	71	59	142	131	TRUE	TRUE	TRUE	1	TRUE	TRUE	1	1
FBgn0261806	86	80	64	64	150	144	TRUE	TRUE	TRUE	1	TRUE	TRUE	1	1
FBgn0261807	55	53	46	52	101	105	TRUE	TRUE	TRUE	1	TRUE	TRUE	1	1
FBgn0261808	198	232	177	186	375	418	TRUE	TRUE	TRUE	1	TRUE	TRUE	1	1
FBgn0261816	104	109	72	79	176	188	TRUE	TRUE	TRUE	1	TRUE	TRUE	1	1
FBgn0261817	27	20	20	17	47	37	TRUE	TRUE	TRUE	1	TRUE	TRUE	1	1
FBgn0261822	726	708	556	575	1282	1283	TRUE	TRUE	TRUE	1	TRUE	TRUE	1	1
FBgn0261823	377	353	307	302	684	655	TRUE	TRUE	TRUE	1	TRUE	TRUE	1	1
FBgn0261830	60	68	73	61	133	129	TRUE	TRUE	TRUE	1	TRUE	TRUE	1	1
FBgn0261831	46	72	56	59	102	131	FALSE	TRUE	FALSE	0	FALSE	TRUE	0	0
FBgn0261832	31	23	29	32	60	55	TRUE	TRUE	TRUE	1	TRUE	TRUE	1	1
FBgn0261833	55	75	67	65	122	140	FALSE	TRUE	TRUE	0	TRUE	TRUE	1	0
FBgn0261836	4927	5046	4309	4232	9236	9278	TRUE	TRUE	TRUE	1	TRUE	TRUE	1	1
FBgn0261847	35	48	33	34	68	82	TRUE	TRUE	TRUE	1	TRUE	TRUE	1	1
FBgn0261850	259	287	205	211	464	498	TRUE	TRUE	TRUE	1	TRUE	TRUE	1	1
FBgn0261853	95	109	78	106	173	215	TRUE	FALSE	FALSE	0	TRUE	TRUE	1	0
FBgn0261854	546	590	477	486	1023	1076	TRUE	TRUE	TRUE	1	TRUE	TRUE	1	1
FBgn0261857	93	70	77	66	170	136	FALSE	TRUE	FALSE	0	TRUE	TRUE	1	0
FBgn0261858	44	39	21	27	65	66	TRUE	TRUE	TRUE	1	TRUE	TRUE	1	1
FBgn0261859	241	255	199	221	440	476	TRUE	TRUE	TRUE	1	TRUE	TRUE	1	1
FBgn0261860	81	84	79	56	160	140	TRUE	FALSE	TRUE	0	TRUE	TRUE	1	0
FBgn0261861	133	124	97	89	230	213	TRUE	TRUE	TRUE	1	TRUE	TRUE	1	1
FBgn0261862	256	278	211	202	467	480	TRUE	TRUE	TRUE	1	TRUE	TRUE	1	1
FBgn0261871	309	283	239	264	548	547	TRUE	TRUE	TRUE	1	TRUE	TRUE	1	1
FBgn0261872	288	327	273	277	561	604	TRUE	TRUE	TRUE	1	TRUE	TRUE	1	1
FBgn0261881	56	47	53	34	109	81	TRUE	FALSE	FALSE	0	TRUE	FALSE	0	0
FBgn0261885	593	665	478	491	1071	1156	FALSE	TRUE	FALSE	0	TRUE	TRUE	1	0
FBgn0261925	49	55	46	51	95	106	TRUE	TRUE	TRUE	1	TRUE	TRUE	1	1
FBgn0261928	240	168	175	193	415	361	FALSE	TRUE	FALSE	0	TRUE	TRUE	1	0
FBgn0261929	209	191	158	178	367	369	TRUE	TRUE	TRUE	1	TRUE	TRUE	1	1
FBgn0261932	115	92	78	70	193	162	TRUE	TRUE	TRUE	1	TRUE	TRUE	1	1
FBgn0261933	71	82	71	70	142	152	TRUE	TRUE	TRUE	1	TRUE	TRUE	1	1
FBgn0261934	549	558	481	453	1030	1011	TRUE	TRUE	TRUE	1	TRUE	TRUE	1	1
FBgn0261938	376	416	274	305	650	721	TRUE	TRUE	FALSE	0	TRUE	TRUE	1	0
FBgn0261952	61	63	71	43	132	106	TRUE	FALSE	TRUE	0	TRUE	FALSE	0	0
FBgn0261953	94	90	78	78	172	168	TRUE	TRUE	TRUE	1	TRUE	TRUE	1	1
FBgn0261963	302	310	243	225	545	535	TRUE	TRUE	TRUE	1	TRUE	TRUE	1	1
FBgn0261975	22	23	25	27	47	50	TRUE	TRUE	TRUE	1	TRUE	TRUE	1	1
FBgn0261976	79	94	59	60	138	154	TRUE	TRUE	TRUE	1	TRUE	TRUE	1	1
FBgn0261983	190	169	146	150	336	319	TRUE	TRUE	TRUE	1	TRUE	TRUE	1	1
FBgn0261984	302	277	218	238	520	515	TRUE	TRUE	TRUE	1	TRUE	TRUE	1	1
FBgn0261985	235	225	196	192	431	417	TRUE	TRUE	TRUE	1	TRUE	TRUE	1	1
FBgn0261986	203	196	151	170	354	366	TRUE	TRUE	TRUE	1	TRUE	TRUE	1	1
FBgn0261987	270	303	269	249	539	552	TRUE	TRUE	TRUE	1	TRUE	TRUE	1	1
FBgn0261988	173	167	157	147	330	314	TRUE	TRUE	TRUE	1	TRUE	TRUE	1	1
FBgn0261989	239	230	179	182	418	412	TRUE	TRUE	TRUE	1	TRUE	TRUE	1	1
FBgn0261990	51	47	42	41	93	88	TRUE	TRUE	TRUE	1	TRUE	TRUE	1	1
FBgn0261991	73	62	55	65	128	127	TRUE	TRUE	TRUE	1	TRUE	TRUE	1	1
FBgn0261992	76	88	68	62	144	150	TRUE	TRUE	TRUE	1	TRUE	TRUE	1	1
FBgn0261993	45	38	40	40	85	78	TRUE	TRUE	TRUE	1	TRUE	TRUE	1	1
FBgn0261994	33	49	40	35	73	84	FALSE	TRUE	TRUE	0	TRUE	TRUE	1	0
FBgn0261995	110	90	69	78	179	168	TRUE	TRUE	TRUE	1	TRUE	TRUE	1	1
FBgn0261996	60	75	57	40	117	115	TRUE	TRUE	TRUE	1	TRUE	TRUE	1	1
FBgn0261998	220	205	183	189	403	394	TRUE	TRUE	TRUE	1	TRUE	TRUE	1	1
FBgn0261999	488	492	405	431	893	923	TRUE	TRUE	TRUE	1	TRUE	TRUE	1	1
FBgn0262000	252	258	265	217	517	475	TRUE	FALSE	TRUE	0	TRUE	TRUE	1	0
FBgn0262001	45	50	42	33	87	83	TRUE	TRUE	TRUE	1	TRUE	TRUE	1	1
FBgn0262002	208	216	184	164	392	380	TRUE	TRUE	TRUE	1	TRUE	TRUE	1	1
FBgn0262003	69	155	80	126	149	281	FALSE	FALSE	FALSE	0	FALSE	FALSE	0	0
FBgn0262004	90	181	77	166	167	347	FALSE	FALSE	FALSE	0	FALSE	FALSE	0	0
FBgn0262005	47	67	50	33	97	100	FALSE	FALSE	TRUE	0	TRUE	FALSE	0	0
FBgn0262006	64	66	44	58	108	124	TRUE	TRUE	TRUE	1	TRUE	TRUE	1	1
FBgn0262007	174	166	148	172	322	338	TRUE	TRUE	TRUE	1	TRUE	TRUE	1	1
FBgn0262008	114	126	98	98	212	224	TRUE	TRUE	TRUE	1	TRUE	TRUE	1	1
FBgn0262009	82	74	73	72	155	146	TRUE	TRUE	TRUE	1	TRUE	TRUE	1	1
FBgn0262010	56	55	35	43	91	98	TRUE	TRUE	TRUE	1	TRUE	TRUE	1	1
FBgn0262017	67	91	70	65	137	156	FALSE	TRUE	TRUE	0	TRUE	TRUE	1	0
FBgn0262018	553	517	485	523	1038	1040	TRUE	TRUE	TRUE	1	TRUE	TRUE	1	1
FBgn0262020	102	126	88	131	190	257	TRUE	FALSE	FALSE	0	TRUE	TRUE	1	0
FBgn0262021	35	34	25	34	60	68	TRUE	TRUE	TRUE	1	TRUE	TRUE	1	1
FBgn0262023	82	131	64	114	146	245	FALSE	FALSE	FALSE	0	FALSE	FALSE	0	0
FBgn0262024	70	58	48	42	118	100	TRUE	TRUE	TRUE	1	TRUE	TRUE	1	1
FBgn0262025	34	52	57	44	91	96	FALSE	TRUE	TRUE	0	FALSE	TRUE	0	0
FBgn0262027	39	39	27	31	66	70	TRUE	TRUE	TRUE	1	TRUE	TRUE	1	1
FBgn0262028	198	164	126	136	324	300	FALSE	TRUE	TRUE	0	TRUE	TRUE	1	0
FBgn0262029	371	385	345	337	716	722	TRUE	TRUE	TRUE	1	TRUE	TRUE	1	1
FBgn0262030	130	151	132	123	262	274	TRUE	TRUE	TRUE	1	TRUE	TRUE	1	1
FBgn0262033	62	68	62	48	124	116	TRUE	TRUE	TRUE	1	TRUE	TRUE	1	1
FBgn0262036	57	53	50	37	107	90	TRUE	TRUE	TRUE	1	TRUE	TRUE	1	1
FBgn0262057	29	24	18	23	47	47	TRUE	TRUE	TRUE	1	TRUE	TRUE	1	1
FBgn0262081	236	204	166	203	402	407	TRUE	FALSE	TRUE	0	TRUE	TRUE	1	0
FBgn0262097	161	137	133	153	294	290	TRUE	TRUE	TRUE	1	TRUE	TRUE	1	1
FBgn0262098	57	59	43	55	100	114	TRUE	TRUE	TRUE	1	TRUE	TRUE	1	1
FBgn0262099	63	53	48	35	111	88	TRUE	TRUE	TRUE	1	TRUE	TRUE	1	1
FBgn0262100	61	51	36	39	97	90	TRUE	TRUE	TRUE	1	TRUE	TRUE	1	1
FBgn0262102	60	74	55	66	115	140	TRUE	TRUE	TRUE	1	TRUE	TRUE	1	1
FBgn0262103	457	435	357	354	814	789	TRUE	TRUE	TRUE	1	TRUE	TRUE	1	1
FBgn0262106	142	133	110	131	252	264	TRUE	TRUE	TRUE	1	TRUE	TRUE	1	1
FBgn0262107	36	26	18	23	54	49	TRUE	TRUE	TRUE	1	TRUE	TRUE	1	1
FBgn0262112	110	89	82	92	192	181	TRUE	TRUE	TRUE	1	TRUE	TRUE	1	1
FBgn0262114	225	194	168	146	393	340	TRUE	TRUE	FALSE	0	TRUE	TRUE	1	0
FBgn0262115	62	65	42	41	104	106	TRUE	TRUE	TRUE	1	TRUE	TRUE	1	1
FBgn0262116	62	47	47	52	109	99	TRUE	TRUE	TRUE	1	TRUE	TRUE	1	1
FBgn0262117	89	90	68	71	157	161	TRUE	TRUE	TRUE	1	TRUE	TRUE	1	1
FBgn0262124	120	102	105	102	225	204	TRUE	TRUE	TRUE	1	TRUE	TRUE	1	1
FBgn0262125	35	25	31	23	66	48	TRUE	TRUE	TRUE	1	TRUE	TRUE	1	1
FBgn0262126	270	277	200	216	470	493	TRUE	TRUE	TRUE	1	TRUE	TRUE	1	1
FBgn0262127	276	280	193	208	469	488	TRUE	TRUE	TRUE	1	TRUE	TRUE	1	1
FBgn0262139	349	353	294	322	643	675	TRUE	TRUE	TRUE	1	TRUE	TRUE	1	1
FBgn0262140	46	43	36	37	82	80	TRUE	TRUE	TRUE	1	TRUE	TRUE	1	1
FBgn0262141	29	47	35	44	64	91	FALSE	TRUE	FALSE	0	FALSE	TRUE	0	0
FBgn0262143	30	24	46	32	76	56	TRUE	TRUE	FALSE	0	TRUE	TRUE	1	0
FBgn0262144	49	42	36	42	85	84	TRUE	TRUE	TRUE	1	TRUE	TRUE	1	1
FBgn0262146	98	79	74	64	172	143	TRUE	TRUE	TRUE	1	TRUE	TRUE	1	1
FBgn0262148	136	135	126	118	262	253	TRUE	TRUE	TRUE	1	TRUE	TRUE	1	1
FBgn0262149	36	49	39	38	75	87	TRUE	TRUE	TRUE	1	TRUE	TRUE	1	1
FBgn0262150	132	116	118	106	250	222	TRUE	TRUE	TRUE	1	TRUE	TRUE	1	1
FBgn0262160	290	334	238	263	528	597	FALSE	TRUE	FALSE	0	TRUE	TRUE	1	0
FBgn0262166	115	122	112	88	227	210	TRUE	TRUE	TRUE	1	TRUE	TRUE	1	1
FBgn0262167	321	323	264	247	585	570	TRUE	TRUE	TRUE	1	TRUE	TRUE	1	1
FBgn0262169	115	119	112	92	227	211	TRUE	TRUE	TRUE	1	TRUE	TRUE	1	1
FBgn0262170	58	44	47	64	105	108	TRUE	TRUE	TRUE	1	TRUE	TRUE	1	1
FBgn0262203	36	25	32	25	68	50	TRUE	TRUE	TRUE	1	TRUE	TRUE	1	1
FBgn0262215	28	33	28	15	56	48	TRUE	FALSE	TRUE	0	TRUE	FALSE	0	0
FBgn0262307	20	24	14	20	34	44	TRUE	TRUE	TRUE	1	TRUE	TRUE	1	1
FBgn0262327	41	25	28	28	69	53	FALSE	TRUE	TRUE	0	FALSE	TRUE	0	0
FBgn0262351	69	72	55	57	124	129	TRUE	TRUE	TRUE	1	TRUE	TRUE	1	1
FBgn0262352	136	144	110	126	246	270	TRUE	TRUE	TRUE	1	TRUE	TRUE	1	1
FBgn0262353	34	43	22	26	56	69	TRUE	TRUE	TRUE	1	TRUE	TRUE	1	1
FBgn0262354	55	47	47	59	102	106	TRUE	TRUE	TRUE	1	TRUE	TRUE	1	1
FBgn0262355	69	38	57	63	126	101	FALSE	TRUE	TRUE	0	FALSE	TRUE	0	0
FBgn0262356	73	60	56	54	129	114	TRUE	TRUE	TRUE	1	TRUE	TRUE	1	1
FBgn0262357	79	82	69	78	148	160	TRUE	TRUE	TRUE	1	TRUE	TRUE	1	1
FBgn0262358	49	54	75	47	124	101	TRUE	FALSE	TRUE	0	TRUE	FALSE	0	0
FBgn0262359	71	51	36	34	107	85	FALSE	TRUE	TRUE	0	TRUE	TRUE	1	0
FBgn0262360	29	39	31	42	60	81	TRUE	TRUE	FALSE	0	TRUE	TRUE	1	0
FBgn0262361	53	51	47	47	100	98	TRUE	TRUE	TRUE	1	TRUE	TRUE	1	1
FBgn0262362	38	45	36	69	74	114	TRUE	FALSE	FALSE	0	TRUE	FALSE	0	0
FBgn0262363	50	55	57	48	107	103	TRUE	TRUE	TRUE	1	TRUE	TRUE	1	1
FBgn0262364	42	33	24	43	66	76	TRUE	FALSE	TRUE	0	TRUE	FALSE	0	0
FBgn0262365	62	54	52	51	114	105	TRUE	TRUE	TRUE	1	TRUE	TRUE	1	1
FBgn0262366	240	249	170	176	410	425	TRUE	TRUE	TRUE	1	TRUE	TRUE	1	1
FBgn0262400	26	16	16	20	42	36	TRUE	TRUE	TRUE	1	FALSE	TRUE	0	0
FBgn0262401	34	29	20	29	54	58	TRUE	TRUE	TRUE	1	TRUE	TRUE	1	1
FBgn0262415	8	41	17	27	25	68	FALSE	TRUE	FALSE	0	FALSE	FALSE	0	0
FBgn0262416	39	31	33	21	72	52	TRUE	TRUE	FALSE	0	TRUE	FALSE	0	0
FBgn0262437	37	31	32	39	69	70	TRUE	TRUE	TRUE	1	TRUE	TRUE	1	1
FBgn0262440	23	16	33	18	56	34	TRUE	FALSE	FALSE	0	TRUE	FALSE	0	0
FBgn0262446	39	31	33	27	72	58	TRUE	TRUE	TRUE	1	TRUE	TRUE	1	1
FBgn0262467	25	33	23	13	48	46	TRUE	TRUE	TRUE	1	TRUE	FALSE	0	0
FBgn0262473	314	363	256	268	570	631	FALSE	TRUE	FALSE	0	TRUE	TRUE	1	0
FBgn0262475	634	752	591	544	1225	1296	FALSE	TRUE	TRUE	0	TRUE	TRUE	1	0
FBgn0262476	419	376	360	322	779	698	TRUE	TRUE	FALSE	0	TRUE	TRUE	1	0
FBgn0262477	118	148	131	122	249	270	FALSE	TRUE	TRUE	0	TRUE	TRUE	1	0
FBgn0262478	48	58	37	40	85	98	TRUE	TRUE	TRUE	1	TRUE	TRUE	1	1
FBgn0262479	48	41	29	31	77	72	TRUE	TRUE	TRUE	1	TRUE	TRUE	1	1
FBgn0262480	85	70	60	52	145	122	TRUE	TRUE	TRUE	1	TRUE	TRUE	1	1
FBgn0262481	37	35	38	22	75	57	TRUE	FALSE	TRUE	0	TRUE	FALSE	0	0
FBgn0262483	319	321	267	234	586	555	TRUE	TRUE	TRUE	1	TRUE	TRUE	1	1
FBgn0262484	100	99	88	93	188	192	TRUE	TRUE	TRUE	1	TRUE	TRUE	1	1
FBgn0262508	1117	1082	933	869	2050	1951	TRUE	TRUE	TRUE	1	TRUE	TRUE	1	1
FBgn0262509	579	568	478	437	1057	1005	TRUE	TRUE	TRUE	1	TRUE	TRUE	1	1
FBgn0262511	323	320	252	245	575	565	TRUE	TRUE	TRUE	1	TRUE	TRUE	1	1
FBgn0262514	27	28	17	18	44	46	TRUE	TRUE	TRUE	1	TRUE	TRUE	1	1
FBgn0262515	123	127	101	95	224	222	TRUE	TRUE	TRUE	1	TRUE	TRUE	1	1
FBgn0262517	68	64	48	56	116	120	TRUE	TRUE	TRUE	1	TRUE	TRUE	1	1
FBgn0262518	142	132	94	134	236	266	TRUE	FALSE	TRUE	0	TRUE	TRUE	1	0
FBgn0262519	122	102	98	112	220	214	TRUE	TRUE	TRUE	1	TRUE	TRUE	1	1
FBgn0262524	58	50	37	42	95	92	TRUE	TRUE	TRUE	1	TRUE	TRUE	1	1
FBgn0262527	65	79	60	70	125	149	TRUE	TRUE	TRUE	1	TRUE	TRUE	1	1
FBgn0262528	55	54	62	44	117	98	TRUE	FALSE	TRUE	0	TRUE	TRUE	1	0
FBgn0262529	60	42	49	32	109	74	FALSE	FALSE	FALSE	0	TRUE	FALSE	0	0
FBgn0262530	61	46	51	31	112	77	TRUE	FALSE	FALSE	0	TRUE	FALSE	0	0
FBgn0262531	83	80	70	58	153	138	TRUE	TRUE	TRUE	1	TRUE	TRUE	1	1
FBgn0262532	51	33	30	29	81	62	FALSE	TRUE	TRUE	0	FALSE	TRUE	0	0
FBgn0262533	67	57	73	47	140	104	TRUE	FALSE	FALSE	0	TRUE	FALSE	0	0
FBgn0262535	54	74	55	52	109	126	FALSE	TRUE	TRUE	0	TRUE	TRUE	1	0
FBgn0262537	57	45	44	56	101	101	TRUE	TRUE	TRUE	1	TRUE	TRUE	1	1
FBgn0262539	34	34	28	45	62	79	TRUE	FALSE	TRUE	0	TRUE	FALSE	0	0
FBgn0262540	41	28	34	24	75	52	TRUE	TRUE	FALSE	0	TRUE	TRUE	1	0
FBgn0262541	77	84	72	64	149	148	TRUE	TRUE	TRUE	1	TRUE	TRUE	1	1
FBgn0262542	55	32	61	27	116	59	FALSE	FALSE	FALSE	0	FALSE	FALSE	0	0
FBgn0262543	75	69	84	72	159	141	TRUE	TRUE	TRUE	1	TRUE	TRUE	1	1
FBgn0262544	38	46	36	43	74	89	TRUE	TRUE	TRUE	1	TRUE	TRUE	1	1
FBgn0262546	61	67	39	46	100	113	TRUE	TRUE	TRUE	1	TRUE	TRUE	1	1
FBgn0262547	35	48	27	21	62	69	TRUE	TRUE	TRUE	1	TRUE	TRUE	1	1
FBgn0262559	134	155	95	115	229	270	TRUE	TRUE	FALSE	0	TRUE	TRUE	1	0
FBgn0262560	100	128	80	90	180	218	FALSE	TRUE	FALSE	0	TRUE	TRUE	1	0
FBgn0262562	729	667	571	606	1300	1273	TRUE	TRUE	TRUE	1	TRUE	TRUE	1	1
FBgn0262563	36	24	22	18	58	42	TRUE	TRUE	TRUE	1	TRUE	TRUE	1	1
FBgn0262564	134	109	93	108	227	217	TRUE	TRUE	TRUE	1	TRUE	TRUE	1	1
FBgn0262565	24	46	36	28	60	74	FALSE	TRUE	TRUE	0	FALSE	TRUE	0	0
FBgn0262568	113	88	83	82	196	170	FALSE	TRUE	TRUE	0	TRUE	TRUE	1	0
FBgn0262570	322	346	253	255	575	601	TRUE	TRUE	TRUE	1	TRUE	TRUE	1	1
FBgn0262571	53	75	58	50	111	125	FALSE	TRUE	TRUE	0	TRUE	TRUE	1	0
FBgn0262572	68	52	47	68	115	120	TRUE	FALSE	TRUE	0	TRUE	TRUE	1	0
FBgn0262576	54	51	41	31	95	82	TRUE	TRUE	TRUE	1	TRUE	TRUE	1	1
FBgn0262577	38	49	37	34	75	83	TRUE	TRUE	TRUE	1	TRUE	TRUE	1	1
FBgn0262579	763	796	640	648	1403	1444	TRUE	TRUE	TRUE	1	TRUE	TRUE	1	1
FBgn0262580	45	76	53	49	98	125	FALSE	TRUE	FALSE	0	FALSE	TRUE	0	0
FBgn0262581	68	90	62	63	130	153	FALSE	TRUE	TRUE	0	TRUE	TRUE	1	0
FBgn0262582	571	591	499	489	1070	1080	TRUE	TRUE	TRUE	1	TRUE	TRUE	1	1
FBgn0262583	86	70	83	62	169	132	TRUE	FALSE	FALSE	0	TRUE	TRUE	1	0
FBgn0262587	71	80	73	61	144	141	TRUE	TRUE	TRUE	1	TRUE	TRUE	1	1
FBgn0262588	79	83	77	72	156	155	TRUE	TRUE	TRUE	1	TRUE	TRUE	1	1
FBgn0262592	109	96	99	81	208	177	TRUE	TRUE	TRUE	1	TRUE	TRUE	1	1
FBgn0262593	838	733	661	670	1499	1403	FALSE	TRUE	FALSE	0	TRUE	TRUE	1	0
FBgn0262594	82	74	61	63	143	137	TRUE	TRUE	TRUE	1	TRUE	TRUE	1	1
FBgn0262595	71	68	43	58	114	126	TRUE	TRUE	TRUE	1	TRUE	TRUE	1	1
FBgn0262598	138	144	119	133	257	277	TRUE	TRUE	TRUE	1	TRUE	TRUE	1	1
FBgn0262599	227	227	181	166	408	393	TRUE	TRUE	TRUE	1	TRUE	TRUE	1	1
FBgn0262601	89	90	74	65	163	155	TRUE	TRUE	TRUE	1	TRUE	TRUE	1	1
FBgn0262604	55	39	37	40	92	79	TRUE	TRUE	TRUE	1	TRUE	TRUE	1	1
FBgn0262605	59	67	55	47	114	114	TRUE	TRUE	TRUE	1	TRUE	TRUE	1	1
FBgn0262613	59	54	44	41	103	95	TRUE	TRUE	TRUE	1	TRUE	TRUE	1	1
FBgn0262614	666	681	535	542	1201	1223	TRUE	TRUE	TRUE	1	TRUE	TRUE	1	1
FBgn0262616	19	21	18	24	37	45	TRUE	TRUE	TRUE	1	TRUE	TRUE	1	1
FBgn0262617	394	385	326	292	720	677	TRUE	TRUE	TRUE	1	TRUE	TRUE	1	1
FBgn0262619	173	174	126	138	299	312	TRUE	TRUE	TRUE	1	TRUE	TRUE	1	1
FBgn0262620	39	48	20	18	59	66	TRUE	TRUE	TRUE	1	TRUE	TRUE	1	1
FBgn0262621	23	25	19	20	42	45	TRUE	TRUE	TRUE	1	TRUE	TRUE	1	1
FBgn0262622	56	63	45	52	101	115	TRUE	TRUE	TRUE	1	TRUE	TRUE	1	1
FBgn0262623	54	50	45	36	99	86	TRUE	TRUE	TRUE	1	TRUE	TRUE	1	1
FBgn0262624	228	219	164	162	392	381	TRUE	TRUE	TRUE	1	TRUE	TRUE	1	1
FBgn0262631	37	45	38	43	75	88	TRUE	TRUE	TRUE	1	TRUE	TRUE	1	1
FBgn0262636	105	100	106	100	211	200	TRUE	TRUE	TRUE	1	TRUE	TRUE	1	1
FBgn0262647	322	310	253	274	575	584	TRUE	TRUE	TRUE	1	TRUE	TRUE	1	1
FBgn0262683	88	84	76	74	164	158	TRUE	TRUE	TRUE	1	TRUE	TRUE	1	1
FBgn0262688	35	40	39	33	74	73	TRUE	TRUE	TRUE	1	TRUE	TRUE	1	1
FBgn0262690	74	71	44	71	118	142	TRUE	FALSE	TRUE	0	TRUE	FALSE	0	0
FBgn0262714	228	217	193	165	421	382	TRUE	TRUE	TRUE	1	TRUE	TRUE	1	1
FBgn0262716	124	103	108	79	232	182	TRUE	FALSE	FALSE	0	TRUE	TRUE	1	0
FBgn0262717	277	292	235	221	512	513	TRUE	TRUE	TRUE	1	TRUE	TRUE	1	1
FBgn0262719	632	606	497	508	1129	1114	TRUE	TRUE	TRUE	1	TRUE	TRUE	1	1
FBgn0262721	48	33	20	23	68	56	TRUE	TRUE	TRUE	1	TRUE	TRUE	1	1
FBgn0262722	39	29	35	19	74	48	TRUE	FALSE	FALSE	0	TRUE	FALSE	0	0
FBgn0262728	131	129	107	109	238	238	TRUE	TRUE	TRUE	1	TRUE	TRUE	1	1
FBgn0262732	56	53	51	57	107	110	TRUE	TRUE	TRUE	1	TRUE	TRUE	1	1
FBgn0262733	304	295	258	262	562	557	TRUE	TRUE	TRUE	1	TRUE	TRUE	1	1
FBgn0262736	102	89	64	77	166	166	TRUE	TRUE	TRUE	1	TRUE	TRUE	1	1
FBgn0262737	388	366	327	264	715	630	TRUE	FALSE	FALSE	0	TRUE	TRUE	1	0
FBgn0262739	481	494	382	412	863	906	TRUE	TRUE	TRUE	1	TRUE	TRUE	1	1
FBgn0262741	373	357	283	303	656	660	TRUE	TRUE	TRUE	1	TRUE	TRUE	1	1
FBgn0262743	290	285	209	219	499	504	TRUE	TRUE	TRUE	1	TRUE	TRUE	1	1
FBgn0262782	174	151	101	116	275	267	TRUE	TRUE	TRUE	1	TRUE	TRUE	1	1
FBgn0262786	36	32	21	29	57	61	TRUE	TRUE	TRUE	1	TRUE	TRUE	1	1
FBgn0262787	118	99	80	89	198	188	TRUE	TRUE	TRUE	1	TRUE	TRUE	1	1
FBgn0262788	17	23	27	17	44	40	TRUE	TRUE	TRUE	1	TRUE	FALSE	0	0
FBgn0262789	59	67	52	55	111	122	TRUE	TRUE	TRUE	1	TRUE	TRUE	1	1
FBgn0262794	49	62	46	43	95	105	TRUE	TRUE	TRUE	1	TRUE	TRUE	1	1
FBgn0262801	44	37	29	27	73	64	TRUE	TRUE	TRUE	1	TRUE	TRUE	1	1
FBgn0262806	17	29	26	28	43	57	TRUE	TRUE	TRUE	1	FALSE	TRUE	0	0
FBgn0262808	69	97	59	61	128	158	FALSE	TRUE	FALSE	0	TRUE	TRUE	1	0
FBgn0262812	62	60	60	42	122	102	TRUE	FALSE	TRUE	0	TRUE	TRUE	1	0
FBgn0262813	52	48	56	47	108	95	TRUE	TRUE	TRUE	1	TRUE	TRUE	1	1
FBgn0262814	67	74	59	55	126	129	TRUE	TRUE	TRUE	1	TRUE	TRUE	1	1
FBgn0262815	44	43	30	40	74	83	TRUE	TRUE	TRUE	1	TRUE	TRUE	1	1
FBgn0262816	415	457	336	354	751	811	TRUE	TRUE	TRUE	1	TRUE	TRUE	1	1
FBgn0262817	44	54	42	44	86	98	TRUE	TRUE	TRUE	1	TRUE	TRUE	1	1
FBgn0262820	82	73	75	45	157	118	TRUE	FALSE	FALSE	0	TRUE	FALSE	0	0
FBgn0262821	76	76	67	84	143	160	TRUE	TRUE	TRUE	1	TRUE	TRUE	1	1
FBgn0262825	26	22	23	33	49	55	TRUE	TRUE	TRUE	1	TRUE	TRUE	1	1
FBgn0262838	20	23	30	19	50	42	TRUE	TRUE	TRUE	1	TRUE	FALSE	0	0
FBgn0262839	60	50	49	56	109	106	TRUE	TRUE	TRUE	1	TRUE	TRUE	1	1
FBgn0262842	24	23	14	25	38	48	TRUE	TRUE	TRUE	1	TRUE	FALSE	0	0
FBgn0262843	35	40	36	41	71	81	TRUE	TRUE	TRUE	1	TRUE	TRUE	1	1
FBgn0262844	49	80	50	43	99	123	FALSE	TRUE	TRUE	0	FALSE	TRUE	0	0
FBgn0262845	62	49	44	27	106	76	TRUE	FALSE	FALSE	0	TRUE	FALSE	0	0
FBgn0262854	34	36	41	26	75	62	TRUE	FALSE	TRUE	0	TRUE	FALSE	0	0
FBgn0262855	29	48	28	28	57	76	FALSE	TRUE	TRUE	0	FALSE	TRUE	0	0
FBgn0262858	29	29	17	24	46	53	TRUE	TRUE	TRUE	1	TRUE	TRUE	1	1
FBgn0262867	203	249	184	199	387	448	FALSE	TRUE	FALSE	0	TRUE	TRUE	1	0
FBgn0262869	458	416	352	401	810	817	TRUE	FALSE	TRUE	0	TRUE	TRUE	1	0
FBgn0262870	865	816	745	654	1610	1470	TRUE	FALSE	FALSE	0	TRUE	TRUE	1	0
FBgn0262871	254	261	200	207	454	468	TRUE	TRUE	TRUE	1	TRUE	TRUE	1	1
FBgn0262872	719	692	575	586	1294	1278	TRUE	TRUE	TRUE	1	TRUE	TRUE	1	1
FBgn0262873	55	56	40	41	95	97	TRUE	TRUE	TRUE	1	TRUE	TRUE	1	1
FBgn0262875	97	102	82	79	179	181	TRUE	TRUE	TRUE	1	TRUE	TRUE	1	1
FBgn0262876	124	133	118	119	242	252	TRUE	TRUE	TRUE	1	TRUE	TRUE	1	1
FBgn0262878	66	67	47	33	113	100	TRUE	TRUE	TRUE	1	TRUE	TRUE	1	1
FBgn0262879	92	103	77	73	169	176	TRUE	TRUE	TRUE	1	TRUE	TRUE	1	1
FBgn0262880	81	70	63	57	144	127	TRUE	TRUE	TRUE	1	TRUE	TRUE	1	1
FBgn0262881	52	53	42	34	94	87	TRUE	TRUE	TRUE	1	TRUE	TRUE	1	1
FBgn0262882	52	71	43	56	95	127	TRUE	TRUE	FALSE	0	TRUE	TRUE	1	0
FBgn0262883	65	39	41	43	106	82	FALSE	TRUE	FALSE	0	FALSE	TRUE	0	0
FBgn0262885	16	26	26	12	42	38	TRUE	FALSE	TRUE	0	FALSE	FALSE	0	0
FBgn0262886	52	53	40	39	92	92	TRUE	TRUE	TRUE	1	TRUE	TRUE	1	1
FBgn0262887	44	40	32	26	76	66	TRUE	TRUE	TRUE	1	TRUE	TRUE	1	1
FBgn0262889	113	96	90	82	203	178	TRUE	TRUE	TRUE	1	TRUE	TRUE	1	1
FBgn0262890	115	105	74	95	189	200	TRUE	TRUE	TRUE	1	TRUE	TRUE	1	1
FBgn0262891	79	70	62	49	141	119	TRUE	TRUE	TRUE	1	TRUE	TRUE	1	1
FBgn0262893	56	34	37	39	93	73	FALSE	TRUE	TRUE	0	FALSE	TRUE	0	0
FBgn0262894	50	53	36	48	86	101	TRUE	TRUE	TRUE	1	TRUE	TRUE	1	1
FBgn0262895	35	33	29	39	64	72	TRUE	TRUE	TRUE	1	TRUE	TRUE	1	1
FBgn0262896	38	32	36	26	74	58	TRUE	TRUE	TRUE	1	TRUE	TRUE	1	1
FBgn0262897	48	63	54	40	102	103	TRUE	TRUE	TRUE	1	TRUE	TRUE	1	1
FBgn0262898	96	87	70	76	166	163	TRUE	TRUE	TRUE	1	TRUE	TRUE	1	1
FBgn0262899	37	30	38	38	75	68	TRUE	TRUE	TRUE	1	TRUE	TRUE	1	1
FBgn0262901	90	93	95	82	185	175	TRUE	TRUE	TRUE	1	TRUE	TRUE	1	1
FBgn0262902	33	35	35	36	68	71	TRUE	TRUE	TRUE	1	TRUE	TRUE	1	1
FBgn0262903	110	126	97	92	207	218	TRUE	TRUE	TRUE	1	TRUE	TRUE	1	1
FBgn0262904	92	115	72	89	164	204	TRUE	TRUE	FALSE	0	TRUE	TRUE	1	0
FBgn0262943	41	51	34	45	75	96	TRUE	TRUE	TRUE	1	TRUE	TRUE	1	1
FBgn0262944	87	62	71	75	158	137	FALSE	TRUE	TRUE	0	TRUE	TRUE	1	0
FBgn0262948	33	30	38	50	71	80	TRUE	TRUE	TRUE	1	TRUE	TRUE	1	1
FBgn0262951	164	145	101	111	265	256	TRUE	TRUE	TRUE	1	TRUE	TRUE	1	1
FBgn0262952	19943	80	7568	30	27511	110	FALSE	FALSE	FALSE	0	FALSE	FALSE	0	0
FBgn0262954	47	65	58	57	105	122	TRUE	TRUE	TRUE	1	TRUE	TRUE	1	1
FBgn0262955	281	259	260	229	541	488	TRUE	TRUE	TRUE	1	TRUE	TRUE	1	1
FBgn0262960	39	68	55	59	94	127	FALSE	TRUE	FALSE	0	FALSE	TRUE	0	0
FBgn0262961	63	47	58	38	121	85	TRUE	FALSE	FALSE	0	TRUE	FALSE	0	0
FBgn0262962	46	46	42	47	88	93	TRUE	TRUE	TRUE	1	TRUE	TRUE	1	1
FBgn0262963	33	26	30	27	63	53	TRUE	TRUE	TRUE	1	TRUE	TRUE	1	1
FBgn0262964	68	83	54	44	122	127	TRUE	TRUE	TRUE	1	TRUE	TRUE	1	1
FBgn0262965	57	66	50	51	107	117	TRUE	TRUE	TRUE	1	TRUE	TRUE	1	1
FBgn0262966	37	41	44	35	81	76	TRUE	TRUE	TRUE	1	TRUE	TRUE	1	1
FBgn0262969	92	84	78	80	170	164	TRUE	TRUE	TRUE	1	TRUE	TRUE	1	1
FBgn0262970	47	39	45	32	92	71	TRUE	TRUE	TRUE	1	TRUE	TRUE	1	1
FBgn0262971	18	24	26	16	44	40	TRUE	TRUE	TRUE	1	TRUE	FALSE	0	0
FBgn0262972	413	461	356	421	769	882	TRUE	FALSE	FALSE	0	TRUE	TRUE	1	0
FBgn0262974	41	38	41	22	82	60	TRUE	FALSE	FALSE	0	TRUE	FALSE	0	0
FBgn0262975	765	731	620	604	1385	1335	TRUE	TRUE	TRUE	1	TRUE	TRUE	1	1
FBgn0262982	39	19	23	29	62	48	FALSE	TRUE	TRUE	0	FALSE	TRUE	0	0
FBgn0262983	84	108	73	71	157	179	FALSE	TRUE	TRUE	0	TRUE	TRUE	1	0
FBgn0262984	60	47	38	48	98	95	TRUE	TRUE	TRUE	1	TRUE	TRUE	1	1
FBgn0262985	42	47	35	37	77	84	TRUE	TRUE	TRUE	1	TRUE	TRUE	1	1
FBgn0262986	39	34	27	25	66	59	TRUE	TRUE	TRUE	1	TRUE	TRUE	1	1
FBgn0262987	33	34	41	22	74	56	TRUE	FALSE	TRUE	0	TRUE	FALSE	0	0
FBgn0262988	29	20	16	15	45	35	TRUE	TRUE	TRUE	1	TRUE	TRUE	1	1
FBgn0262992	32	30	20	26	52	56	TRUE	TRUE	TRUE	1	TRUE	TRUE	1	1
FBgn0262993	38	33	35	28	73	61	TRUE	TRUE	TRUE	1	TRUE	TRUE	1	1
FBgn0262994	35	30	35	24	70	54	TRUE	TRUE	TRUE	1	TRUE	TRUE	1	1
FBgn0262995	62	58	45	53	107	111	TRUE	TRUE	TRUE	1	TRUE	TRUE	1	1
FBgn0262996	72	71	54	67	126	138	TRUE	TRUE	TRUE	1	TRUE	TRUE	1	1
FBgn0262998	83	100	103	76	186	176	TRUE	FALSE	TRUE	0	TRUE	TRUE	1	0
FBgn0262999	51	52	37	48	88	100	TRUE	TRUE	TRUE	1	TRUE	TRUE	1	1
FBgn0263004	18	15	17	17	35	32	TRUE	TRUE	TRUE	1	TRUE	TRUE	1	1
FBgn0263006	353	339	282	272	635	611	TRUE	TRUE	TRUE	1	TRUE	TRUE	1	1
FBgn0263019	595	577	535	511	1130	1088	TRUE	TRUE	TRUE	1	TRUE	TRUE	1	1
FBgn0263020	99	85	85	86	184	171	TRUE	TRUE	TRUE	1	TRUE	TRUE	1	1
FBgn0263021	109	84	64	63	173	147	FALSE	TRUE	TRUE	0	TRUE	TRUE	1	0
FBgn0263022	25	34	27	25	52	59	TRUE	TRUE	TRUE	1	TRUE	TRUE	1	1
FBgn0263024	38	38	43	33	81	71	TRUE	TRUE	TRUE	1	TRUE	TRUE	1	1
FBgn0263025	67	72	57	64	124	136	TRUE	TRUE	TRUE	1	TRUE	TRUE	1	1
FBgn0263026	54	71	58	50	112	121	TRUE	TRUE	TRUE	1	TRUE	TRUE	1	1
FBgn0263027	130	102	94	90	224	192	FALSE	TRUE	TRUE	0	TRUE	TRUE	1	0
FBgn0263034	26	53	34	43	60	96	FALSE	TRUE	FALSE	0	FALSE	TRUE	0	0
FBgn0263037	127	174	106	112	233	286	FALSE	TRUE	FALSE	0	TRUE	TRUE	1	0
FBgn0263038	328	367	259	275	587	642	TRUE	TRUE	TRUE	1	TRUE	TRUE	1	1
FBgn0263040	93	97	71	89	164	186	TRUE	TRUE	TRUE	1	TRUE	TRUE	1	1
FBgn0263041	58	61	50	51	108	112	TRUE	TRUE	TRUE	1	TRUE	TRUE	1	1
FBgn0263042	81	99	84	83	165	182	TRUE	TRUE	TRUE	1	TRUE	TRUE	1	1
FBgn0263048	234	285	226	223	460	508	FALSE	TRUE	TRUE	0	TRUE	TRUE	1	0
FBgn0263049	147	164	127	94	274	258	TRUE	FALSE	TRUE	0	TRUE	TRUE	1	0
FBgn0263076	196	227	163	198	359	425	TRUE	FALSE	FALSE	0	TRUE	TRUE	1	0
FBgn0263077	906	940	798	776	1704	1716	TRUE	TRUE	TRUE	1	TRUE	TRUE	1	1
FBgn0263078	131	127	104	108	235	235	TRUE	TRUE	TRUE	1	TRUE	TRUE	1	1
FBgn0263079	220	191	153	164	373	355	TRUE	TRUE	TRUE	1	TRUE	TRUE	1	1
FBgn0263080	61	48	49	56	110	104	TRUE	TRUE	TRUE	1	TRUE	TRUE	1	1
FBgn0263081	37	36	32	27	69	63	TRUE	TRUE	TRUE	1	TRUE	TRUE	1	1
FBgn0263082	51	59	52	52	103	111	TRUE	TRUE	TRUE	1	TRUE	TRUE	1	1
FBgn0263083	38	29	21	27	59	56	TRUE	TRUE	TRUE	1	TRUE	TRUE	1	1
FBgn0263084	64	66	50	43	114	109	TRUE	TRUE	TRUE	1	TRUE	TRUE	1	1
FBgn0263085	56	66	52	52	108	118	TRUE	TRUE	TRUE	1	TRUE	TRUE	1	1
FBgn0263086	39	35	45	37	84	72	TRUE	TRUE	TRUE	1	TRUE	TRUE	1	1
FBgn0263088	37	41	33	42	70	83	TRUE	TRUE	TRUE	1	TRUE	TRUE	1	1
FBgn0263089	91	87	86	66	177	153	TRUE	TRUE	TRUE	1	TRUE	TRUE	1	1
FBgn0263090	61	50	55	50	116	100	TRUE	TRUE	TRUE	1	TRUE	TRUE	1	1
FBgn0263091	56	52	41	35	97	87	TRUE	TRUE	TRUE	1	TRUE	TRUE	1	1
FBgn0263092	49	35	31	36	80	71	TRUE	TRUE	TRUE	1	TRUE	TRUE	1	1
FBgn0263095	52	60	59	53	111	113	TRUE	TRUE	TRUE	1	TRUE	TRUE	1	1
FBgn0263096	34	35	28	28	62	63	TRUE	TRUE	TRUE	1	TRUE	TRUE	1	1
FBgn0263102	588	601	523	495	1111	1096	TRUE	TRUE	TRUE	1	TRUE	TRUE	1	1
FBgn0263106	89	82	74	67	163	149	TRUE	TRUE	TRUE	1	TRUE	TRUE	1	1
FBgn0263108	331	356	292	266	623	622	TRUE	TRUE	TRUE	1	TRUE	TRUE	1	1
FBgn0263109	278	224	240	200	518	424	FALSE	FALSE	FALSE	0	TRUE	TRUE	1	0
FBgn0263110	786	827	665	692	1451	1519	TRUE	TRUE	TRUE	1	TRUE	TRUE	1	1
FBgn0263112	103	132	117	80	220	212	FALSE	FALSE	TRUE	0	TRUE	TRUE	1	0
FBgn0263113	346	310	262	257	608	567	TRUE	TRUE	TRUE	1	TRUE	TRUE	1	1
FBgn0263116	380	364	285	323	665	687	TRUE	TRUE	TRUE	1	TRUE	TRUE	1	1
FBgn0263117	307	371	315	258	622	629	FALSE	FALSE	TRUE	0	TRUE	TRUE	1	0
FBgn0263118	92	74	71	74	163	148	TRUE	TRUE	TRUE	1	TRUE	TRUE	1	1
FBgn0263120	247	222	196	224	443	446	TRUE	TRUE	TRUE	1	TRUE	TRUE	1	1
FBgn0263130	125	119	107	105	232	224	TRUE	TRUE	TRUE	1	TRUE	TRUE	1	1
FBgn0263131	805	757	660	633	1465	1390	TRUE	TRUE	TRUE	1	TRUE	TRUE	1	1
FBgn0263133	126	136	123	98	249	234	TRUE	TRUE	TRUE	1	TRUE	TRUE	1	1
FBgn0263144	157	138	120	134	277	272	TRUE	TRUE	TRUE	1	TRUE	TRUE	1	1
FBgn0263197	513	496	398	406	911	902	TRUE	TRUE	TRUE	1	TRUE	TRUE	1	1
FBgn0263198	184	128	141	155	325	283	FALSE	TRUE	FALSE	0	TRUE	TRUE	1	0
FBgn0263199	262	226	183	190	445	416	TRUE	TRUE	TRUE	1	TRUE	TRUE	1	1
FBgn0263200	40	47	25	38	65	85	TRUE	TRUE	TRUE	1	TRUE	FALSE	0	0
FBgn0263201	21	25	20	16	41	41	TRUE	TRUE	TRUE	1	TRUE	TRUE	1	1
FBgn0263217	47	34	41	35	88	69	TRUE	TRUE	TRUE	1	TRUE	TRUE	1	1
FBgn0263219	789	758	614	575	1403	1333	TRUE	TRUE	TRUE	1	TRUE	TRUE	1	1
FBgn0263231	128	117	98	92	226	209	TRUE	TRUE	TRUE	1	TRUE	TRUE	1	1
FBgn0263232	83	67	72	74	155	141	TRUE	TRUE	TRUE	1	TRUE	TRUE	1	1
FBgn0263233	40	59	44	32	84	91	FALSE	TRUE	TRUE	0	TRUE	TRUE	1	0
FBgn0263234	104	85	87	80	191	165	TRUE	TRUE	TRUE	1	TRUE	TRUE	1	1
FBgn0263235	127	165	92	107	219	272	FALSE	TRUE	FALSE	0	TRUE	TRUE	1	0
FBgn0263236	455	429	343	363	798	792	TRUE	TRUE	TRUE	1	TRUE	TRUE	1	1
FBgn0263239	200	237	201	176	401	413	FALSE	TRUE	TRUE	0	TRUE	TRUE	1	0
FBgn0263240	24	34	26	13	50	47	TRUE	FALSE	TRUE	0	TRUE	FALSE	0	0
FBgn0263241	170	147	133	143	303	290	TRUE	TRUE	TRUE	1	TRUE	TRUE	1	1
FBgn0263246	62	81	76	70	138	151	TRUE	TRUE	TRUE	1	TRUE	TRUE	1	1
FBgn0263247	58	51	53	38	111	89	TRUE	TRUE	TRUE	1	TRUE	TRUE	1	1
FBgn0263248	63	55	57	45	120	100	TRUE	TRUE	TRUE	1	TRUE	TRUE	1	1
FBgn0263250	52	94	58	54	110	148	FALSE	TRUE	FALSE	0	FALSE	TRUE	0	0
FBgn0263256	373	375	340	328	713	703	TRUE	TRUE	TRUE	1	TRUE	TRUE	1	1
FBgn0263260	84	68	57	67	141	135	TRUE	TRUE	TRUE	1	TRUE	TRUE	1	1
FBgn0263270	70	55	48	43	118	98	TRUE	TRUE	TRUE	1	TRUE	TRUE	1	1
FBgn0263278	155	157	139	117	294	274	TRUE	TRUE	TRUE	1	TRUE	TRUE	1	1
FBgn0263289	1034	1080	844	824	1878	1904	TRUE	TRUE	TRUE	1	TRUE	TRUE	1	1
FBgn0263290	75	97	53	55	128	152	TRUE	TRUE	TRUE	1	TRUE	TRUE	1	1
FBgn0263314	101	92	65	98	166	190	TRUE	FALSE	TRUE	0	TRUE	FALSE	0	0
FBgn0263316	330	313	234	308	564	621	TRUE	FALSE	TRUE	0	TRUE	TRUE	1	0
FBgn0263320	74	78	80	69	154	147	TRUE	TRUE	TRUE	1	TRUE	TRUE	1	1
FBgn0263321	144	117	126	94	270	211	TRUE	FALSE	FALSE	0	TRUE	TRUE	1	0
FBgn0263322	23	36	22	33	45	69	TRUE	TRUE	FALSE	0	FALSE	TRUE	0	0
FBgn0263323	72	45	56	51	128	96	FALSE	TRUE	FALSE	0	FALSE	TRUE	0	0
FBgn0263324	43	51	38	37	81	88	TRUE	TRUE	TRUE	1	TRUE	TRUE	1	1
FBgn0263325	84	100	107	127	191	227	TRUE	TRUE	FALSE	0	TRUE	TRUE	1	0
FBgn0263326	37	33	31	40	68	73	TRUE	TRUE	TRUE	1	TRUE	TRUE	1	1
FBgn0263327	49	34	26	37	75	71	TRUE	TRUE	TRUE	1	TRUE	TRUE	1	1
FBgn0263328	27	21	14	17	41	38	TRUE	TRUE	TRUE	1	TRUE	TRUE	1	1
FBgn0263329	35	42	42	31	77	73	TRUE	TRUE	TRUE	1	TRUE	TRUE	1	1
FBgn0263330	38	38	23	27	61	65	TRUE	TRUE	TRUE	1	TRUE	TRUE	1	1
FBgn0263331	25	47	31	18	56	65	FALSE	FALSE	TRUE	0	FALSE	FALSE	0	0
FBgn0263332	26	22	16	21	42	43	TRUE	TRUE	TRUE	1	TRUE	TRUE	1	1
FBgn0263333	62	70	49	67	111	137	TRUE	TRUE	TRUE	1	TRUE	TRUE	1	1
FBgn0263334	71	61	39	42	110	103	TRUE	TRUE	TRUE	1	TRUE	TRUE	1	1
FBgn0263335	53	59	48	51	101	110	TRUE	TRUE	TRUE	1	TRUE	TRUE	1	1
FBgn0263336	72	65	54	66	126	131	TRUE	TRUE	TRUE	1	TRUE	TRUE	1	1
FBgn0263338	63	73	53	57	116	130	TRUE	TRUE	TRUE	1	TRUE	TRUE	1	1
FBgn0263339	62	82	66	80	128	162	TRUE	TRUE	FALSE	0	TRUE	TRUE	1	0
FBgn0263340	36	33	27	38	63	71	TRUE	TRUE	TRUE	1	TRUE	TRUE	1	1
FBgn0263341	92	98	65	67	157	165	TRUE	TRUE	TRUE	1	TRUE	TRUE	1	1
FBgn0263343	69	66	52	55	121	121	TRUE	TRUE	TRUE	1	TRUE	TRUE	1	1
FBgn0263345	71	64	55	51	126	115	TRUE	TRUE	TRUE	1	TRUE	TRUE	1	1
FBgn0263346	294	302	253	287	547	589	TRUE	TRUE	TRUE	1	TRUE	TRUE	1	1
FBgn0263351	66	77	41	57	107	134	TRUE	TRUE	FALSE	0	TRUE	TRUE	1	0
FBgn0263352	505	453	416	348	921	801	FALSE	FALSE	FALSE	0	TRUE	TRUE	1	0
FBgn0263353	49	55	29	32	78	87	TRUE	TRUE	TRUE	1	TRUE	TRUE	1	1
FBgn0263354	395	408	251	272	646	680	TRUE	TRUE	TRUE	1	TRUE	TRUE	1	1
FBgn0263355	374	285	315	233	689	518	FALSE	FALSE	FALSE	0	TRUE	TRUE	1	0
FBgn0263376	158	154	143	118	301	272	TRUE	TRUE	TRUE	1	TRUE	TRUE	1	1
FBgn0263379	161	166	118	120	279	286	TRUE	TRUE	TRUE	1	TRUE	TRUE	1	1
FBgn0263380	72	65	58	61	130	126	TRUE	TRUE	TRUE	1	TRUE	TRUE	1	1
FBgn0263382	71	76	60	49	131	125	TRUE	TRUE	TRUE	1	TRUE	TRUE	1	1
FBgn0263383	46	48	41	34	87	82	TRUE	TRUE	TRUE	1	TRUE	TRUE	1	1
FBgn0263384	24	24	28	14	52	38	TRUE	FALSE	TRUE	0	TRUE	FALSE	0	0
FBgn0263386	52	51	47	59	99	110	TRUE	TRUE	TRUE	1	TRUE	TRUE	1	1
FBgn0263388	56	59	48	52	104	111	TRUE	TRUE	TRUE	1	TRUE	TRUE	1	1
FBgn0263389	32	28	20	28	52	56	TRUE	TRUE	TRUE	1	TRUE	TRUE	1	1
FBgn0263390	297	281	228	218	525	499	TRUE	TRUE	TRUE	1	TRUE	TRUE	1	1
FBgn0263391	898	943	765	773	1663	1716	TRUE	TRUE	TRUE	1	TRUE	TRUE	1	1
FBgn0263392	778	809	643	691	1421	1500	TRUE	TRUE	TRUE	1	TRUE	TRUE	1	1
FBgn0263395	451	476	406	378	857	854	TRUE	TRUE	TRUE	1	TRUE	TRUE	1	1
FBgn0263396	202	186	158	174	360	360	TRUE	TRUE	TRUE	1	TRUE	TRUE	1	1
FBgn0263397	701	656	554	488	1255	1144	TRUE	FALSE	FALSE	0	TRUE	TRUE	1	0
FBgn0263398	134	166	134	127	268	293	FALSE	TRUE	TRUE	0	TRUE	TRUE	1	0
FBgn0263399	95	79	66	67	161	146	TRUE	TRUE	TRUE	1	TRUE	TRUE	1	1
FBgn0263400	118	125	107	130	225	255	TRUE	TRUE	TRUE	1	TRUE	TRUE	1	1
FBgn0263401	37	39	47	31	84	70	TRUE	FALSE	TRUE	0	TRUE	FALSE	0	0
FBgn0263402	86	79	68	60	154	139	TRUE	TRUE	TRUE	1	TRUE	TRUE	1	1
FBgn0263403	51	54	65	50	116	104	TRUE	TRUE	TRUE	1	TRUE	TRUE	1	1
FBgn0263404	22	25	31	23	53	48	TRUE	TRUE	TRUE	1	TRUE	TRUE	1	1
FBgn0263405	81	69	53	53	134	122	TRUE	TRUE	TRUE	1	TRUE	TRUE	1	1
FBgn0263406	94	89	61	72	155	161	TRUE	TRUE	TRUE	1	TRUE	TRUE	1	1
FBgn0263407	72	80	67	72	139	152	TRUE	TRUE	TRUE	1	TRUE	TRUE	1	1
FBgn0263408	66	57	78	56	144	113	TRUE	FALSE	FALSE	0	TRUE	TRUE	1	0
FBgn0263410	79	96	65	69	144	165	TRUE	TRUE	TRUE	1	TRUE	TRUE	1	1
FBgn0263411	60	49	37	46	97	95	TRUE	TRUE	TRUE	1	TRUE	TRUE	1	1
FBgn0263412	71	65	55	61	126	126	TRUE	TRUE	TRUE	1	TRUE	TRUE	1	1
FBgn0263413	156	145	124	117	280	262	TRUE	TRUE	TRUE	1	TRUE	TRUE	1	1
FBgn0263414	67	53	42	45	109	98	TRUE	TRUE	TRUE	1	TRUE	TRUE	1	1
FBgn0263441	131	151	122	110	253	261	TRUE	TRUE	TRUE	1	TRUE	TRUE	1	1
FBgn0263449	43	46	27	32	70	78	TRUE	TRUE	TRUE	1	TRUE	TRUE	1	1
FBgn0263452	43	45	38	41	81	86	TRUE	TRUE	TRUE	1	TRUE	TRUE	1	1
FBgn0263453	27	22	27	26	54	48	TRUE	TRUE	TRUE	1	TRUE	TRUE	1	1
FBgn0263456	487	468	398	387	885	855	TRUE	TRUE	TRUE	1	TRUE	TRUE	1	1
FBgn0263464	31	24	23	16	54	40	TRUE	TRUE	TRUE	1	TRUE	TRUE	1	1
FBgn0263466	21	27	20	18	41	45	TRUE	TRUE	TRUE	1	TRUE	TRUE	1	1
FBgn0263469	17	17	22	14	39	31	TRUE	TRUE	TRUE	1	TRUE	FALSE	0	0
FBgn0263473	25	21	19	18	44	39	TRUE	TRUE	TRUE	1	TRUE	TRUE	1	1
FBgn0263490	514	460	342	392	856	852	FALSE	FALSE	TRUE	0	TRUE	TRUE	1	0
FBgn0263492	153	156	109	148	262	304	TRUE	FALSE	FALSE	0	TRUE	TRUE	1	0
FBgn0263495	62	44	50	50	112	94	FALSE	TRUE	TRUE	0	TRUE	TRUE	1	0
FBgn0263496	41	38	24	24	65	62	TRUE	TRUE	TRUE	1	TRUE	TRUE	1	1
FBgn0263497	28	21	29	14	57	35	TRUE	FALSE	FALSE	0	TRUE	FALSE	0	0
FBgn0263498	40	45	35	33	75	78	TRUE	TRUE	TRUE	1	TRUE	TRUE	1	1
FBgn0263499	30	30	18	32	48	62	TRUE	FALSE	TRUE	0	TRUE	FALSE	0	0
FBgn0263500	30	41	26	22	56	63	TRUE	TRUE	TRUE	1	TRUE	TRUE	1	1
FBgn0263501	69	107	73	65	142	172	FALSE	TRUE	TRUE	0	FALSE	TRUE	0	0
FBgn0263510	82	89	58	50	140	139	TRUE	TRUE	TRUE	1	TRUE	TRUE	1	1
FBgn0263513	23	44	31	32	54	76	FALSE	TRUE	FALSE	0	FALSE	TRUE	0	0
FBgn0263521	23	38	33	22	56	60	FALSE	TRUE	TRUE	0	FALSE	TRUE	0	0
FBgn0263522	29	28	16	24	45	52	TRUE	TRUE	TRUE	1	TRUE	TRUE	1	1
FBgn0263539	16	21	16	20	32	41	TRUE	TRUE	TRUE	1	TRUE	TRUE	1	1
FBgn0263547	37	38	35	26	72	64	TRUE	TRUE	TRUE	1	TRUE	TRUE	1	1
FBgn0263561	18	19	24	25	42	44	TRUE	TRUE	TRUE	1	TRUE	TRUE	1	1
FBgn0263568	34	22	20	22	54	44	TRUE	TRUE	TRUE	1	FALSE	TRUE	0	0
FBgn0263581	107	101	109	109	216	210	TRUE	TRUE	TRUE	1	TRUE	TRUE	1	1
FBgn0263582	24	38	31	38	55	76	FALSE	TRUE	FALSE	0	FALSE	TRUE	0	0
FBgn0263583	71	78	61	68	132	146	TRUE	TRUE	TRUE	1	TRUE	TRUE	1	1
FBgn0263585	43	33	33	39	76	72	TRUE	TRUE	TRUE	1	TRUE	TRUE	1	1
FBgn0263586	44	46	50	44	94	90	TRUE	TRUE	TRUE	1	TRUE	TRUE	1	1
FBgn0263587	107	107	81	78	188	185	TRUE	TRUE	TRUE	1	TRUE	TRUE	1	1
FBgn0263588	78	90	79	74	157	164	TRUE	TRUE	TRUE	1	TRUE	TRUE	1	1
FBgn0263593	215	206	166	188	381	394	TRUE	TRUE	TRUE	1	TRUE	TRUE	1	1
FBgn0263595	129	126	123	136	252	262	TRUE	TRUE	TRUE	1	TRUE	TRUE	1	1
FBgn0263598	215	228	175	219	390	447	TRUE	FALSE	FALSE	0	TRUE	TRUE	1	0
FBgn0263599	332	415	275	278	607	693	FALSE	TRUE	FALSE	0	TRUE	TRUE	1	0
FBgn0263600	179	145	132	118	311	263	FALSE	TRUE	FALSE	0	TRUE	TRUE	1	0
FBgn0263601	198	188	155	183	353	371	TRUE	TRUE	TRUE	1	TRUE	TRUE	1	1
FBgn0263602	143	141	100	103	243	244	TRUE	TRUE	TRUE	1	TRUE	TRUE	1	1
FBgn0263603	174	206	126	163	300	369	TRUE	FALSE	FALSE	0	TRUE	TRUE	1	0
FBgn0263605	136	157	132	106	268	263	TRUE	TRUE	TRUE	1	TRUE	TRUE	1	1
FBgn0263606	77	76	59	44	136	120	TRUE	TRUE	TRUE	1	TRUE	TRUE	1	1
FBgn0263607	208	257	192	190	400	447	FALSE	TRUE	TRUE	0	TRUE	TRUE	1	0
FBgn0263608	96	90	84	77	180	167	TRUE	TRUE	TRUE	1	TRUE	TRUE	1	1
FBgn0263612	99	92	66	76	165	168	TRUE	TRUE	TRUE	1	TRUE	TRUE	1	1
FBgn0263613	49	54	50	32	99	86	TRUE	FALSE	TRUE	0	TRUE	FALSE	0	0
FBgn0263615	77	67	54	67	131	134	TRUE	TRUE	TRUE	1	TRUE	TRUE	1	1
FBgn0263616	23	25	24	23	47	48	TRUE	TRUE	TRUE	1	TRUE	TRUE	1	1
FBgn0263617	337	321	296	300	633	621	TRUE	TRUE	TRUE	1	TRUE	TRUE	1	1
FBgn0263618	117	123	106	95	223	218	TRUE	TRUE	TRUE	1	TRUE	TRUE	1	1
FBgn0263620	27	30	31	17	58	47	TRUE	FALSE	TRUE	0	TRUE	FALSE	0	0
FBgn0263622	65	62	45	45	110	107	TRUE	TRUE	TRUE	1	TRUE	TRUE	1	1
FBgn0263623	51	51	43	40	94	91	TRUE	TRUE	TRUE	1	TRUE	TRUE	1	1
FBgn0263625	44	55	42	44	86	99	TRUE	TRUE	TRUE	1	TRUE	TRUE	1	1
FBgn0263626	31	38	24	31	55	69	TRUE	TRUE	TRUE	1	TRUE	TRUE	1	1
FBgn0263647	96	97	98	97	194	194	TRUE	TRUE	TRUE	1	TRUE	TRUE	1	1
FBgn0263648	53	57	50	58	103	115	TRUE	TRUE	TRUE	1	TRUE	TRUE	1	1
FBgn0263649	142	140	116	104	258	244	TRUE	TRUE	TRUE	1	TRUE	TRUE	1	1
FBgn0263650	44	75	62	46	106	121	FALSE	TRUE	TRUE	0	FALSE	TRUE	0	0
FBgn0263651	103	78	64	60	167	138	FALSE	TRUE	TRUE	0	TRUE	TRUE	1	0
FBgn0263652	79	59	58	50	137	109	TRUE	TRUE	FALSE	0	TRUE	TRUE	1	0
FBgn0263653	33	38	19	25	52	63	TRUE	TRUE	TRUE	1	TRUE	TRUE	1	1
FBgn0263655	35	32	29	23	64	55	TRUE	TRUE	TRUE	1	TRUE	TRUE	1	1
FBgn0263656	41	62	46	37	87	99	FALSE	TRUE	TRUE	0	FALSE	TRUE	0	0
FBgn0263657	46	56	35	50	81	106	TRUE	TRUE	FALSE	0	TRUE	TRUE	1	0
FBgn0263658	68	64	54	44	122	108	TRUE	TRUE	TRUE	1	TRUE	TRUE	1	1
FBgn0263659	730	705	625	661	1355	1366	TRUE	TRUE	TRUE	1	TRUE	TRUE	1	1
FBgn0263660	17	22	16	26	33	48	TRUE	TRUE	TRUE	1	TRUE	FALSE	0	0
FBgn0263661	79	99	84	85	163	184	TRUE	TRUE	TRUE	1	TRUE	TRUE	1	1
FBgn0263662	145	111	117	99	262	210	FALSE	TRUE	FALSE	0	TRUE	TRUE	1	0
FBgn0263663	144	163	132	140	276	303	TRUE	TRUE	TRUE	1	TRUE	TRUE	1	1
FBgn0263664	48	53	41	39	89	92	TRUE	TRUE	TRUE	1	TRUE	TRUE	1	1
FBgn0263667	217	223	188	201	405	424	TRUE	TRUE	TRUE	1	TRUE	TRUE	1	1
FBgn0263697	67	63	54	48	121	111	TRUE	TRUE	TRUE	1	TRUE	TRUE	1	1
FBgn0263707	43	53	50	49	93	102	TRUE	TRUE	TRUE	1	TRUE	TRUE	1	1
FBgn0263708	107	116	108	120	215	236	TRUE	TRUE	TRUE	1	TRUE	TRUE	1	1
FBgn0263709	55	57	43	51	98	108	TRUE	TRUE	TRUE	1	TRUE	TRUE	1	1
FBgn0263738	134	132	88	117	222	249	TRUE	FALSE	TRUE	0	TRUE	TRUE	1	0
FBgn0263740	54	25	28	29	82	54	FALSE	TRUE	FALSE	0	FALSE	TRUE	0	0
FBgn0263741	59	51	52	55	111	106	TRUE	TRUE	TRUE	1	TRUE	TRUE	1	1
FBgn0263742	49	42	36	45	85	87	TRUE	TRUE	TRUE	1	TRUE	TRUE	1	1
FBgn0263743	107	85	88	69	195	154	TRUE	TRUE	FALSE	0	TRUE	TRUE	1	0
FBgn0263744	30	40	31	37	61	77	TRUE	TRUE	TRUE	1	TRUE	TRUE	1	1
FBgn0263745	187	174	121	116	308	290	TRUE	TRUE	TRUE	1	TRUE	TRUE	1	1
FBgn0263746	102	94	100	82	202	176	TRUE	TRUE	TRUE	1	TRUE	TRUE	1	1
FBgn0263750	23	20	20	25	43	45	TRUE	TRUE	TRUE	1	TRUE	TRUE	1	1
FBgn0263760	74	86	67	72	141	158	TRUE	TRUE	TRUE	1	TRUE	TRUE	1	1
FBgn0263761	25	32	16	33	41	65	TRUE	FALSE	FALSE	0	TRUE	FALSE	0	0
FBgn0263762	41	85	61	59	102	144	FALSE	TRUE	FALSE	0	FALSE	TRUE	0	0
FBgn0263763	64	66	45	62	109	128	TRUE	TRUE	TRUE	1	TRUE	TRUE	1	1
FBgn0263764	253	226	196	175	449	401	TRUE	TRUE	TRUE	1	TRUE	TRUE	1	1
FBgn0263765	90	90	72	66	162	156	TRUE	TRUE	TRUE	1	TRUE	TRUE	1	1
FBgn0263767	101	72	69	84	170	156	FALSE	TRUE	TRUE	0	TRUE	TRUE	1	0
FBgn0263768	15	34	16	19	31	53	FALSE	TRUE	FALSE	0	FALSE	TRUE	0	0
FBgn0263770	95	65	97	47	192	112	FALSE	FALSE	FALSE	0	TRUE	FALSE	0	0
FBgn0263771	49	51	42	37	91	88	TRUE	TRUE	TRUE	1	TRUE	TRUE	1	1
FBgn0263773	159	161	140	124	299	285	TRUE	TRUE	TRUE	1	TRUE	TRUE	1	1
FBgn0263774	313	324	244	265	557	589	TRUE	TRUE	TRUE	1	TRUE	TRUE	1	1
FBgn0263776	325	281	260	257	585	538	FALSE	TRUE	TRUE	0	TRUE	TRUE	1	0
FBgn0263777	40	61	48	53	88	114	FALSE	TRUE	FALSE	0	FALSE	TRUE	0	0
FBgn0263780	35	27	32	42	67	69	TRUE	TRUE	TRUE	1	TRUE	TRUE	1	1
FBgn0263782	301	312	212	269	513	581	TRUE	FALSE	FALSE	0	TRUE	TRUE	1	0
FBgn0263802	101	104	82	84	183	188	TRUE	TRUE	TRUE	1	TRUE	TRUE	1	1
FBgn0263831	219	237	181	195	400	432	TRUE	TRUE	TRUE	1	TRUE	TRUE	1	1
FBgn0263832	139	163	102	106	241	269	TRUE	TRUE	TRUE	1	TRUE	TRUE	1	1
FBgn0263838	28	29	28	31	56	60	TRUE	TRUE	TRUE	1	TRUE	TRUE	1	1
FBgn0263839	15	18	17	14	32	32	TRUE	TRUE	TRUE	1	TRUE	TRUE	1	1
FBgn0263841	58	46	43	57	101	103	TRUE	TRUE	TRUE	1	TRUE	TRUE	1	1
FBgn0263844	68	62	43	64	111	126	TRUE	FALSE	TRUE	0	TRUE	TRUE	1	0
FBgn0263845	53	34	46	36	99	70	FALSE	TRUE	FALSE	0	FALSE	TRUE	0	0
FBgn0263846	521	488	398	377	919	865	TRUE	TRUE	TRUE	1	TRUE	TRUE	1	1
FBgn0263848	73	76	55	63	128	139	TRUE	TRUE	TRUE	1	TRUE	TRUE	1	1
FBgn0263849	111	101	83	81	194	182	TRUE	TRUE	TRUE	1	TRUE	TRUE	1	1
FBgn0263850	88	81	74	71	162	152	TRUE	TRUE	TRUE	1	TRUE	TRUE	1	1
FBgn0263852	42	40	28	39	70	79	TRUE	TRUE	TRUE	1	TRUE	TRUE	1	1
FBgn0263855	113	161	112	131	225	292	FALSE	TRUE	FALSE	0	TRUE	TRUE	1	0
FBgn0263863	79	88	66	56	145	144	TRUE	TRUE	TRUE	1	TRUE	TRUE	1	1
FBgn0263864	104	101	86	83	190	184	TRUE	TRUE	TRUE	1	TRUE	TRUE	1	1
FBgn0263866	90	79	78	74	168	153	TRUE	TRUE	TRUE	1	TRUE	TRUE	1	1
FBgn0263867	55	54	57	48	112	102	TRUE	TRUE	TRUE	1	TRUE	TRUE	1	1
FBgn0263868	35	30	28	27	63	57	TRUE	TRUE	TRUE	1	TRUE	TRUE	1	1
FBgn0263869	73	78	61	58	134	136	TRUE	TRUE	TRUE	1	TRUE	TRUE	1	1
FBgn0263872	78	57	59	47	137	104	FALSE	TRUE	FALSE	0	TRUE	TRUE	1	0
FBgn0263873	1032	993	847	890	1879	1883	TRUE	TRUE	TRUE	1	TRUE	TRUE	1	1
FBgn0263874	44	43	43	35	87	78	TRUE	TRUE	TRUE	1	TRUE	TRUE	1	1
FBgn0263916	94	99	68	78	162	177	TRUE	TRUE	TRUE	1	TRUE	TRUE	1	1
FBgn0263929	511	574	451	416	962	990	FALSE	TRUE	TRUE	0	TRUE	TRUE	1	0
FBgn0263930	351	374	264	294	615	668	TRUE	TRUE	TRUE	1	TRUE	TRUE	1	1
FBgn0263933	144	126	104	103	248	229	TRUE	TRUE	TRUE	1	TRUE	TRUE	1	1
FBgn0263934	358	317	283	265	641	582	TRUE	TRUE	FALSE	0	TRUE	TRUE	1	0
FBgn0263970	97	92	98	69	195	161	TRUE	FALSE	FALSE	0	TRUE	TRUE	1	0
FBgn0263971	33	25	29	26	62	51	TRUE	TRUE	TRUE	1	TRUE	TRUE	1	1
FBgn0263973	576	589	506	524	1082	1113	TRUE	TRUE	TRUE	1	TRUE	TRUE	1	1
FBgn0263974	345	398	329	336	674	734	FALSE	TRUE	TRUE	0	TRUE	TRUE	1	0
FBgn0263977	49	54	39	35	88	89	TRUE	TRUE	TRUE	1	TRUE	TRUE	1	1
FBgn0263979	65	46	30	32	95	78	FALSE	TRUE	TRUE	0	TRUE	TRUE	1	0
FBgn0263980	995	1026	839	854	1834	1880	TRUE	TRUE	TRUE	1	TRUE	TRUE	1	1
FBgn0263986	94	83	88	88	182	171	TRUE	TRUE	TRUE	1	TRUE	TRUE	1	1
FBgn0263995	790	786	686	759	1476	1545	TRUE	FALSE	TRUE	0	TRUE	TRUE	1	0
FBgn0263998	402	428	334	363	736	791	TRUE	TRUE	TRUE	1	TRUE	TRUE	1	1
FBgn0263999	163	139	126	149	289	288	TRUE	TRUE	TRUE	1	TRUE	TRUE	1	1
FBgn0264000	702	668	574	581	1276	1249	TRUE	TRUE	TRUE	1	TRUE	TRUE	1	1
FBgn0264001	692	625	596	612	1288	1237	FALSE	TRUE	TRUE	0	TRUE	TRUE	1	0
FBgn0264002	140	115	78	65	218	180	TRUE	TRUE	FALSE	0	TRUE	TRUE	1	0
FBgn0264005	203	218	173	161	376	379	TRUE	TRUE	TRUE	1	TRUE	TRUE	1	1
FBgn0264006	877	971	787	791	1664	1762	FALSE	TRUE	FALSE	0	TRUE	TRUE	1	0
FBgn0264075	97	92	67	79	164	171	TRUE	TRUE	TRUE	1	TRUE	TRUE	1	1
FBgn0264081	162	160	126	126	288	286	TRUE	TRUE	TRUE	1	TRUE	TRUE	1	1
FBgn0264084	254	277	257	247	511	524	TRUE	TRUE	TRUE	1	TRUE	TRUE	1	1
FBgn0264085	104	100	97	79	201	179	TRUE	TRUE	TRUE	1	TRUE	TRUE	1	1
FBgn0264086	119	116	114	109	233	225	TRUE	TRUE	TRUE	1	TRUE	TRUE	1	1
FBgn0264087	814	826	649	706	1463	1532	TRUE	TRUE	TRUE	1	TRUE	TRUE	1	1
FBgn0264089	773	722	569	701	1342	1423	TRUE	FALSE	TRUE	0	TRUE	TRUE	1	0
FBgn0264253	62	65	55	94	117	159	TRUE	FALSE	FALSE	0	TRUE	FALSE	0	0
FBgn0264260	67	70	47	45	114	115	TRUE	TRUE	TRUE	1	TRUE	TRUE	1	1
FBgn0264261	137	144	140	140	277	284	TRUE	TRUE	TRUE	1	TRUE	TRUE	1	1
FBgn0264262	35	45	28	33	63	78	TRUE	TRUE	TRUE	1	TRUE	TRUE	1	1
FBgn0264263	27	37	45	47	72	84	TRUE	TRUE	TRUE	1	TRUE	TRUE	1	1
FBgn0264264	137	153	135	105	272	258	TRUE	FALSE	TRUE	0	TRUE	TRUE	1	0
FBgn0264265	56	62	53	41	109	103	TRUE	TRUE	TRUE	1	TRUE	TRUE	1	1
FBgn0264266	25	19	26	19	51	38	TRUE	TRUE	TRUE	1	TRUE	TRUE	1	1
FBgn0264269	25	19	20	14	45	33	TRUE	TRUE	TRUE	1	TRUE	TRUE	1	1
FBgn0264271	70	67	56	69	126	136	TRUE	TRUE	TRUE	1	TRUE	TRUE	1	1
FBgn0264272	373	371	326	315	699	686	TRUE	TRUE	TRUE	1	TRUE	TRUE	1	1
FBgn0264273	485	506	386	414	871	920	TRUE	TRUE	TRUE	1	TRUE	TRUE	1	1
FBgn0264291	44	53	37	40	81	93	TRUE	TRUE	TRUE	1	TRUE	TRUE	1	1
FBgn0264294	45	55	32	35	77	90	TRUE	TRUE	TRUE	1	TRUE	TRUE	1	1
FBgn0264295	47	72	41	39	88	111	FALSE	TRUE	TRUE	0	FALSE	TRUE	0	0
FBgn0264296	62	66	44	59	106	125	TRUE	TRUE	TRUE	1	TRUE	TRUE	1	1
FBgn0264305	209	211	154	203	363	414	TRUE	FALSE	FALSE	0	TRUE	TRUE	1	0
FBgn0264307	434	459	363	359	797	818	TRUE	TRUE	TRUE	1	TRUE	TRUE	1	1
FBgn0264308	410	405	280	302	690	707	TRUE	TRUE	TRUE	1	TRUE	TRUE	1	1
FBgn0264324	420	445	377	370	797	815	TRUE	TRUE	TRUE	1	TRUE	TRUE	1	1
FBgn0264325	89	76	67	48	156	124	TRUE	FALSE	FALSE	0	TRUE	TRUE	1	0
FBgn0264326	510	521	420	394	930	915	TRUE	TRUE	TRUE	1	TRUE	TRUE	1	1
FBgn0264329	58	37	32	43	90	80	FALSE	TRUE	TRUE	0	FALSE	TRUE	0	0
FBgn0264330	39	46	25	39	64	85	TRUE	TRUE	TRUE	1	TRUE	FALSE	0	0
FBgn0264336	32	33	19	25	51	58	TRUE	TRUE	TRUE	1	TRUE	TRUE	1	1
FBgn0264337	30	28	22	28	52	56	TRUE	TRUE	TRUE	1	TRUE	TRUE	1	1
FBgn0264338	60	59	59	56	119	115	TRUE	TRUE	TRUE	1	TRUE	TRUE	1	1
FBgn0264339	619	655	524	498	1143	1153	TRUE	TRUE	TRUE	1	TRUE	TRUE	1	1
FBgn0264340	72	65	49	43	121	108	TRUE	TRUE	TRUE	1	TRUE	TRUE	1	1
FBgn0264341	82	87	66	79	148	166	TRUE	TRUE	TRUE	1	TRUE	TRUE	1	1
FBgn0264342	96	70	68	79	164	149	FALSE	TRUE	TRUE	0	TRUE	TRUE	1	0
FBgn0264343	97	75	75	61	172	136	TRUE	TRUE	FALSE	0	TRUE	TRUE	1	0
FBgn0264344	67	50	53	43	120	93	TRUE	TRUE	FALSE	0	TRUE	TRUE	1	0
FBgn0264345	33	38	19	33	52	71	TRUE	FALSE	TRUE	0	TRUE	FALSE	0	0
FBgn0264346	19	36	27	25	46	61	FALSE	TRUE	TRUE	0	FALSE	TRUE	0	0
FBgn0264347	100	82	74	64	174	146	TRUE	TRUE	TRUE	1	TRUE	TRUE	1	1
FBgn0264348	23	28	34	21	57	49	TRUE	TRUE	TRUE	1	TRUE	FALSE	0	0
FBgn0264349	89	83	95	84	184	167	TRUE	TRUE	TRUE	1	TRUE	TRUE	1	1
FBgn0264351	96	83	78	64	174	147	TRUE	TRUE	TRUE	1	TRUE	TRUE	1	1
FBgn0264352	114	116	97	107	211	223	TRUE	TRUE	TRUE	1	TRUE	TRUE	1	1
FBgn0264357	1066	1056	860	882	1926	1938	TRUE	TRUE	TRUE	1	TRUE	TRUE	1	1
FBgn0264358	61	62	46	45	107	107	TRUE	TRUE	TRUE	1	TRUE	TRUE	1	1
FBgn0264359	21	20	19	12	40	32	TRUE	TRUE	TRUE	1	TRUE	FALSE	0	0
FBgn0264361	27	29	20	23	47	52	TRUE	TRUE	TRUE	1	TRUE	TRUE	1	1
FBgn0264362	45	53	53	40	98	93	TRUE	TRUE	TRUE	1	TRUE	TRUE	1	1
FBgn0264363	48	55	20	37	68	92	TRUE	FALSE	FALSE	0	TRUE	FALSE	0	0
FBgn0264365	25	24	24	34	49	58	TRUE	TRUE	TRUE	1	TRUE	TRUE	1	1
FBgn0264366	24	25	19	22	43	47	TRUE	TRUE	TRUE	1	TRUE	TRUE	1	1
FBgn0264367	26	21	25	13	51	34	TRUE	FALSE	FALSE	0	TRUE	FALSE	0	0
FBgn0264368	42	20	35	17	77	37	FALSE	FALSE	FALSE	0	FALSE	FALSE	0	0
FBgn0264369	67	65	56	46	123	111	TRUE	TRUE	TRUE	1	TRUE	TRUE	1	1
FBgn0264370	45	42	40	40	85	82	TRUE	TRUE	TRUE	1	TRUE	TRUE	1	1
FBgn0264371	192	139	118	141	310	280	FALSE	TRUE	TRUE	0	TRUE	TRUE	1	0
FBgn0264373	55	65	50	56	105	121	TRUE	TRUE	TRUE	1	TRUE	TRUE	1	1
FBgn0264374	26	33	33	36	59	69	TRUE	TRUE	TRUE	1	TRUE	TRUE	1	1
FBgn0264375	68	56	67	51	135	107	TRUE	TRUE	FALSE	0	TRUE	TRUE	1	0
FBgn0264376	187	134	158	127	345	261	FALSE	FALSE	FALSE	0	TRUE	TRUE	1	0
FBgn0264377	52	66	50	62	102	128	TRUE	TRUE	FALSE	0	TRUE	TRUE	1	0
FBgn0264378	48	57	45	58	93	115	TRUE	TRUE	TRUE	1	TRUE	TRUE	1	1
FBgn0264379	50	38	46	40	96	78	TRUE	TRUE	TRUE	1	TRUE	TRUE	1	1
FBgn0264391	21	29	24	22	45	51	TRUE	TRUE	TRUE	1	TRUE	TRUE	1	1
FBgn0264392	62	68	60	55	122	123	TRUE	TRUE	TRUE	1	TRUE	TRUE	1	1
FBgn0264426	53	53	37	58	90	111	TRUE	FALSE	TRUE	0	TRUE	FALSE	0	0
FBgn0264428	50	54	43	41	93	95	TRUE	TRUE	TRUE	1	TRUE	TRUE	1	1
FBgn0264429	90	78	74	74	164	152	TRUE	TRUE	TRUE	1	TRUE	TRUE	1	1
FBgn0264430	51	51	20	44	71	95	TRUE	FALSE	FALSE	0	TRUE	FALSE	0	0
FBgn0264431	37	42	45	42	82	84	TRUE	TRUE	TRUE	1	TRUE	TRUE	1	1
FBgn0264432	182	155	82	70	264	225	TRUE	TRUE	FALSE	0	TRUE	TRUE	1	0
FBgn0264433	33	53	40	35	73	88	FALSE	TRUE	TRUE	0	FALSE	TRUE	0	0
FBgn0264435	67	73	54	64	121	137	TRUE	TRUE	TRUE	1	TRUE	TRUE	1	1
FBgn0264436	44	56	69	56	113	112	TRUE	TRUE	TRUE	1	TRUE	TRUE	1	1
FBgn0264437	109	133	112	107	221	240	TRUE	TRUE	TRUE	1	TRUE	TRUE	1	1
FBgn0264438	59	83	55	51	114	134	FALSE	TRUE	TRUE	0	TRUE	TRUE	1	0
FBgn0264439	41	45	49	35	90	80	TRUE	TRUE	TRUE	1	TRUE	TRUE	1	1
FBgn0264441	37	38	35	25	72	63	TRUE	TRUE	TRUE	1	TRUE	TRUE	1	1
FBgn0264442	384	364	320	314	704	678	TRUE	TRUE	TRUE	1	TRUE	TRUE	1	1
FBgn0264443	298	256	264	220	562	476	FALSE	FALSE	FALSE	0	TRUE	TRUE	1	0
FBgn0264447	31	28	30	25	61	53	TRUE	TRUE	TRUE	1	TRUE	TRUE	1	1
FBgn0264448	24	34	28	19	52	53	TRUE	TRUE	TRUE	1	TRUE	TRUE	1	1
FBgn0264462	76	97	76	90	152	187	TRUE	TRUE	FALSE	0	TRUE	TRUE	1	0
FBgn0264466	49	46	45	44	94	90	TRUE	TRUE	TRUE	1	TRUE	TRUE	1	1
FBgn0264467	32	21	29	21	61	42	TRUE	TRUE	FALSE	0	FALSE	TRUE	0	0
FBgn0264471	41	42	20	26	61	68	TRUE	TRUE	TRUE	1	TRUE	TRUE	1	1
FBgn0264472	45	47	40	39	85	86	TRUE	TRUE	TRUE	1	TRUE	TRUE	1	1
FBgn0264473	80	92	71	65	151	157	TRUE	TRUE	TRUE	1	TRUE	TRUE	1	1
FBgn0264474	81	74	69	60	150	134	TRUE	TRUE	TRUE	1	TRUE	TRUE	1	1
FBgn0264475	51	57	54	46	105	103	TRUE	TRUE	TRUE	1	TRUE	TRUE	1	1
FBgn0264476	54	60	76	41	130	101	TRUE	FALSE	FALSE	0	TRUE	FALSE	0	0
FBgn0264479	48	48	37	56	85	104	TRUE	FALSE	TRUE	0	TRUE	FALSE	0	0
FBgn0264481	31	25	22	18	53	43	TRUE	TRUE	TRUE	1	TRUE	TRUE	1	1
FBgn0264482	31	29	30	18	61	47	TRUE	TRUE	TRUE	1	TRUE	FALSE	0	0
FBgn0264484	33	35	30	33	63	68	TRUE	TRUE	TRUE	1	TRUE	TRUE	1	1
FBgn0264485	45	35	41	31	86	66	TRUE	TRUE	TRUE	1	TRUE	TRUE	1	1
FBgn0264486	227	200	200	190	427	390	TRUE	TRUE	TRUE	1	TRUE	TRUE	1	1
FBgn0264487	23	26	21	29	44	55	TRUE	TRUE	TRUE	1	TRUE	TRUE	1	1
FBgn0264488	297	311	209	258	506	569	TRUE	FALSE	FALSE	0	TRUE	TRUE	1	0
FBgn0264489	684	677	555	576	1239	1253	TRUE	TRUE	TRUE	1	TRUE	TRUE	1	1
FBgn0264490	791	775	707	666	1498	1441	TRUE	TRUE	TRUE	1	TRUE	TRUE	1	1
FBgn0264491	359	355	316	319	675	674	TRUE	TRUE	TRUE	1	TRUE	TRUE	1	1
FBgn0264492	134	153	128	114	262	267	TRUE	TRUE	TRUE	1	TRUE	TRUE	1	1
FBgn0264493	202	190	173	176	375	366	TRUE	TRUE	TRUE	1	TRUE	TRUE	1	1
FBgn0264494	481	448	332	384	813	832	TRUE	FALSE	TRUE	0	TRUE	TRUE	1	0
FBgn0264495	158	157	116	115	274	272	TRUE	TRUE	TRUE	1	TRUE	TRUE	1	1
FBgn0264501	41	31	25	20	66	51	TRUE	TRUE	TRUE	1	TRUE	TRUE	1	1
FBgn0264506	52	58	50	53	102	111	TRUE	TRUE	TRUE	1	TRUE	TRUE	1	1
FBgn0264508	24	22	24	25	48	47	TRUE	TRUE	TRUE	1	TRUE	TRUE	1	1
FBgn0264510	94	113	93	94	187	207	TRUE	TRUE	TRUE	1	TRUE	TRUE	1	1
FBgn0264511	62	77	67	58	129	135	TRUE	TRUE	TRUE	1	TRUE	TRUE	1	1
FBgn0264513	273	227	206	229	479	456	FALSE	TRUE	TRUE	0	TRUE	TRUE	1	0
FBgn0264514	50	52	37	48	87	100	TRUE	TRUE	TRUE	1	TRUE	TRUE	1	1
FBgn0264515	64	57	60	60	124	117	TRUE	TRUE	TRUE	1	TRUE	TRUE	1	1
FBgn0264516	48	59	32	40	80	99	TRUE	TRUE	TRUE	1	TRUE	TRUE	1	1
FBgn0264517	53	41	39	48	92	89	TRUE	TRUE	TRUE	1	TRUE	TRUE	1	1
FBgn0264518	55	53	57	65	112	118	TRUE	TRUE	TRUE	1	TRUE	TRUE	1	1
FBgn0264540	62	65	70	56	132	121	TRUE	TRUE	TRUE	1	TRUE	TRUE	1	1
FBgn0264541	66	60	59	50	125	110	TRUE	TRUE	TRUE	1	TRUE	TRUE	1	1
FBgn0264547	27	28	18	17	45	45	TRUE	TRUE	TRUE	1	TRUE	TRUE	1	1
FBgn0264548	48	33	32	45	80	78	TRUE	TRUE	TRUE	1	TRUE	TRUE	1	1
FBgn0264549	80	63	77	89	157	152	TRUE	TRUE	TRUE	1	TRUE	TRUE	1	1
FBgn0264550	39	33	20	25	59	58	TRUE	TRUE	TRUE	1	TRUE	TRUE	1	1
FBgn0264553	43	59	40	38	83	97	TRUE	TRUE	TRUE	1	TRUE	TRUE	1	1
FBgn0264556	187	242	158	159	345	401	FALSE	TRUE	FALSE	0	TRUE	TRUE	1	0
FBgn0264560	413	381	297	273	710	654	TRUE	TRUE	TRUE	1	TRUE	TRUE	1	1
FBgn0264561	99	79	73	63	172	142	TRUE	TRUE	TRUE	1	TRUE	TRUE	1	1
FBgn0264563	29	28	22	18	51	46	TRUE	TRUE	TRUE	1	TRUE	TRUE	1	1
FBgn0264565	32	40	46	35	78	75	TRUE	TRUE	TRUE	1	TRUE	TRUE	1	1
FBgn0264566	70	51	41	66	111	117	TRUE	FALSE	TRUE	0	TRUE	FALSE	0	0
FBgn0264567	38	36	22	26	60	62	TRUE	TRUE	TRUE	1	TRUE	TRUE	1	1
FBgn0264568	54	48	45	52	99	100	TRUE	TRUE	TRUE	1	TRUE	TRUE	1	1
FBgn0264573	42	33	25	37	67	70	TRUE	TRUE	TRUE	1	TRUE	TRUE	1	1
FBgn0264574	963	966	776	813	1739	1779	TRUE	TRUE	TRUE	1	TRUE	TRUE	1	1
FBgn0264599	126	123	92	94	218	217	TRUE	TRUE	TRUE	1	TRUE	TRUE	1	1
FBgn0264601	32	29	29	25	61	54	TRUE	TRUE	TRUE	1	TRUE	TRUE	1	1
FBgn0264602	77	81	85	82	162	163	TRUE	TRUE	TRUE	1	TRUE	TRUE	1	1
FBgn0264603	52	41	41	36	93	77	TRUE	TRUE	TRUE	1	TRUE	TRUE	1	1
FBgn0264604	61	75	64	63	125	138	TRUE	TRUE	TRUE	1	TRUE	TRUE	1	1
FBgn0264606	935	993	779	769	1714	1762	TRUE	TRUE	TRUE	1	TRUE	TRUE	1	1
FBgn0264607	75	82	76	68	151	150	TRUE	TRUE	TRUE	1	TRUE	TRUE	1	1
FBgn0264672	121	134	89	106	210	240	TRUE	TRUE	TRUE	1	TRUE	TRUE	1	1
FBgn0264679	42	37	39	41	81	78	TRUE	TRUE	TRUE	1	TRUE	TRUE	1	1
FBgn0264693	485	495	390	412	875	907	TRUE	TRUE	TRUE	1	TRUE	TRUE	1	1
FBgn0264694	26	15	23	17	49	32	TRUE	TRUE	FALSE	0	FALSE	TRUE	0	0
FBgn0264695	644	591	525	551	1169	1142	TRUE	TRUE	TRUE	1	TRUE	TRUE	1	1
FBgn0264697	45	51	49	39	94	90	TRUE	TRUE	TRUE	1	TRUE	TRUE	1	1
FBgn0264698	30	24	32	12	62	36	TRUE	FALSE	FALSE	0	TRUE	FALSE	0	0
FBgn0264699	39	48	57	38	96	86	TRUE	FALSE	TRUE	0	TRUE	TRUE	1	0
FBgn0264700	66	62	57	53	123	115	TRUE	TRUE	TRUE	1	TRUE	TRUE	1	1
FBgn0264701	54	43	37	58	91	101	TRUE	FALSE	TRUE	0	TRUE	FALSE	0	0
FBgn0264702	43	42	37	36	80	78	TRUE	TRUE	TRUE	1	TRUE	TRUE	1	1
FBgn0264703	81	91	77	64	158	155	TRUE	TRUE	TRUE	1	TRUE	TRUE	1	1
FBgn0264704	21	30	24	29	45	59	TRUE	TRUE	TRUE	1	TRUE	TRUE	1	1
FBgn0264705	88	80	84	68	172	148	TRUE	TRUE	TRUE	1	TRUE	TRUE	1	1
FBgn0264706	40	41	29	35	69	76	TRUE	TRUE	TRUE	1	TRUE	TRUE	1	1
FBgn0264707	536	544	474	407	1010	951	TRUE	FALSE	TRUE	0	TRUE	TRUE	1	0
FBgn0264708	41	38	41	40	82	78	TRUE	TRUE	TRUE	1	TRUE	TRUE	1	1
FBgn0264709	27	15	18	22	45	37	FALSE	TRUE	TRUE	0	FALSE	TRUE	0	0
FBgn0264711	160	141	147	124	307	265	TRUE	TRUE	FALSE	0	TRUE	TRUE	1	0
FBgn0264712	67	73	72	60	139	133	TRUE	TRUE	TRUE	1	TRUE	TRUE	1	1
FBgn0264714	67	54	33	44	100	98	TRUE	TRUE	TRUE	1	TRUE	TRUE	1	1
FBgn0264715	77	60	59	69	136	129	TRUE	TRUE	TRUE	1	TRUE	TRUE	1	1
FBgn0264716	61	30	44	22	105	52	FALSE	FALSE	FALSE	0	FALSE	FALSE	0	0
FBgn0264719	39	59	45	63	84	122	FALSE	TRUE	FALSE	0	FALSE	TRUE	0	0
FBgn0264721	71	81	55	51	126	132	TRUE	TRUE	TRUE	1	TRUE	TRUE	1	1
FBgn0264722	64	69	50	44	114	113	TRUE	TRUE	TRUE	1	TRUE	TRUE	1	1
FBgn0264723	44	44	33	27	77	71	TRUE	TRUE	TRUE	1	TRUE	TRUE	1	1
FBgn0264724	50	57	33	51	83	108	TRUE	FALSE	FALSE	0	TRUE	FALSE	0	0
FBgn0264725	62	74	49	65	111	139	TRUE	TRUE	FALSE	0	TRUE	TRUE	1	0
FBgn0264726	62	73	42	54	104	127	TRUE	TRUE	TRUE	1	TRUE	TRUE	1	1
FBgn0264744	38	42	41	40	79	82	TRUE	TRUE	TRUE	1	TRUE	TRUE	1	1
FBgn0264745	106	99	82	93	188	192	TRUE	TRUE	TRUE	1	TRUE	TRUE	1	1
FBgn0264746	122	99	112	86	234	185	TRUE	FALSE	FALSE	0	TRUE	TRUE	1	0
FBgn0264747	152	132	116	136	268	268	TRUE	TRUE	TRUE	1	TRUE	TRUE	1	1
FBgn0264748	132	122	96	118	228	240	TRUE	TRUE	TRUE	1	TRUE	TRUE	1	1
FBgn0264750	79	97	77	83	156	180	TRUE	TRUE	TRUE	1	TRUE	TRUE	1	1
FBgn0264751	94	79	88	85	182	164	TRUE	TRUE	TRUE	1	TRUE	TRUE	1	1
FBgn0264753	791	727	613	629	1404	1356	TRUE	TRUE	TRUE	1	TRUE	TRUE	1	1
FBgn0264775	98	101	87	72	185	173	TRUE	TRUE	TRUE	1	TRUE	TRUE	1	1
FBgn0264776	31	42	29	27	60	69	TRUE	TRUE	TRUE	1	TRUE	TRUE	1	1
FBgn0264785	133	145	108	133	241	278	TRUE	TRUE	TRUE	1	TRUE	TRUE	1	1
FBgn0264787	28	26	25	32	53	58	TRUE	TRUE	TRUE	1	TRUE	TRUE	1	1
FBgn0264788	258	274	216	242	474	516	TRUE	TRUE	TRUE	1	TRUE	TRUE	1	1
FBgn0264792	61	75	54	56	115	131	TRUE	TRUE	TRUE	1	TRUE	TRUE	1	1
FBgn0264793	47	59	48	48	95	107	TRUE	TRUE	TRUE	1	TRUE	TRUE	1	1
FBgn0264794	48	34	30	25	78	59	TRUE	TRUE	TRUE	1	TRUE	TRUE	1	1
FBgn0264810	81	72	73	84	154	156	TRUE	TRUE	TRUE	1	TRUE	TRUE	1	1
FBgn0264815	619	574	489	513	1108	1087	TRUE	TRUE	TRUE	1	TRUE	TRUE	1	1
FBgn0264816	168	131	122	125	290	256	FALSE	TRUE	TRUE	0	TRUE	TRUE	1	0
FBgn0264817	102	102	53	90	155	192	TRUE	FALSE	FALSE	0	TRUE	FALSE	0	0
FBgn0264821	96	95	70	66	166	161	TRUE	TRUE	TRUE	1	TRUE	TRUE	1	1
FBgn0264822	32	28	23	19	55	47	TRUE	TRUE	TRUE	1	TRUE	TRUE	1	1
FBgn0264824	89	97	71	65	160	162	TRUE	TRUE	TRUE	1	TRUE	TRUE	1	1
FBgn0264825	83	103	56	74	139	177	TRUE	TRUE	FALSE	0	TRUE	TRUE	1	0
FBgn0264826	54	53	50	52	104	105	TRUE	TRUE	TRUE	1	TRUE	TRUE	1	1
FBgn0264828	78	77	61	71	139	148	TRUE	TRUE	TRUE	1	TRUE	TRUE	1	1
FBgn0264829	78	85	45	59	123	144	TRUE	TRUE	TRUE	1	TRUE	TRUE	1	1
FBgn0264831	106	120	89	85	195	205	TRUE	TRUE	TRUE	1	TRUE	TRUE	1	1
FBgn0264833	45	48	51	40	96	88	TRUE	TRUE	TRUE	1	TRUE	TRUE	1	1
FBgn0264834	33	22	19	22	52	44	TRUE	TRUE	TRUE	1	TRUE	TRUE	1	1
FBgn0264835	42	16	36	29	78	45	FALSE	TRUE	FALSE	0	FALSE	TRUE	0	0
FBgn0264838	57	67	59	61	116	128	TRUE	TRUE	TRUE	1	TRUE	TRUE	1	1
FBgn0264839	59	55	43	50	102	105	TRUE	TRUE	TRUE	1	TRUE	TRUE	1	1
FBgn0264840	73	55	56	45	129	100	TRUE	TRUE	FALSE	0	TRUE	TRUE	1	0
FBgn0264842	100	79	69	70	169	149	TRUE	TRUE	TRUE	1	TRUE	TRUE	1	1
FBgn0264845	301	249	274	263	575	512	FALSE	TRUE	FALSE	0	TRUE	TRUE	1	0
FBgn0264848	57	64	38	46	95	110	TRUE	TRUE	TRUE	1	TRUE	TRUE	1	1
FBgn0264855	199	192	171	168	370	360	TRUE	TRUE	TRUE	1	TRUE	TRUE	1	1
FBgn0264857	339	347	304	337	643	684	TRUE	TRUE	TRUE	1	TRUE	TRUE	1	1
FBgn0264864	70	51	53	47	123	98	TRUE	TRUE	TRUE	1	TRUE	TRUE	1	1
FBgn0264865	37	39	29	34	66	73	TRUE	TRUE	TRUE	1	TRUE	TRUE	1	1
FBgn0264867	74	92	91	84	165	176	TRUE	TRUE	TRUE	1	TRUE	TRUE	1	1
FBgn0264868	64	86	72	64	136	150	FALSE	TRUE	TRUE	0	TRUE	TRUE	1	0
FBgn0264870	44	60	47	41	91	101	TRUE	TRUE	TRUE	1	TRUE	TRUE	1	1
FBgn0264871	126	142	93	95	219	237	TRUE	TRUE	TRUE	1	TRUE	TRUE	1	1
FBgn0264872	20	18	24	18	44	36	TRUE	TRUE	TRUE	1	TRUE	TRUE	1	1
FBgn0264873	52	52	34	55	86	107	TRUE	FALSE	TRUE	0	TRUE	FALSE	0	0
FBgn0264874	21	22	16	18	37	40	TRUE	TRUE	TRUE	1	TRUE	TRUE	1	1
FBgn0264875	56	63	46	23	102	86	TRUE	FALSE	TRUE	0	TRUE	FALSE	0	0
FBgn0264877	40	42	35	34	75	76	TRUE	TRUE	TRUE	1	TRUE	TRUE	1	1
FBgn0264878	52	52	45	44	97	96	TRUE	TRUE	TRUE	1	TRUE	TRUE	1	1
FBgn0264879	41	53	52	43	93	96	TRUE	TRUE	TRUE	1	TRUE	TRUE	1	1
FBgn0264883	60	38	28	50	88	88	FALSE	FALSE	TRUE	0	FALSE	FALSE	0	0
FBgn0264884	13	26	11	21	24	47	FALSE	TRUE	FALSE	0	FALSE	FALSE	0	0
FBgn0264885	70	75	50	69	120	144	TRUE	FALSE	TRUE	0	TRUE	TRUE	1	0
FBgn0264886	27	38	29	33	56	71	TRUE	TRUE	TRUE	1	TRUE	TRUE	1	1
FBgn0264887	57	49	40	40	97	89	TRUE	TRUE	TRUE	1	TRUE	TRUE	1	1
FBgn0264888	20	17	25	24	45	41	TRUE	TRUE	TRUE	1	TRUE	TRUE	1	1
FBgn0264889	53	60	45	46	98	106	TRUE	TRUE	TRUE	1	TRUE	TRUE	1	1
FBgn0264890	74	53	59	46	133	99	FALSE	TRUE	FALSE	0	TRUE	TRUE	1	0
FBgn0264894	792	832	678	676	1470	1508	TRUE	TRUE	TRUE	1	TRUE	TRUE	1	1
FBgn0264895	576	622	516	460	1092	1082	TRUE	FALSE	TRUE	0	TRUE	TRUE	1	0
FBgn0264897	17	19	26	21	43	40	TRUE	TRUE	TRUE	1	TRUE	TRUE	1	1
FBgn0264898	55	54	33	40	88	94	TRUE	TRUE	TRUE	1	TRUE	TRUE	1	1
FBgn0264899	48	48	22	29	70	77	TRUE	TRUE	TRUE	1	TRUE	TRUE	1	1
FBgn0264900	31	43	19	34	50	77	TRUE	FALSE	FALSE	0	TRUE	FALSE	0	0
FBgn0264902	19	26	16	19	35	45	TRUE	TRUE	TRUE	1	TRUE	TRUE	1	1
FBgn0264903	24	26	22	18	46	44	TRUE	TRUE	TRUE	1	TRUE	TRUE	1	1
FBgn0264905	87	72	86	75	173	147	TRUE	TRUE	TRUE	1	TRUE	TRUE	1	1
FBgn0264907	160	193	138	145	298	338	FALSE	TRUE	TRUE	0	TRUE	TRUE	1	0
FBgn0264908	674	664	562	584	1236	1248	TRUE	TRUE	TRUE	1	TRUE	TRUE	1	1
FBgn0264911	87	88	70	61	157	149	TRUE	TRUE	TRUE	1	TRUE	TRUE	1	1
FBgn0264914	27	62	35	42	62	104	FALSE	TRUE	FALSE	0	FALSE	TRUE	0	0
FBgn0264922	38	31	34	37	72	68	TRUE	TRUE	TRUE	1	TRUE	TRUE	1	1
FBgn0264943	55	51	34	42	89	93	TRUE	TRUE	TRUE	1	TRUE	TRUE	1	1
FBgn0264944	43	42	36	34	79	76	TRUE	TRUE	TRUE	1	TRUE	TRUE	1	1
FBgn0264950	26	32	17	20	43	52	TRUE	TRUE	TRUE	1	TRUE	TRUE	1	1
FBgn0264952	21	28	18	15	39	43	TRUE	TRUE	TRUE	1	TRUE	TRUE	1	1
FBgn0264953	1215	1208	968	982	2183	2190	TRUE	TRUE	TRUE	1	TRUE	TRUE	1	1
FBgn0264956	59	82	71	76	130	158	FALSE	TRUE	TRUE	0	TRUE	TRUE	1	0
FBgn0264957	14	20	20	18	34	38	TRUE	TRUE	TRUE	1	TRUE	TRUE	1	1
FBgn0264959	265	269	238	228	503	497	TRUE	TRUE	TRUE	1	TRUE	TRUE	1	1
FBgn0264961	37	33	29	25	66	58	TRUE	TRUE	TRUE	1	TRUE	TRUE	1	1
FBgn0264962	413	425	324	331	737	756	TRUE	TRUE	TRUE	1	TRUE	TRUE	1	1
FBgn0264978	240	237	204	204	444	441	TRUE	TRUE	TRUE	1	TRUE	TRUE	1	1
FBgn0264979	180	177	135	163	315	340	TRUE	TRUE	TRUE	1	TRUE	TRUE	1	1
FBgn0264980	52	49	40	33	92	82	TRUE	TRUE	TRUE	1	TRUE	TRUE	1	1
FBgn0264982	29	33	20	18	49	51	TRUE	TRUE	TRUE	1	TRUE	TRUE	1	1
FBgn0264984	33	27	22	21	55	48	TRUE	TRUE	TRUE	1	TRUE	TRUE	1	1
FBgn0264985	30	32	33	27	63	59	TRUE	TRUE	TRUE	1	TRUE	TRUE	1	1
FBgn0264986	47	42	31	32	78	74	TRUE	TRUE	TRUE	1	TRUE	TRUE	1	1
FBgn0264988	26	32	38	24	64	56	TRUE	FALSE	TRUE	0	TRUE	FALSE	0	0
FBgn0264992	41	33	36	31	77	64	TRUE	TRUE	TRUE	1	TRUE	TRUE	1	1
FBgn0264994	74	89	81	85	155	174	TRUE	TRUE	TRUE	1	TRUE	TRUE	1	1
FBgn0264995	46	44	28	18	74	62	TRUE	TRUE	TRUE	1	TRUE	FALSE	0	0
FBgn0264997	47	35	53	40	100	75	TRUE	TRUE	FALSE	0	TRUE	TRUE	1	0
FBgn0264998	35	51	29	23	64	74	TRUE	TRUE	TRUE	1	TRUE	TRUE	1	1
FBgn0264999	108	108	93	109	201	217	TRUE	TRUE	TRUE	1	TRUE	TRUE	1	1
FBgn0265000	33	35	36	29	69	64	TRUE	TRUE	TRUE	1	TRUE	TRUE	1	1
FBgn0265001	165	163	151	126	316	289	TRUE	TRUE	TRUE	1	TRUE	TRUE	1	1
FBgn0265002	939	890	736	692	1675	1582	TRUE	TRUE	TRUE	1	TRUE	TRUE	1	1
FBgn0265003	275	291	245	265	520	556	TRUE	TRUE	TRUE	1	TRUE	TRUE	1	1
FBgn0265011	251	233	227	219	478	452	TRUE	TRUE	TRUE	1	TRUE	TRUE	1	1
FBgn0265017	236	243	207	210	443	453	TRUE	TRUE	TRUE	1	TRUE	TRUE	1	1
FBgn0265040	71	75	58	55	129	130	TRUE	TRUE	TRUE	1	TRUE	TRUE	1	1
FBgn0265041	49	38	34	37	83	75	TRUE	TRUE	TRUE	1	TRUE	TRUE	1	1
FBgn0265042	201	207	189	205	390	412	TRUE	TRUE	TRUE	1	TRUE	TRUE	1	1
FBgn0265044	94	75	63	71	157	146	TRUE	TRUE	TRUE	1	TRUE	TRUE	1	1
FBgn0265045	2471	2545	2005	2080	4476	4625	TRUE	TRUE	TRUE	1	TRUE	TRUE	1	1
FBgn0265046	41	49	53	34	94	83	TRUE	FALSE	TRUE	0	TRUE	FALSE	0	0
FBgn0265048	281	263	200	206	481	469	TRUE	TRUE	TRUE	1	TRUE	TRUE	1	1
FBgn0265049	30	30	29	24	59	54	TRUE	TRUE	TRUE	1	TRUE	TRUE	1	1
FBgn0265050	24	46	26	26	50	72	FALSE	TRUE	FALSE	0	FALSE	TRUE	0	0
FBgn0265051	45	39	44	55	89	94	TRUE	TRUE	TRUE	1	TRUE	TRUE	1	1
FBgn0265052	224	249	200	199	424	448	TRUE	TRUE	TRUE	1	TRUE	TRUE	1	1
FBgn0265059	85	91	74	73	159	164	TRUE	TRUE	TRUE	1	TRUE	TRUE	1	1
FBgn0265060	22	38	23	35	45	73	FALSE	TRUE	FALSE	0	FALSE	FALSE	0	0
FBgn0265061	18	38	30	27	48	65	FALSE	TRUE	TRUE	0	FALSE	TRUE	0	0
FBgn0265062	106	90	58	80	164	170	TRUE	FALSE	TRUE	0	TRUE	TRUE	1	0
FBgn0265063	43	49	45	56	88	105	TRUE	TRUE	TRUE	1	TRUE	TRUE	1	1
FBgn0265065	66	71	50	52	116	123	TRUE	TRUE	TRUE	1	TRUE	TRUE	1	1
FBgn0265067	131	98	122	91	253	189	FALSE	FALSE	FALSE	0	TRUE	TRUE	1	0
FBgn0265069	36	35	43	27	79	62	TRUE	FALSE	TRUE	0	TRUE	FALSE	0	0
FBgn0265073	48	35	36	41	84	76	TRUE	TRUE	TRUE	1	TRUE	TRUE	1	1
FBgn0265074	71	35	65	27	136	62	FALSE	FALSE	FALSE	0	FALSE	FALSE	0	0
FBgn0265076	57	60	60	57	117	117	TRUE	TRUE	TRUE	1	TRUE	TRUE	1	1
FBgn0265077	103	89	79	80	182	169	TRUE	TRUE	TRUE	1	TRUE	TRUE	1	1
FBgn0265078	64	55	59	53	123	108	TRUE	TRUE	TRUE	1	TRUE	TRUE	1	1
FBgn0265079	183	168	147	132	330	300	TRUE	TRUE	TRUE	1	TRUE	TRUE	1	1
FBgn0265080	61	70	56	52	117	122	TRUE	TRUE	TRUE	1	TRUE	TRUE	1	1
FBgn0265082	257	244	181	213	438	457	TRUE	TRUE	TRUE	1	TRUE	TRUE	1	1
FBgn0265084	37	35	35	29	72	64	TRUE	TRUE	TRUE	1	TRUE	TRUE	1	1
FBgn0265085	53	50	36	47	89	97	TRUE	TRUE	TRUE	1	TRUE	TRUE	1	1
FBgn0265086	61	62	65	54	126	116	TRUE	TRUE	TRUE	1	TRUE	TRUE	1	1
FBgn0265087	34	42	32	42	66	84	TRUE	TRUE	TRUE	1	TRUE	TRUE	1	1
FBgn0265088	19	20	18	18	37	38	TRUE	TRUE	TRUE	1	TRUE	TRUE	1	1
FBgn0265089	129	146	120	102	249	248	TRUE	TRUE	TRUE	1	TRUE	TRUE	1	1
FBgn0265096	70	69	46	44	116	113	TRUE	TRUE	TRUE	1	TRUE	TRUE	1	1
FBgn0265097	23	31	17	24	40	55	TRUE	TRUE	TRUE	1	TRUE	TRUE	1	1
FBgn0265098	30	34	20	25	50	59	TRUE	TRUE	TRUE	1	TRUE	TRUE	1	1
FBgn0265099	65	69	48	56	113	125	TRUE	TRUE	TRUE	1	TRUE	TRUE	1	1
FBgn0265102	281	249	229	240	510	489	TRUE	TRUE	TRUE	1	TRUE	TRUE	1	1
FBgn0265104	144	133	122	131	266	264	TRUE	TRUE	TRUE	1	TRUE	TRUE	1	1
FBgn0265105	60	55	51	46	111	101	TRUE	TRUE	TRUE	1	TRUE	TRUE	1	1
FBgn0265106	175	181	179	144	354	325	TRUE	FALSE	TRUE	0	TRUE	TRUE	1	0
FBgn0265137	43	39	46	46	89	85	TRUE	TRUE	TRUE	1	TRUE	TRUE	1	1
FBgn0265138	116	116	103	91	219	207	TRUE	TRUE	TRUE	1	TRUE	TRUE	1	1
FBgn0265140	182	217	182	177	364	394	FALSE	TRUE	TRUE	0	TRUE	TRUE	1	0
FBgn0265141	91	81	78	60	169	141	TRUE	TRUE	TRUE	1	TRUE	TRUE	1	1
FBgn0265145	69	65	53	59	122	124	TRUE	TRUE	TRUE	1	TRUE	TRUE	1	1
FBgn0265146	62	65	42	49	104	114	TRUE	TRUE	TRUE	1	TRUE	TRUE	1	1
FBgn0265147	62	68	58	56	120	124	TRUE	TRUE	TRUE	1	TRUE	TRUE	1	1
FBgn0265149	24	21	21	12	45	33	TRUE	TRUE	TRUE	1	TRUE	FALSE	0	0
FBgn0265152	30	14	12	22	42	36	FALSE	TRUE	TRUE	0	FALSE	FALSE	0	0
FBgn0265153	59	36	24	29	83	65	FALSE	TRUE	TRUE	0	FALSE	TRUE	0	0
FBgn0265154	45	52	27	39	72	91	TRUE	TRUE	TRUE	1	TRUE	TRUE	1	1
FBgn0265156	40	39	28	25	68	64	TRUE	TRUE	TRUE	1	TRUE	TRUE	1	1
FBgn0265157	23	20	25	31	48	51	TRUE	TRUE	TRUE	1	TRUE	TRUE	1	1
FBgn0265160	49	61	47	42	96	103	TRUE	TRUE	TRUE	1	TRUE	TRUE	1	1
FBgn0265161	70	75	52	62	122	137	TRUE	TRUE	TRUE	1	TRUE	TRUE	1	1
FBgn0265162	43	54	39	48	82	102	TRUE	TRUE	TRUE	1	TRUE	TRUE	1	1
FBgn0265163	44	44	38	22	82	66	TRUE	FALSE	TRUE	0	TRUE	FALSE	0	0
FBgn0265167	56	70	41	67	97	137	TRUE	FALSE	FALSE	0	TRUE	FALSE	0	0
FBgn0265168	16	15	13	27	29	42	TRUE	FALSE	TRUE	0	TRUE	FALSE	0	0
FBgn0265174	74	108	76	65	150	173	FALSE	TRUE	TRUE	0	TRUE	TRUE	1	0
FBgn0265176	31	25	33	27	64	52	TRUE	TRUE	TRUE	1	TRUE	TRUE	1	1
FBgn0265177	17	24	20	28	37	52	TRUE	TRUE	TRUE	1	TRUE	TRUE	1	1
FBgn0265180	156	139	114	124	270	263	TRUE	TRUE	TRUE	1	TRUE	TRUE	1	1
FBgn0265182	111	111	78	93	189	204	TRUE	TRUE	TRUE	1	TRUE	TRUE	1	1
FBgn0265184	58	64	54	53	112	117	TRUE	TRUE	TRUE	1	TRUE	TRUE	1	1
FBgn0265185	78	98	76	70	154	168	TRUE	TRUE	TRUE	1	TRUE	TRUE	1	1
FBgn0265186	153	152	117	120	270	272	TRUE	TRUE	TRUE	1	TRUE	TRUE	1	1
FBgn0265187	305	330	215	214	520	544	TRUE	TRUE	TRUE	1	TRUE	TRUE	1	1
FBgn0265188	36	38	28	23	64	61	TRUE	TRUE	TRUE	1	TRUE	TRUE	1	1
FBgn0265189	28	20	19	25	47	45	TRUE	TRUE	TRUE	1	TRUE	TRUE	1	1
FBgn0265190	81	94	68	60	149	154	TRUE	TRUE	TRUE	1	TRUE	TRUE	1	1
FBgn0265191	363	364	294	284	657	648	TRUE	TRUE	TRUE	1	TRUE	TRUE	1	1
FBgn0265192	61	68	50	52	111	120	TRUE	TRUE	TRUE	1	TRUE	TRUE	1	1
FBgn0265193	36	34	34	38	70	72	TRUE	TRUE	TRUE	1	TRUE	TRUE	1	1
FBgn0265194	924	899	788	781	1712	1680	TRUE	TRUE	TRUE	1	TRUE	TRUE	1	1
FBgn0265196	59	35	38	34	97	69	FALSE	TRUE	FALSE	0	FALSE	TRUE	0	0
FBgn0265197	51	44	29	24	80	68	TRUE	TRUE	TRUE	1	TRUE	TRUE	1	1
FBgn0265198	54	47	46	49	100	96	TRUE	TRUE	TRUE	1	TRUE	TRUE	1	1
FBgn0265199	26	18	34	15	60	33	TRUE	FALSE	FALSE	0	TRUE	FALSE	0	0
FBgn0265200	35	50	34	40	69	90	TRUE	TRUE	TRUE	1	TRUE	TRUE	1	1
FBgn0265202	63	52	39	50	102	102	TRUE	TRUE	TRUE	1	TRUE	TRUE	1	1
FBgn0265203	32	28	19	19	51	47	TRUE	TRUE	TRUE	1	TRUE	TRUE	1	1
FBgn0265204	53	51	56	60	109	111	TRUE	TRUE	TRUE	1	TRUE	TRUE	1	1
FBgn0265205	20	27	20	34	40	61	TRUE	FALSE	FALSE	0	TRUE	FALSE	0	0
FBgn0265254	37	38	30	38	67	76	TRUE	TRUE	TRUE	1	TRUE	TRUE	1	1
FBgn0265255	40	28	22	18	62	46	TRUE	TRUE	TRUE	1	TRUE	TRUE	1	1
FBgn0265256	34	48	36	28	70	76	TRUE	TRUE	TRUE	1	TRUE	TRUE	1	1
FBgn0265257	69	59	70	51	139	110	TRUE	TRUE	FALSE	0	TRUE	TRUE	1	0
FBgn0265262	88	106	72	86	160	192	TRUE	TRUE	FALSE	0	TRUE	TRUE	1	0
FBgn0265263	90	98	70	65	160	163	TRUE	TRUE	TRUE	1	TRUE	TRUE	1	1
FBgn0265264	299	278	220	228	519	506	TRUE	TRUE	TRUE	1	TRUE	TRUE	1	1
FBgn0265266	40	32	35	25	75	57	TRUE	TRUE	TRUE	1	TRUE	TRUE	1	1
FBgn0265268	163	154	155	147	318	301	TRUE	TRUE	TRUE	1	TRUE	TRUE	1	1
FBgn0265269	83	85	53	64	136	149	TRUE	TRUE	TRUE	1	TRUE	TRUE	1	1
FBgn0265270	110	112	92	79	202	191	TRUE	TRUE	TRUE	1	TRUE	TRUE	1	1
FBgn0265271	81	80	69	76	150	156	TRUE	TRUE	TRUE	1	TRUE	TRUE	1	1
FBgn0265272	77	92	48	68	125	160	TRUE	FALSE	FALSE	0	TRUE	TRUE	1	0
FBgn0265274	137	135	100	99	237	234	TRUE	TRUE	TRUE	1	TRUE	TRUE	1	1
FBgn0265276	178	169	184	170	362	339	TRUE	TRUE	TRUE	1	TRUE	TRUE	1	1
FBgn0265296	941	908	792	781	1733	1689	TRUE	TRUE	TRUE	1	TRUE	TRUE	1	1
FBgn0265297	182	176	127	132	309	308	TRUE	TRUE	TRUE	1	TRUE	TRUE	1	1
FBgn0265298	89	78	69	82	158	160	TRUE	TRUE	TRUE	1	TRUE	TRUE	1	1
FBgn0265299	36	34	30	27	66	61	TRUE	TRUE	TRUE	1	TRUE	TRUE	1	1
FBgn0265300	39	42	21	34	60	76	TRUE	TRUE	TRUE	1	TRUE	FALSE	0	0
FBgn0265301	42	33	28	39	70	72	TRUE	TRUE	TRUE	1	TRUE	TRUE	1	1
FBgn0265303	35	39	31	29	66	68	TRUE	TRUE	TRUE	1	TRUE	TRUE	1	1
FBgn0265304	18	34	27	25	45	59	FALSE	TRUE	TRUE	0	FALSE	TRUE	0	0
FBgn0265305	24	40	22	29	46	69	FALSE	TRUE	FALSE	0	FALSE	TRUE	0	0
FBgn0265306	46	44	33	30	79	74	TRUE	TRUE	TRUE	1	TRUE	TRUE	1	1
FBgn0265307	42	58	41	47	83	105	TRUE	TRUE	TRUE	1	TRUE	TRUE	1	1
FBgn0265308	31	21	21	20	52	41	TRUE	TRUE	TRUE	1	TRUE	TRUE	1	1
FBgn0265309	90	88	75	83	165	171	TRUE	TRUE	TRUE	1	TRUE	TRUE	1	1
FBgn0265310	23	23	32	26	55	49	TRUE	TRUE	TRUE	1	TRUE	TRUE	1	1
FBgn0265311	83	101	85	79	168	180	TRUE	TRUE	TRUE	1	TRUE	TRUE	1	1
FBgn0265313	34	43	26	21	60	64	TRUE	TRUE	TRUE	1	TRUE	TRUE	1	1
FBgn0265315	23	39	29	31	52	70	FALSE	TRUE	TRUE	0	FALSE	TRUE	0	0
FBgn0265316	146	142	116	129	262	271	TRUE	TRUE	TRUE	1	TRUE	TRUE	1	1
FBgn0265317	29	27	28	24	57	51	TRUE	TRUE	TRUE	1	TRUE	TRUE	1	1
FBgn0265338	82	83	58	80	140	163	TRUE	FALSE	TRUE	0	TRUE	TRUE	1	0
FBgn0265339	24	15	12	21	36	36	TRUE	TRUE	TRUE	1	FALSE	FALSE	0	0
FBgn0265341	46	68	54	54	100	122	FALSE	TRUE	TRUE	0	TRUE	TRUE	1	0
FBgn0265344	35	46	24	22	59	68	TRUE	TRUE	TRUE	1	TRUE	TRUE	1	1
FBgn0265345	95	99	71	62	166	161	TRUE	TRUE	TRUE	1	TRUE	TRUE	1	1
FBgn0265347	27	24	16	19	43	43	TRUE	TRUE	TRUE	1	TRUE	TRUE	1	1
FBgn0265348	87	62	64	65	151	127	FALSE	TRUE	TRUE	0	TRUE	TRUE	1	0
FBgn0265349	35	30	36	12	71	42	TRUE	FALSE	FALSE	0	TRUE	FALSE	0	0
FBgn0265351	32	31	17	31	49	62	TRUE	FALSE	TRUE	0	TRUE	FALSE	0	0
FBgn0265356	526	586	537	552	1063	1138	FALSE	TRUE	TRUE	0	TRUE	TRUE	1	0
FBgn0265364	90	104	79	76	169	180	TRUE	TRUE	TRUE	1	TRUE	TRUE	1	1
FBgn0265365	62	47	41	59	103	106	TRUE	FALSE	TRUE	0	TRUE	TRUE	1	0
FBgn0265366	44	26	36	45	80	71	FALSE	TRUE	TRUE	0	FALSE	TRUE	0	0
FBgn0265367	47	37	42	46	89	83	TRUE	TRUE	TRUE	1	TRUE	TRUE	1	1
FBgn0265368	74	95	71	59	145	154	TRUE	TRUE	TRUE	1	TRUE	TRUE	1	1
FBgn0265369	40	50	36	36	76	86	TRUE	TRUE	TRUE	1	TRUE	TRUE	1	1
FBgn0265370	43	51	38	30	81	81	TRUE	TRUE	TRUE	1	TRUE	TRUE	1	1
FBgn0265371	37	44	39	36	76	80	TRUE	TRUE	TRUE	1	TRUE	TRUE	1	1
FBgn0265372	84	101	85	70	169	171	TRUE	TRUE	TRUE	1	TRUE	TRUE	1	1
FBgn0265373	160	189	146	143	306	332	TRUE	TRUE	TRUE	1	TRUE	TRUE	1	1
FBgn0265374	41	36	45	31	86	67	TRUE	TRUE	TRUE	1	TRUE	TRUE	1	1
FBgn0265375	50	67	37	45	87	112	TRUE	TRUE	FALSE	0	TRUE	TRUE	1	0
FBgn0265376	69	66	60	69	129	135	TRUE	TRUE	TRUE	1	TRUE	TRUE	1	1
FBgn0265378	50	75	60	54	110	129	FALSE	TRUE	TRUE	0	TRUE	TRUE	1	0
FBgn0265379	99	103	87	70	186	173	TRUE	TRUE	TRUE	1	TRUE	TRUE	1	1
FBgn0265380	16	21	16	20	32	41	TRUE	TRUE	TRUE	1	TRUE	TRUE	1	1
FBgn0265381	65	67	64	49	129	116	TRUE	TRUE	TRUE	1	TRUE	TRUE	1	1
FBgn0265382	30	39	28	30	58	69	TRUE	TRUE	TRUE	1	TRUE	TRUE	1	1
FBgn0265383	44	42	33	24	77	66	TRUE	TRUE	TRUE	1	TRUE	TRUE	1	1
FBgn0265414	77	74	72	77	149	151	TRUE	TRUE	TRUE	1	TRUE	TRUE	1	1
FBgn0265419	42	28	33	32	75	60	TRUE	TRUE	TRUE	1	TRUE	TRUE	1	1
FBgn0265422	45	36	38	27	83	63	TRUE	TRUE	TRUE	1	TRUE	TRUE	1	1
FBgn0265425	48	29	24	25	72	54	FALSE	TRUE	TRUE	0	FALSE	TRUE	0	0
FBgn0265426	34	34	28	28	62	62	TRUE	TRUE	TRUE	1	TRUE	TRUE	1	1
FBgn0265427	17	21	26	28	43	49	TRUE	TRUE	TRUE	1	TRUE	TRUE	1	1
FBgn0265429	136	126	129	120	265	246	TRUE	TRUE	TRUE	1	TRUE	TRUE	1	1
FBgn0265434	227	285	231	220	458	505	FALSE	TRUE	TRUE	0	TRUE	TRUE	1	0
FBgn0265443	97	91	86	93	183	184	TRUE	TRUE	TRUE	1	TRUE	TRUE	1	1
FBgn0265444	175	183	142	152	317	335	TRUE	TRUE	TRUE	1	TRUE	TRUE	1	1
FBgn0265445	57	53	38	44	95	97	TRUE	TRUE	TRUE	1	TRUE	TRUE	1	1
FBgn0265446	73	54	59	61	132	115	TRUE	TRUE	TRUE	1	TRUE	TRUE	1	1
FBgn0265447	185	158	158	160	343	318	TRUE	TRUE	TRUE	1	TRUE	TRUE	1	1
FBgn0265448	77	73	60	63	137	136	TRUE	TRUE	TRUE	1	TRUE	TRUE	1	1
FBgn0265449	75	81	58	82	133	163	TRUE	FALSE	FALSE	0	TRUE	TRUE	1	0
FBgn0265450	37	47	35	26	72	73	TRUE	TRUE	TRUE	1	TRUE	TRUE	1	1
FBgn0265452	28	24	36	21	64	45	TRUE	FALSE	FALSE	0	TRUE	FALSE	0	0
FBgn0265455	60	52	64	60	124	112	TRUE	TRUE	TRUE	1	TRUE	TRUE	1	1
FBgn0265467	79	67	63	50	142	117	TRUE	TRUE	TRUE	1	TRUE	TRUE	1	1
FBgn0265468	47	65	59	49	106	114	TRUE	TRUE	TRUE	1	TRUE	TRUE	1	1
FBgn0265470	25	24	14	22	39	46	TRUE	TRUE	TRUE	1	TRUE	FALSE	0	0
FBgn0265487	1023	948	784	756	1807	1704	FALSE	TRUE	FALSE	0	TRUE	TRUE	1	0
FBgn0265496	158	179	141	149	299	328	TRUE	TRUE	TRUE	1	TRUE	TRUE	1	1
FBgn0265497	111	121	117	110	228	231	TRUE	TRUE	TRUE	1	TRUE	TRUE	1	1
FBgn0265500	62	62	52	47	114	109	TRUE	TRUE	TRUE	1	TRUE	TRUE	1	1
FBgn0265508	246	260	190	218	436	478	TRUE	TRUE	TRUE	1	TRUE	TRUE	1	1
FBgn0265509	31	36	32	20	63	56	TRUE	TRUE	TRUE	1	TRUE	FALSE	0	0
FBgn0265511	82	89	55	79	137	168	TRUE	FALSE	FALSE	0	TRUE	TRUE	1	0
FBgn0265512	90	119	86	77	176	196	FALSE	TRUE	TRUE	0	TRUE	TRUE	1	0
FBgn0265525	97	86	82	65	179	151	TRUE	TRUE	TRUE	1	TRUE	TRUE	1	1
FBgn0265526	76	72	43	57	119	129	TRUE	TRUE	TRUE	1	TRUE	TRUE	1	1
FBgn0265527	264	240	208	189	472	429	TRUE	TRUE	TRUE	1	TRUE	TRUE	1	1
FBgn0265529	31	34	35	32	66	66	TRUE	TRUE	TRUE	1	TRUE	TRUE	1	1
FBgn0265530	127	103	82	72	209	175	TRUE	TRUE	FALSE	0	TRUE	TRUE	1	0
FBgn0265537	71	67	51	53	122	120	TRUE	TRUE	TRUE	1	TRUE	TRUE	1	1
FBgn0265538	45	43	36	40	81	83	TRUE	TRUE	TRUE	1	TRUE	TRUE	1	1
FBgn0265539	41	71	27	50	68	121	FALSE	FALSE	FALSE	0	FALSE	FALSE	0	0
FBgn0265540	21	12	16	16	37	28	TRUE	TRUE	TRUE	1	FALSE	TRUE	0	0
FBgn0265541	29	45	29	25	58	70	FALSE	TRUE	TRUE	0	FALSE	TRUE	0	0
FBgn0265542	26	40	33	28	59	68	TRUE	TRUE	TRUE	1	FALSE	TRUE	0	0
FBgn0265543	38	52	56	40	94	92	TRUE	TRUE	TRUE	1	TRUE	TRUE	1	1
FBgn0265545	24	39	30	22	54	61	FALSE	TRUE	TRUE	0	FALSE	TRUE	0	0
FBgn0265546	13	21	12	23	25	44	TRUE	FALSE	FALSE	0	FALSE	FALSE	0	0
FBgn0265547	84	65	55	64	139	129	TRUE	TRUE	TRUE	1	TRUE	TRUE	1	1
FBgn0265548	45	40	54	51	99	91	TRUE	TRUE	TRUE	1	TRUE	TRUE	1	1
FBgn0265549	33	25	36	29	69	54	TRUE	TRUE	TRUE	1	TRUE	TRUE	1	1
FBgn0265550	33	35	33	38	66	73	TRUE	TRUE	TRUE	1	TRUE	TRUE	1	1
FBgn0265551	72	89	72	68	144	157	TRUE	TRUE	TRUE	1	TRUE	TRUE	1	1
FBgn0265574	25	25	17	28	42	53	TRUE	TRUE	TRUE	1	TRUE	FALSE	0	0
FBgn0265576	94	95	76	80	170	175	TRUE	TRUE	TRUE	1	TRUE	TRUE	1	1
FBgn0265577	20	11	23	16	43	27	TRUE	TRUE	FALSE	0	FALSE	TRUE	0	0
FBgn0265578	98	155	90	105	188	260	FALSE	TRUE	FALSE	0	FALSE	TRUE	0	0
FBgn0265580	89	90	56	73	145	163	TRUE	TRUE	TRUE	1	TRUE	TRUE	1	1
FBgn0265582	65	58	55	39	120	97	TRUE	TRUE	TRUE	1	TRUE	TRUE	1	1
FBgn0265584	50	61	35	53	85	114	TRUE	FALSE	FALSE	0	TRUE	FALSE	0	0
FBgn0265585	81	87	66	60	147	147	TRUE	TRUE	TRUE	1	TRUE	TRUE	1	1
FBgn0265587	71	86	67	70	138	156	TRUE	TRUE	TRUE	1	TRUE	TRUE	1	1
FBgn0265588	128	147	124	129	252	276	TRUE	TRUE	TRUE	1	TRUE	TRUE	1	1
FBgn0265591	63	58	41	52	104	110	TRUE	TRUE	TRUE	1	TRUE	TRUE	1	1
FBgn0265592	53	56	70	44	123	100	TRUE	FALSE	TRUE	0	TRUE	FALSE	0	0
FBgn0265593	72	81	62	49	134	130	TRUE	TRUE	TRUE	1	TRUE	TRUE	1	1
FBgn0265594	25	41	29	38	54	79	FALSE	TRUE	FALSE	0	FALSE	TRUE	0	0
FBgn0265605	124	131	97	120	221	251	TRUE	TRUE	TRUE	1	TRUE	TRUE	1	1
FBgn0265606	55	48	39	44	94	92	TRUE	TRUE	TRUE	1	TRUE	TRUE	1	1
FBgn0265614	84	81	75	69	159	150	TRUE	TRUE	TRUE	1	TRUE	TRUE	1	1
FBgn0265623	526	499	443	456	969	955	TRUE	TRUE	TRUE	1	TRUE	TRUE	1	1
FBgn0265625	248	250	204	203	452	453	TRUE	TRUE	TRUE	1	TRUE	TRUE	1	1
FBgn0265631	25	37	31	27	56	64	TRUE	TRUE	TRUE	1	TRUE	TRUE	1	1
FBgn0265632	66	46	50	43	116	89	FALSE	TRUE	FALSE	0	TRUE	TRUE	1	0
FBgn0265633	17	23	17	24	34	47	TRUE	TRUE	TRUE	1	TRUE	TRUE	1	1
FBgn0265634	50	56	41	48	91	104	TRUE	TRUE	TRUE	1	TRUE	TRUE	1	1
FBgn0265635	84	71	65	74	149	145	TRUE	TRUE	TRUE	1	TRUE	TRUE	1	1
FBgn0265636	65	59	48	71	113	130	TRUE	FALSE	TRUE	0	TRUE	TRUE	1	0
FBgn0265637	40	39	35	31	75	70	TRUE	TRUE	TRUE	1	TRUE	TRUE	1	1
FBgn0265638	68	88	73	78	141	166	TRUE	TRUE	TRUE	1	TRUE	TRUE	1	1
FBgn0265639	80	74	57	61	137	135	TRUE	TRUE	TRUE	1	TRUE	TRUE	1	1
FBgn0265640	44	57	35	41	79	98	TRUE	TRUE	TRUE	1	TRUE	TRUE	1	1
FBgn0265641	45	61	51	37	96	98	TRUE	TRUE	TRUE	1	TRUE	TRUE	1	1
FBgn0265642	54	79	65	75	119	154	FALSE	TRUE	FALSE	0	TRUE	TRUE	1	0
FBgn0265643	57	58	49	43	106	101	TRUE	TRUE	TRUE	1	TRUE	TRUE	1	1
FBgn0265644	100	112	84	77	184	189	TRUE	TRUE	TRUE	1	TRUE	TRUE	1	1
FBgn0265645	89	76	74	52	163	128	TRUE	FALSE	FALSE	0	TRUE	TRUE	1	0
FBgn0265646	63	63	43	40	106	103	TRUE	TRUE	TRUE	1	TRUE	TRUE	1	1
FBgn0265648	30	26	21	30	51	56	TRUE	TRUE	TRUE	1	TRUE	TRUE	1	1
FBgn0265650	61	55	74	43	135	98	TRUE	FALSE	FALSE	0	TRUE	FALSE	0	0
FBgn0265651	34	40	39	25	73	65	TRUE	TRUE	TRUE	1	TRUE	FALSE	0	0
FBgn0265653	32	31	28	26	60	57	TRUE	TRUE	TRUE	1	TRUE	TRUE	1	1
FBgn0265654	55	49	42	41	97	90	TRUE	TRUE	TRUE	1	TRUE	TRUE	1	1
FBgn0265655	69	86	49	59	118	145	TRUE	TRUE	TRUE	1	TRUE	TRUE	1	1
FBgn0265656	45	43	31	37	76	80	TRUE	TRUE	TRUE	1	TRUE	TRUE	1	1
FBgn0265658	42	54	43	39	85	93	TRUE	TRUE	TRUE	1	TRUE	TRUE	1	1
FBgn0265659	67	68	58	54	125	122	TRUE	TRUE	TRUE	1	TRUE	TRUE	1	1
FBgn0265660	38	33	37	33	75	66	TRUE	TRUE	TRUE	1	TRUE	TRUE	1	1
FBgn0265661	126	115	109	112	235	227	TRUE	TRUE	TRUE	1	TRUE	TRUE	1	1
FBgn0265665	88	92	63	62	151	154	TRUE	TRUE	TRUE	1	TRUE	TRUE	1	1
FBgn0265667	32	40	25	26	57	66	TRUE	TRUE	TRUE	1	TRUE	TRUE	1	1
FBgn0265668	64	80	55	53	119	133	TRUE	TRUE	TRUE	1	TRUE	TRUE	1	1
FBgn0265669	53	50	57	65	110	115	TRUE	TRUE	TRUE	1	TRUE	TRUE	1	1
FBgn0265670	47	38	40	38	87	76	TRUE	TRUE	TRUE	1	TRUE	TRUE	1	1
FBgn0265671	49	40	25	40	74	80	TRUE	FALSE	TRUE	0	TRUE	FALSE	0	0
FBgn0265672	25	42	27	32	52	74	FALSE	TRUE	FALSE	0	FALSE	TRUE	0	0
FBgn0265674	25	16	21	19	46	35	TRUE	TRUE	TRUE	1	FALSE	TRUE	0	0
FBgn0265675	54	50	49	51	103	101	TRUE	TRUE	TRUE	1	TRUE	TRUE	1	1
FBgn0265676	23	19	26	20	49	39	TRUE	TRUE	TRUE	1	TRUE	TRUE	1	1
FBgn0265678	63	36	31	48	94	84	FALSE	FALSE	TRUE	0	FALSE	FALSE	0	0
FBgn0265679	72	63	52	58	124	121	TRUE	TRUE	TRUE	1	TRUE	TRUE	1	1
FBgn0265680	18	29	31	26	49	55	TRUE	TRUE	TRUE	1	FALSE	TRUE	0	0
FBgn0265681	69	64	59	56	128	120	TRUE	TRUE	TRUE	1	TRUE	TRUE	1	1
FBgn0265682	82	76	72	62	154	138	TRUE	TRUE	TRUE	1	TRUE	TRUE	1	1
FBgn0265683	31	40	36	30	67	70	TRUE	TRUE	TRUE	1	TRUE	TRUE	1	1
FBgn0265684	64	33	43	38	107	71	FALSE	TRUE	FALSE	0	FALSE	TRUE	0	0
FBgn0265685	56	47	56	38	112	85	TRUE	FALSE	FALSE	0	TRUE	TRUE	1	0
FBgn0265686	22	49	33	22	55	71	FALSE	TRUE	TRUE	0	FALSE	TRUE	0	0
FBgn0265687	103	87	105	93	208	180	TRUE	TRUE	TRUE	1	TRUE	TRUE	1	1
FBgn0265688	81	71	77	65	158	136	TRUE	TRUE	TRUE	1	TRUE	TRUE	1	1
FBgn0265689	37	43	55	36	92	79	TRUE	FALSE	TRUE	0	TRUE	FALSE	0	0
FBgn0265690	53	56	54	49	107	105	TRUE	TRUE	TRUE	1	TRUE	TRUE	1	1
FBgn0265696	136	114	100	129	236	243	TRUE	FALSE	TRUE	0	TRUE	TRUE	1	0
FBgn0265697	69	55	49	56	118	111	TRUE	TRUE	TRUE	1	TRUE	TRUE	1	1
FBgn0265698	65	71	58	45	123	116	TRUE	TRUE	TRUE	1	TRUE	TRUE	1	1
FBgn0265699	311	362	263	258	574	620	FALSE	TRUE	TRUE	0	TRUE	TRUE	1	0
FBgn0265702	28	25	19	25	47	50	TRUE	TRUE	TRUE	1	TRUE	TRUE	1	1
FBgn0265703	37	37	18	27	55	64	TRUE	TRUE	TRUE	1	TRUE	TRUE	1	1
FBgn0265708	27	25	15	18	42	43	TRUE	TRUE	TRUE	1	TRUE	TRUE	1	1
FBgn0265711	33	26	22	15	55	41	TRUE	TRUE	TRUE	1	TRUE	TRUE	1	1
FBgn0265712	37	37	37	34	74	71	TRUE	TRUE	TRUE	1	TRUE	TRUE	1	1
FBgn0265713	94	102	99	97	193	199	TRUE	TRUE	TRUE	1	TRUE	TRUE	1	1
FBgn0265714	66	57	42	60	108	117	TRUE	FALSE	TRUE	0	TRUE	TRUE	1	0
FBgn0265715	17	26	14	20	31	46	TRUE	TRUE	TRUE	1	FALSE	TRUE	0	0
FBgn0265716	43	43	27	25	70	68	TRUE	TRUE	TRUE	1	TRUE	TRUE	1	1
FBgn0265718	75	111	93	83	168	194	FALSE	TRUE	TRUE	0	TRUE	TRUE	1	0
FBgn0265719	168	163	45	67	213	230	TRUE	FALSE	TRUE	0	TRUE	TRUE	1	0
FBgn0265720	266	236	55	54	321	290	TRUE	TRUE	TRUE	1	TRUE	TRUE	1	1
FBgn0265721	38	36	35	48	73	84	TRUE	TRUE	TRUE	1	TRUE	TRUE	1	1
FBgn0265722	54	44	47	42	101	86	TRUE	TRUE	TRUE	1	TRUE	TRUE	1	1
FBgn0265723	80	100	63	70	143	170	TRUE	TRUE	TRUE	1	TRUE	TRUE	1	1
FBgn0265724	51	46	38	47	89	93	TRUE	TRUE	TRUE	1	TRUE	TRUE	1	1
FBgn0265728	176	189	149	146	325	335	TRUE	TRUE	TRUE	1	TRUE	TRUE	1	1
FBgn0265729	84	99	62	84	146	183	TRUE	FALSE	FALSE	0	TRUE	TRUE	1	0
FBgn0265730	86	104	69	79	155	183	TRUE	TRUE	TRUE	1	TRUE	TRUE	1	1
FBgn0265731	85	89	90	55	175	144	TRUE	FALSE	FALSE	0	TRUE	FALSE	0	0
FBgn0265732	75	64	57	53	132	117	TRUE	TRUE	TRUE	1	TRUE	TRUE	1	1
FBgn0265734	44	36	39	29	83	65	TRUE	TRUE	TRUE	1	TRUE	TRUE	1	1
FBgn0265735	26	24	29	24	55	48	TRUE	TRUE	TRUE	1	TRUE	TRUE	1	1
FBgn0265736	70	55	51	50	121	105	TRUE	TRUE	TRUE	1	TRUE	TRUE	1	1
FBgn0265737	61	56	72	58	133	114	TRUE	TRUE	TRUE	1	TRUE	TRUE	1	1
FBgn0265738	72	73	66	61	138	134	TRUE	TRUE	TRUE	1	TRUE	TRUE	1	1
FBgn0265739	52	46	33	42	85	88	TRUE	TRUE	TRUE	1	TRUE	TRUE	1	1
FBgn0265740	79	85	82	99	161	184	TRUE	TRUE	TRUE	1	TRUE	TRUE	1	1
FBgn0265741	77	99	74	57	151	156	TRUE	TRUE	TRUE	1	TRUE	TRUE	1	1
FBgn0265742	32	41	38	34	70	75	TRUE	TRUE	TRUE	1	TRUE	TRUE	1	1
FBgn0265743	57	60	34	38	91	98	TRUE	TRUE	TRUE	1	TRUE	TRUE	1	1
FBgn0265744	59	54	37	37	96	91	TRUE	TRUE	TRUE	1	TRUE	TRUE	1	1
FBgn0265745	55	58	44	40	99	98	TRUE	TRUE	TRUE	1	TRUE	TRUE	1	1
FBgn0265746	92	111	84	84	176	195	TRUE	TRUE	TRUE	1	TRUE	TRUE	1	1
FBgn0265747	32	35	39	34	71	69	TRUE	TRUE	TRUE	1	TRUE	TRUE	1	1
FBgn0265748	55	54	44	43	99	97	TRUE	TRUE	TRUE	1	TRUE	TRUE	1	1
FBgn0265751	42	61	30	44	72	105	FALSE	TRUE	FALSE	0	TRUE	TRUE	1	0
FBgn0265752	34	55	54	44	88	99	FALSE	TRUE	TRUE	0	FALSE	TRUE	0	0
FBgn0265753	70	70	61	61	131	131	TRUE	TRUE	TRUE	1	TRUE	TRUE	1	1
FBgn0265754	29	39	21	33	50	72	TRUE	TRUE	FALSE	0	TRUE	FALSE	0	0
FBgn0265755	45	48	43	37	88	85	TRUE	TRUE	TRUE	1	TRUE	TRUE	1	1
FBgn0265756	29	26	21	27	50	53	TRUE	TRUE	TRUE	1	TRUE	TRUE	1	1
FBgn0265757	51	52	40	47	91	99	TRUE	TRUE	TRUE	1	TRUE	TRUE	1	1
FBgn0265759	88	92	78	66	166	158	TRUE	TRUE	TRUE	1	TRUE	TRUE	1	1
FBgn0265762	62	64	52	48	114	112	TRUE	TRUE	TRUE	1	TRUE	TRUE	1	1
FBgn0265763	26	28	24	29	50	57	TRUE	TRUE	TRUE	1	TRUE	TRUE	1	1
FBgn0265764	47	26	38	36	85	62	FALSE	TRUE	FALSE	0	FALSE	TRUE	0	0
FBgn0265765	131	129	88	107	219	236	TRUE	TRUE	TRUE	1	TRUE	TRUE	1	1
FBgn0265766	111	104	80	114	191	218	TRUE	FALSE	TRUE	0	TRUE	TRUE	1	0
FBgn0265778	413	439	384	359	797	798	TRUE	TRUE	TRUE	1	TRUE	TRUE	1	1
FBgn0265785	67	44	35	35	102	79	FALSE	TRUE	TRUE	0	FALSE	TRUE	0	0
FBgn0265786	82	80	39	54	121	134	TRUE	TRUE	TRUE	1	TRUE	TRUE	1	1
FBgn0265787	52	59	34	39	86	98	TRUE	TRUE	TRUE	1	TRUE	TRUE	1	1
FBgn0265788	113	88	85	97	198	185	FALSE	TRUE	TRUE	0	TRUE	TRUE	1	0
FBgn0265789	32	36	27	35	59	71	TRUE	TRUE	TRUE	1	TRUE	TRUE	1	1
FBgn0265790	56	46	46	43	102	89	TRUE	TRUE	TRUE	1	TRUE	TRUE	1	1
FBgn0265791	40	43	29	53	69	96	TRUE	FALSE	FALSE	0	TRUE	FALSE	0	0
FBgn0265792	91	87	79	83	170	170	TRUE	TRUE	TRUE	1	TRUE	TRUE	1	1
FBgn0265793	70	65	55	51	125	116	TRUE	TRUE	TRUE	1	TRUE	TRUE	1	1
FBgn0265794	27	38	25	27	52	65	TRUE	TRUE	TRUE	1	TRUE	TRUE	1	1
FBgn0265795	50	36	42	35	92	71	TRUE	TRUE	TRUE	1	TRUE	TRUE	1	1
FBgn0265797	36	34	39	39	75	73	TRUE	TRUE	TRUE	1	TRUE	TRUE	1	1
FBgn0265798	135	134	109	86	244	220	TRUE	TRUE	TRUE	1	TRUE	TRUE	1	1
FBgn0265799	35	26	19	27	54	53	TRUE	TRUE	TRUE	1	TRUE	TRUE	1	1
FBgn0265801	55	49	23	38	78	87	TRUE	FALSE	TRUE	0	TRUE	FALSE	0	0
FBgn0265802	94	79	89	80	183	159	TRUE	TRUE	TRUE	1	TRUE	TRUE	1	1
FBgn0265803	45	47	39	35	84	82	TRUE	TRUE	TRUE	1	TRUE	TRUE	1	1
FBgn0265804	133	124	130	115	263	239	TRUE	TRUE	TRUE	1	TRUE	TRUE	1	1
FBgn0265805	31	23	21	17	52	40	TRUE	TRUE	TRUE	1	TRUE	TRUE	1	1
FBgn0265806	42	50	37	41	79	91	TRUE	TRUE	TRUE	1	TRUE	TRUE	1	1
FBgn0265807	72	66	69	64	141	130	TRUE	TRUE	TRUE	1	TRUE	TRUE	1	1
FBgn0265808	25	14	21	17	46	31	TRUE	TRUE	TRUE	1	FALSE	TRUE	0	0
FBgn0265809	46	38	47	20	93	58	TRUE	FALSE	FALSE	0	TRUE	FALSE	0	0
FBgn0265812	71	67	50	49	121	116	TRUE	TRUE	TRUE	1	TRUE	TRUE	1	1
FBgn0265813	232	242	194	187	426	429	TRUE	TRUE	TRUE	1	TRUE	TRUE	1	1
FBgn0265814	538	498	439	410	977	908	TRUE	TRUE	TRUE	1	TRUE	TRUE	1	1
FBgn0265815	15	29	24	15	39	44	FALSE	TRUE	TRUE	0	FALSE	FALSE	0	0
FBgn0265816	33	39	31	33	64	72	TRUE	TRUE	TRUE	1	TRUE	TRUE	1	1
FBgn0265817	52	89	52	52	104	141	FALSE	TRUE	FALSE	0	FALSE	TRUE	0	0
FBgn0265818	30	40	36	29	66	69	TRUE	TRUE	TRUE	1	TRUE	TRUE	1	1
FBgn0265819	76	60	51	44	127	104	TRUE	TRUE	TRUE	1	TRUE	TRUE	1	1
FBgn0265820	80	63	51	61	131	124	TRUE	TRUE	TRUE	1	TRUE	TRUE	1	1
FBgn0265821	65	64	55	59	120	123	TRUE	TRUE	TRUE	1	TRUE	TRUE	1	1
FBgn0265822	38	27	30	37	68	64	TRUE	TRUE	TRUE	1	TRUE	TRUE	1	1
FBgn0265823	260	232	198	202	458	434	TRUE	TRUE	TRUE	1	TRUE	TRUE	1	1
FBgn0265824	39	40	46	45	85	85	TRUE	TRUE	TRUE	1	TRUE	TRUE	1	1
FBgn0265825	60	49	33	38	93	87	TRUE	TRUE	TRUE	1	TRUE	TRUE	1	1
FBgn0265826	55	44	32	44	87	88	TRUE	TRUE	TRUE	1	TRUE	TRUE	1	1
FBgn0265827	31	40	47	44	78	84	TRUE	TRUE	TRUE	1	TRUE	TRUE	1	1
FBgn0265828	68	45	48	55	116	100	FALSE	TRUE	TRUE	0	FALSE	TRUE	0	0
FBgn0265829	70	70	57	57	127	127	TRUE	TRUE	TRUE	1	TRUE	TRUE	1	1
FBgn0265833	78	57	60	47	138	104	FALSE	TRUE	FALSE	0	TRUE	TRUE	1	0
FBgn0265834	54	70	58	66	112	136	TRUE	TRUE	TRUE	1	TRUE	TRUE	1	1
FBgn0265835	44	41	28	25	72	66	TRUE	TRUE	TRUE	1	TRUE	TRUE	1	1
FBgn0265836	55	57	50	39	105	96	TRUE	TRUE	TRUE	1	TRUE	TRUE	1	1
FBgn0265837	30	17	19	29	49	46	FALSE	TRUE	TRUE	0	FALSE	FALSE	0	0
FBgn0265838	60	34	34	32	94	66	FALSE	TRUE	FALSE	0	FALSE	TRUE	0	0
FBgn0265839	37	38	42	31	79	69	TRUE	TRUE	TRUE	1	TRUE	TRUE	1	1
FBgn0265840	37	37	46	37	83	74	TRUE	TRUE	TRUE	1	TRUE	TRUE	1	1
FBgn0265841	38	51	27	45	65	96	TRUE	FALSE	FALSE	0	TRUE	FALSE	0	0
FBgn0265842	70	70	70	54	140	124	TRUE	TRUE	TRUE	1	TRUE	TRUE	1	1
FBgn0265843	69	63	53	59	122	122	TRUE	TRUE	TRUE	1	TRUE	TRUE	1	1
FBgn0265844	69	88	46	47	115	135	TRUE	TRUE	TRUE	1	TRUE	TRUE	1	1
FBgn0265846	30	34	26	21	56	55	TRUE	TRUE	TRUE	1	TRUE	TRUE	1	1
FBgn0265847	45	45	46	30	91	75	TRUE	FALSE	TRUE	0	TRUE	FALSE	0	0
FBgn0265849	39	33	29	26	68	59	TRUE	TRUE	TRUE	1	TRUE	TRUE	1	1
FBgn0265850	49	59	48	45	97	104	TRUE	TRUE	TRUE	1	TRUE	TRUE	1	1
FBgn0265851	39	47	33	34	72	81	TRUE	TRUE	TRUE	1	TRUE	TRUE	1	1
FBgn0265852	44	65	60	46	104	111	FALSE	TRUE	TRUE	0	TRUE	TRUE	1	0
FBgn0265853	42	37	31	24	73	61	TRUE	TRUE	TRUE	1	TRUE	TRUE	1	1
FBgn0265854	91	96	66	63	157	159	TRUE	TRUE	TRUE	1	TRUE	TRUE	1	1
FBgn0265855	23	20	10	24	33	44	TRUE	FALSE	TRUE	0	TRUE	FALSE	0	0
FBgn0265856	47	22	24	25	71	47	FALSE	TRUE	FALSE	0	FALSE	TRUE	0	0
FBgn0265858	49	43	41	27	90	70	TRUE	TRUE	TRUE	1	TRUE	FALSE	0	0
FBgn0265859	46	39	47	32	93	71	TRUE	TRUE	TRUE	1	TRUE	TRUE	1	1
FBgn0265861	41	28	21	25	62	53	TRUE	TRUE	TRUE	1	TRUE	TRUE	1	1
FBgn0265862	79	83	79	82	158	165	TRUE	TRUE	TRUE	1	TRUE	TRUE	1	1
FBgn0265863	67	61	43	48	110	109	TRUE	TRUE	TRUE	1	TRUE	TRUE	1	1
FBgn0265870	68	61	44	35	112	96	TRUE	TRUE	TRUE	1	TRUE	TRUE	1	1
FBgn0265871	59	69	69	51	128	120	TRUE	TRUE	TRUE	1	TRUE	TRUE	1	1
FBgn0265876	108	131	86	84	194	215	TRUE	TRUE	TRUE	1	TRUE	TRUE	1	1
FBgn0265877	149	104	130	94	279	198	FALSE	FALSE	FALSE	0	TRUE	TRUE	1	0
FBgn0265878	107	111	101	99	208	210	TRUE	TRUE	TRUE	1	TRUE	TRUE	1	1
FBgn0265879	50	55	47	55	97	110	TRUE	TRUE	TRUE	1	TRUE	TRUE	1	1
FBgn0265880	54	53	61	55	115	108	TRUE	TRUE	TRUE	1	TRUE	TRUE	1	1
FBgn0265881	44	62	54	63	98	125	FALSE	TRUE	FALSE	0	TRUE	TRUE	1	0
FBgn0265882	26	52	21	19	47	71	FALSE	TRUE	FALSE	0	FALSE	TRUE	0	0
FBgn0265883	47	48	44	40	91	88	TRUE	TRUE	TRUE	1	TRUE	TRUE	1	1
FBgn0265884	28	43	26	29	54	72	FALSE	TRUE	TRUE	0	FALSE	TRUE	0	0
FBgn0265885	45	47	52	47	97	94	TRUE	TRUE	TRUE	1	TRUE	TRUE	1	1
FBgn0265886	51	50	33	46	84	96	TRUE	TRUE	TRUE	1	TRUE	TRUE	1	1
FBgn0265888	39	20	25	28	64	48	FALSE	TRUE	TRUE	0	FALSE	TRUE	0	0
FBgn0265889	33	30	30	29	63	59	TRUE	TRUE	TRUE	1	TRUE	TRUE	1	1
FBgn0265890	59	47	37	48	96	95	TRUE	TRUE	TRUE	1	TRUE	TRUE	1	1
FBgn0265893	24	18	14	24	38	42	TRUE	TRUE	TRUE	1	TRUE	FALSE	0	0
FBgn0265897	41	41	37	30	78	71	TRUE	TRUE	TRUE	1	TRUE	TRUE	1	1
FBgn0265898	30	16	29	22	59	38	FALSE	TRUE	FALSE	0	FALSE	TRUE	0	0
FBgn0265904	15	23	11	22	26	45	TRUE	FALSE	FALSE	0	FALSE	FALSE	0	0
FBgn0265906	37	31	19	32	56	63	TRUE	FALSE	TRUE	0	TRUE	FALSE	0	0
FBgn0265907	11	23	18	17	29	40	FALSE	TRUE	TRUE	0	FALSE	TRUE	0	0
FBgn0265908	36	51	35	35	71	86	TRUE	TRUE	TRUE	1	TRUE	TRUE	1	1
FBgn0265909	53	54	50	43	103	97	TRUE	TRUE	TRUE	1	TRUE	TRUE	1	1
FBgn0265910	42	45	39	42	81	87	TRUE	TRUE	TRUE	1	TRUE	TRUE	1	1
FBgn0265911	52	50	48	33	100	83	TRUE	TRUE	TRUE	1	TRUE	TRUE	1	1
FBgn0265912	48	48	34	47	82	95	TRUE	TRUE	TRUE	1	TRUE	TRUE	1	1
FBgn0265913	42	63	57	47	99	110	FALSE	TRUE	TRUE	0	TRUE	TRUE	1	0
FBgn0265914	20	18	21	18	41	36	TRUE	TRUE	TRUE	1	TRUE	TRUE	1	1
FBgn0265915	23	31	15	17	38	48	TRUE	TRUE	TRUE	1	TRUE	TRUE	1	1
FBgn0265917	63	55	47	48	110	103	TRUE	TRUE	TRUE	1	TRUE	TRUE	1	1
FBgn0265920	69	95	71	69	140	164	FALSE	TRUE	TRUE	0	TRUE	TRUE	1	0
FBgn0265926	19	20	27	25	46	45	TRUE	TRUE	TRUE	1	TRUE	TRUE	1	1
FBgn0265928	129	166	122	113	251	279	FALSE	TRUE	TRUE	0	TRUE	TRUE	1	0
FBgn0265929	69	55	55	51	124	106	TRUE	TRUE	TRUE	1	TRUE	TRUE	1	1
FBgn0265931	75	66	49	50	124	116	TRUE	TRUE	TRUE	1	TRUE	TRUE	1	1
FBgn0265932	15	24	17	15	32	39	TRUE	TRUE	TRUE	1	FALSE	TRUE	0	0
FBgn0265934	53	30	38	39	91	69	FALSE	TRUE	FALSE	0	FALSE	TRUE	0	0
FBgn0265935	186	167	121	141	307	308	TRUE	TRUE	TRUE	1	TRUE	TRUE	1	1
FBgn0265938	72	56	75	55	147	111	TRUE	FALSE	FALSE	0	TRUE	TRUE	1	0
FBgn0265939	82	56	40	58	122	114	FALSE	FALSE	TRUE	0	TRUE	TRUE	1	0
FBgn0265940	30	33	34	32	64	65	TRUE	TRUE	TRUE	1	TRUE	TRUE	1	1
FBgn0265941	126	112	72	120	198	232	TRUE	FALSE	TRUE	0	TRUE	FALSE	0	0
FBgn0265942	64	69	38	61	102	130	TRUE	FALSE	FALSE	0	TRUE	FALSE	0	0
FBgn0265943	39	38	31	22	70	60	TRUE	TRUE	TRUE	1	TRUE	TRUE	1	1
FBgn0265944	30	22	26	27	56	49	TRUE	TRUE	TRUE	1	TRUE	TRUE	1	1
FBgn0265945	125	105	114	109	239	214	TRUE	TRUE	TRUE	1	TRUE	TRUE	1	1
FBgn0265946	16	24	35	21	51	45	TRUE	FALSE	TRUE	0	TRUE	FALSE	0	0
FBgn0265947	44	42	44	54	88	96	TRUE	TRUE	TRUE	1	TRUE	TRUE	1	1
FBgn0265948	36	38	45	27	81	65	TRUE	FALSE	TRUE	0	TRUE	FALSE	0	0
FBgn0265949	46	43	29	44	75	87	TRUE	TRUE	TRUE	1	TRUE	FALSE	0	0
FBgn0265950	179	172	156	177	335	349	TRUE	TRUE	TRUE	1	TRUE	TRUE	1	1
FBgn0265951	36	34	42	31	78	65	TRUE	TRUE	TRUE	1	TRUE	TRUE	1	1
FBgn0265952	92	105	83	93	175	198	TRUE	TRUE	TRUE	1	TRUE	TRUE	1	1
FBgn0265954	27	26	19	18	46	44	TRUE	TRUE	TRUE	1	TRUE	TRUE	1	1
FBgn0265956	63	61	35	47	98	108	TRUE	TRUE	TRUE	1	TRUE	TRUE	1	1
FBgn0265957	68	68	56	44	124	112	TRUE	TRUE	TRUE	1	TRUE	TRUE	1	1
FBgn0265958	99	90	82	85	181	175	TRUE	TRUE	TRUE	1	TRUE	TRUE	1	1
FBgn0265959	91	88	64	63	155	151	TRUE	TRUE	TRUE	1	TRUE	TRUE	1	1
FBgn0265960	22	24	13	29	35	53	TRUE	FALSE	FALSE	0	TRUE	FALSE	0	0
FBgn0265961	61	73	48	45	109	118	TRUE	TRUE	TRUE	1	TRUE	TRUE	1	1
FBgn0265962	29	32	35	19	64	51	TRUE	FALSE	TRUE	0	TRUE	FALSE	0	0
FBgn0265963	99	84	72	74	171	158	TRUE	TRUE	TRUE	1	TRUE	TRUE	1	1
FBgn0265974	552	579	440	455	992	1034	TRUE	TRUE	TRUE	1	TRUE	TRUE	1	1
FBgn0265976	48	74	48	36	96	110	FALSE	TRUE	TRUE	0	FALSE	TRUE	0	0
FBgn0265977	137	147	123	103	260	250	TRUE	TRUE	TRUE	1	TRUE	TRUE	1	1
FBgn0265978	54	65	51	56	105	121	TRUE	TRUE	TRUE	1	TRUE	TRUE	1	1
FBgn0265979	58	50	39	34	97	84	TRUE	TRUE	TRUE	1	TRUE	TRUE	1	1
FBgn0265980	98	140	78	89	176	229	FALSE	TRUE	FALSE	0	TRUE	TRUE	1	0
FBgn0265981	46	29	28	30	74	59	FALSE	TRUE	TRUE	0	FALSE	TRUE	0	0
FBgn0265982	22	27	23	16	45	43	TRUE	TRUE	TRUE	1	TRUE	TRUE	1	1
FBgn0265983	21	30	22	24	43	54	TRUE	TRUE	TRUE	1	TRUE	TRUE	1	1
FBgn0265984	27	27	20	25	47	52	TRUE	TRUE	TRUE	1	TRUE	TRUE	1	1
FBgn0265985	83	75	63	66	146	141	TRUE	TRUE	TRUE	1	TRUE	TRUE	1	1
FBgn0265988	1025	954	789	805	1814	1759	TRUE	TRUE	TRUE	1	TRUE	TRUE	1	1
FBgn0265991	859	783	726	679	1585	1462	FALSE	TRUE	FALSE	0	TRUE	TRUE	1	0
FBgn0265992	70	72	68	61	138	133	TRUE	TRUE	TRUE	1	TRUE	TRUE	1	1
FBgn0265993	48	51	32	46	80	97	TRUE	TRUE	TRUE	1	TRUE	TRUE	1	1
FBgn0265994	36	20	30	41	66	61	FALSE	TRUE	TRUE	0	FALSE	TRUE	0	0
FBgn0265995	69	55	45	42	114	97	TRUE	TRUE	TRUE	1	TRUE	TRUE	1	1
FBgn0265996	58	55	63	62	121	117	TRUE	TRUE	TRUE	1	TRUE	TRUE	1	1
FBgn0265998	920	923	678	709	1598	1632	TRUE	TRUE	TRUE	1	TRUE	TRUE	1	1
FBgn0266001	91	109	65	74	156	183	TRUE	TRUE	TRUE	1	TRUE	TRUE	1	1
FBgn0266002	44	56	35	43	79	99	TRUE	TRUE	TRUE	1	TRUE	TRUE	1	1
FBgn0266003	137	144	115	118	252	262	TRUE	TRUE	TRUE	1	TRUE	TRUE	1	1
FBgn0266004	92	78	82	71	174	149	TRUE	TRUE	TRUE	1	TRUE	TRUE	1	1
FBgn0266007	29	25	31	29	60	54	TRUE	TRUE	TRUE	1	TRUE	TRUE	1	1
FBgn0266008	65	63	49	55	114	118	TRUE	TRUE	TRUE	1	TRUE	TRUE	1	1
FBgn0266009	93	93	65	94	158	187	TRUE	FALSE	TRUE	0	TRUE	TRUE	1	0
FBgn0266010	51	58	40	48	91	106	TRUE	TRUE	TRUE	1	TRUE	TRUE	1	1
FBgn0266011	37	38	23	30	60	68	TRUE	TRUE	TRUE	1	TRUE	TRUE	1	1
FBgn0266020	36	24	25	18	61	42	TRUE	TRUE	FALSE	0	TRUE	TRUE	1	0
FBgn0266021	103	106	78	77	181	183	TRUE	TRUE	TRUE	1	TRUE	TRUE	1	1
FBgn0266022	33	23	21	28	54	51	TRUE	TRUE	TRUE	1	TRUE	TRUE	1	1
FBgn0266023	29	23	31	32	60	55	TRUE	TRUE	TRUE	1	TRUE	TRUE	1	1
FBgn0266024	55	86	63	55	118	141	FALSE	TRUE	TRUE	0	FALSE	TRUE	0	0
FBgn0266025	79	106	66	83	145	189	FALSE	TRUE	FALSE	0	TRUE	TRUE	1	0
FBgn0266026	52	38	44	39	96	77	TRUE	TRUE	TRUE	1	TRUE	TRUE	1	1
FBgn0266027	73	71	47	54	120	125	TRUE	TRUE	TRUE	1	TRUE	TRUE	1	1
FBgn0266029	49	38	43	41	92	79	TRUE	TRUE	TRUE	1	TRUE	TRUE	1	1
FBgn0266030	46	77	51	46	97	123	FALSE	TRUE	FALSE	0	FALSE	TRUE	0	0
FBgn0266031	21	12	20	13	41	25	TRUE	TRUE	FALSE	0	FALSE	FALSE	0	0
FBgn0266032	40	24	35	40	75	64	FALSE	TRUE	TRUE	0	FALSE	TRUE	0	0
FBgn0266034	69	67	55	55	124	122	TRUE	TRUE	TRUE	1	TRUE	TRUE	1	1
FBgn0266035	54	59	41	35	95	94	TRUE	TRUE	TRUE	1	TRUE	TRUE	1	1
FBgn0266036	240	238	236	179	476	417	TRUE	FALSE	FALSE	0	TRUE	TRUE	1	0
FBgn0266037	48	48	34	53	82	101	TRUE	FALSE	TRUE	0	TRUE	FALSE	0	0
FBgn0266040	41	38	25	36	66	74	TRUE	TRUE	TRUE	1	TRUE	TRUE	1	1
FBgn0266042	46	34	14	39	60	73	TRUE	FALSE	TRUE	0	TRUE	FALSE	0	0
FBgn0266043	33	34	33	25	66	59	TRUE	TRUE	TRUE	1	TRUE	TRUE	1	1
FBgn0266045	144	134	90	109	234	243	TRUE	TRUE	TRUE	1	TRUE	TRUE	1	1
FBgn0266046	59	79	59	58	118	137	TRUE	TRUE	TRUE	1	TRUE	TRUE	1	1
FBgn0266048	28	20	22	29	50	49	TRUE	TRUE	TRUE	1	TRUE	TRUE	1	1
FBgn0266049	23	19	23	22	46	41	TRUE	TRUE	TRUE	1	TRUE	TRUE	1	1
FBgn0266064	161	168	137	142	298	310	TRUE	TRUE	TRUE	1	TRUE	TRUE	1	1
FBgn0266068	47	51	40	54	87	105	TRUE	TRUE	TRUE	1	TRUE	TRUE	1	1
FBgn0266069	45	47	26	23	71	70	TRUE	TRUE	TRUE	1	TRUE	TRUE	1	1
FBgn0266070	39	33	45	38	84	71	TRUE	TRUE	TRUE	1	TRUE	TRUE	1	1
FBgn0266071	20	27	35	36	55	63	TRUE	TRUE	TRUE	1	TRUE	TRUE	1	1
FBgn0266073	55	60	55	52	110	112	TRUE	TRUE	TRUE	1	TRUE	TRUE	1	1
FBgn0266074	100	87	88	90	188	177	TRUE	TRUE	TRUE	1	TRUE	TRUE	1	1
FBgn0266083	407	379	353	371	760	750	TRUE	TRUE	TRUE	1	TRUE	TRUE	1	1
FBgn0266084	1381	1529	601	595	1982	2124	FALSE	TRUE	FALSE	0	TRUE	TRUE	1	0
FBgn0266088	22	19	19	15	41	34	TRUE	TRUE	TRUE	1	TRUE	TRUE	1	1
FBgn0266099	294	281	260	230	554	511	TRUE	TRUE	TRUE	1	TRUE	TRUE	1	1
FBgn0266100	516	489	420	419	936	908	TRUE	TRUE	TRUE	1	TRUE	TRUE	1	1
FBgn0266101	344	355	322	334	666	689	TRUE	TRUE	TRUE	1	TRUE	TRUE	1	1
FBgn0266111	301	300	238	231	539	531	TRUE	TRUE	TRUE	1	TRUE	TRUE	1	1
FBgn0266116	139	130	116	112	255	242	TRUE	TRUE	TRUE	1	TRUE	TRUE	1	1
FBgn0266124	43	31	37	43	80	74	TRUE	TRUE	TRUE	1	TRUE	TRUE	1	1
FBgn0266129	272	264	177	214	449	478	TRUE	FALSE	TRUE	0	TRUE	TRUE	1	0
FBgn0266137	541	503	443	407	984	910	TRUE	TRUE	FALSE	0	TRUE	TRUE	1	0
FBgn0266138	16	26	16	20	32	46	TRUE	TRUE	TRUE	1	FALSE	TRUE	0	0
FBgn0266139	32	40	32	37	64	77	TRUE	TRUE	TRUE	1	TRUE	TRUE	1	1
FBgn0266140	123	113	96	131	219	244	TRUE	FALSE	TRUE	0	TRUE	TRUE	1	0
FBgn0266142	66	84	67	50	133	134	TRUE	TRUE	TRUE	1	TRUE	TRUE	1	1
FBgn0266145	84	81	73	51	157	132	TRUE	FALSE	TRUE	0	TRUE	TRUE	1	0
FBgn0266146	63	60	53	61	116	121	TRUE	TRUE	TRUE	1	TRUE	TRUE	1	1
FBgn0266147	41	48	41	39	82	87	TRUE	TRUE	TRUE	1	TRUE	TRUE	1	1
FBgn0266148	41	44	40	29	81	73	TRUE	TRUE	TRUE	1	TRUE	TRUE	1	1
FBgn0266149	38	43	34	40	72	83	TRUE	TRUE	TRUE	1	TRUE	TRUE	1	1
FBgn0266150	69	67	62	58	131	125	TRUE	TRUE	TRUE	1	TRUE	TRUE	1	1
FBgn0266151	35	41	54	43	89	84	TRUE	TRUE	TRUE	1	TRUE	TRUE	1	1
FBgn0266152	51	39	48	47	99	86	TRUE	TRUE	TRUE	1	TRUE	TRUE	1	1
FBgn0266153	48	46	39	44	87	90	TRUE	TRUE	TRUE	1	TRUE	TRUE	1	1
FBgn0266154	40	35	23	23	63	58	TRUE	TRUE	TRUE	1	TRUE	TRUE	1	1
FBgn0266155	57	33	41	48	98	81	FALSE	TRUE	TRUE	0	FALSE	TRUE	0	0
FBgn0266156	74	66	47	62	121	128	TRUE	TRUE	TRUE	1	TRUE	TRUE	1	1
FBgn0266157	45	56	42	33	87	89	TRUE	TRUE	TRUE	1	TRUE	TRUE	1	1
FBgn0266158	74	59	42	54	116	113	TRUE	TRUE	TRUE	1	TRUE	TRUE	1	1
FBgn0266161	21	16	18	19	39	35	TRUE	TRUE	TRUE	1	TRUE	TRUE	1	1
FBgn0266163	18	20	22	27	40	47	TRUE	TRUE	TRUE	1	TRUE	TRUE	1	1
FBgn0266165	47	52	47	35	94	87	TRUE	TRUE	TRUE	1	TRUE	TRUE	1	1
FBgn0266167	28	38	29	12	57	50	TRUE	FALSE	TRUE	0	TRUE	FALSE	0	0
FBgn0266168	80	82	57	57	137	139	TRUE	TRUE	TRUE	1	TRUE	TRUE	1	1
FBgn0266169	58	51	46	49	104	100	TRUE	TRUE	TRUE	1	TRUE	TRUE	1	1
FBgn0266204	55	46	47	32	102	78	TRUE	TRUE	FALSE	0	TRUE	TRUE	1	0
FBgn0266205	59	60	53	54	112	114	TRUE	TRUE	TRUE	1	TRUE	TRUE	1	1
FBgn0266206	97	79	81	85	178	164	TRUE	TRUE	TRUE	1	TRUE	TRUE	1	1
FBgn0266207	36	37	24	38	60	75	TRUE	FALSE	TRUE	0	TRUE	FALSE	0	0
FBgn0266208	54	46	41	32	95	78	TRUE	TRUE	TRUE	1	TRUE	TRUE	1	1
FBgn0266209	26	42	28	22	54	64	FALSE	TRUE	TRUE	0	FALSE	TRUE	0	0
FBgn0266210	54	54	55	57	109	111	TRUE	TRUE	TRUE	1	TRUE	TRUE	1	1
FBgn0266211	122	134	117	113	239	247	TRUE	TRUE	TRUE	1	TRUE	TRUE	1	1
FBgn0266212	24	23	24	27	48	50	TRUE	TRUE	TRUE	1	TRUE	TRUE	1	1
FBgn0266213	27	40	16	21	43	61	TRUE	TRUE	FALSE	0	TRUE	TRUE	1	0
FBgn0266214	163	144	142	151	305	295	TRUE	TRUE	TRUE	1	TRUE	TRUE	1	1
FBgn0266216	46	39	40	32	86	71	TRUE	TRUE	TRUE	1	TRUE	TRUE	1	1
FBgn0266217	105	101	74	66	179	167	TRUE	TRUE	TRUE	1	TRUE	TRUE	1	1
FBgn0266218	39	33	28	40	67	73	TRUE	TRUE	TRUE	1	TRUE	TRUE	1	1
FBgn0266219	42	61	76	61	118	122	FALSE	TRUE	TRUE	0	TRUE	TRUE	1	0
FBgn0266220	75	78	69	59	144	137	TRUE	TRUE	TRUE	1	TRUE	TRUE	1	1
FBgn0266221	65	69	56	58	121	127	TRUE	TRUE	TRUE	1	TRUE	TRUE	1	1
FBgn0266222	166	178	116	123	282	301	TRUE	TRUE	TRUE	1	TRUE	TRUE	1	1
FBgn0266223	97	90	60	78	157	168	TRUE	TRUE	TRUE	1	TRUE	TRUE	1	1
FBgn0266226	16	16	19	22	35	38	TRUE	TRUE	TRUE	1	TRUE	TRUE	1	1
FBgn0266227	20	11	25	10	45	21	TRUE	FALSE	FALSE	0	FALSE	FALSE	0	0
FBgn0266231	38	37	31	34	69	71	TRUE	TRUE	TRUE	1	TRUE	TRUE	1	1
FBgn0266232	40	37	35	35	75	72	TRUE	TRUE	TRUE	1	TRUE	TRUE	1	1
FBgn0266235	53	72	44	57	97	129	TRUE	TRUE	FALSE	0	TRUE	TRUE	1	0
FBgn0266236	35	28	33	34	68	62	TRUE	TRUE	TRUE	1	TRUE	TRUE	1	1
FBgn0266237	24	31	19	24	43	55	TRUE	TRUE	TRUE	1	TRUE	TRUE	1	1
FBgn0266238	75	76	63	64	138	140	TRUE	TRUE	TRUE	1	TRUE	TRUE	1	1
FBgn0266239	22	21	15	16	37	37	TRUE	TRUE	TRUE	1	TRUE	TRUE	1	1
FBgn0266240	54	53	65	48	119	101	TRUE	TRUE	TRUE	1	TRUE	TRUE	1	1
FBgn0266241	49	62	63	41	112	103	TRUE	FALSE	TRUE	0	TRUE	FALSE	0	0
FBgn0266242	34	36	32	35	66	71	TRUE	TRUE	TRUE	1	TRUE	TRUE	1	1
FBgn0266243	10	36	9	51	19	87	FALSE	FALSE	FALSE	0	FALSE	FALSE	0	0
FBgn0266244	37	40	40	39	77	79	TRUE	TRUE	TRUE	1	TRUE	TRUE	1	1
FBgn0266245	81	97	87	94	168	191	TRUE	TRUE	TRUE	1	TRUE	TRUE	1	1
FBgn0266246	95	98	84	88	179	186	TRUE	TRUE	TRUE	1	TRUE	TRUE	1	1
FBgn0266247	51	41	30	37	81	78	TRUE	TRUE	TRUE	1	TRUE	TRUE	1	1
FBgn0266248	70	69	62	54	132	123	TRUE	TRUE	TRUE	1	TRUE	TRUE	1	1
FBgn0266249	77	83	44	93	121	176	TRUE	FALSE	FALSE	0	TRUE	FALSE	0	0
FBgn0266250	65	81	63	62	128	143	TRUE	TRUE	TRUE	1	TRUE	TRUE	1	1
FBgn0266251	180	186	138	144	318	330	TRUE	TRUE	TRUE	1	TRUE	TRUE	1	1
FBgn0266252	107	135	105	88	212	223	FALSE	TRUE	TRUE	0	TRUE	TRUE	1	0
FBgn0266253	29	27	19	25	48	52	TRUE	TRUE	TRUE	1	TRUE	TRUE	1	1
FBgn0266254	110	115	120	103	230	218	TRUE	TRUE	TRUE	1	TRUE	TRUE	1	1
FBgn0266255	78	109	61	71	139	180	FALSE	TRUE	FALSE	0	TRUE	TRUE	1	0
FBgn0266256	106	102	90	83	196	185	TRUE	TRUE	TRUE	1	TRUE	TRUE	1	1
FBgn0266257	79	73	68	58	147	131	TRUE	TRUE	TRUE	1	TRUE	TRUE	1	1
FBgn0266258	122	91	101	67	223	158	FALSE	FALSE	FALSE	0	TRUE	FALSE	0	0
FBgn0266259	121	114	117	100	238	214	TRUE	TRUE	TRUE	1	TRUE	TRUE	1	1
FBgn0266260	166	179	151	112	317	291	TRUE	FALSE	TRUE	0	TRUE	TRUE	1	0
FBgn0266261	69	55	58	55	127	110	TRUE	TRUE	TRUE	1	TRUE	TRUE	1	1
FBgn0266268	86	70	85	69	171	139	TRUE	TRUE	FALSE	0	TRUE	TRUE	1	0
FBgn0266282	196	169	153	129	349	298	TRUE	TRUE	FALSE	0	TRUE	TRUE	1	0
FBgn0266302	47	29	22	23	69	52	FALSE	TRUE	TRUE	0	FALSE	TRUE	0	0
FBgn0266305	57	57	39	43	96	100	TRUE	TRUE	TRUE	1	TRUE	TRUE	1	1
FBgn0266306	33	50	34	43	67	93	FALSE	TRUE	FALSE	0	FALSE	TRUE	0	0
FBgn0266308	49	41	43	37	92	78	TRUE	TRUE	TRUE	1	TRUE	TRUE	1	1
FBgn0266312	33	56	41	48	74	104	FALSE	TRUE	FALSE	0	FALSE	TRUE	0	0
FBgn0266313	96	101	78	84	174	185	TRUE	TRUE	TRUE	1	TRUE	TRUE	1	1
FBgn0266314	20	22	20	20	40	42	TRUE	TRUE	TRUE	1	TRUE	TRUE	1	1
FBgn0266315	76	72	59	66	135	138	TRUE	TRUE	TRUE	1	TRUE	TRUE	1	1
FBgn0266316	61	54	40	46	101	100	TRUE	TRUE	TRUE	1	TRUE	TRUE	1	1
FBgn0266318	19	15	20	16	39	31	TRUE	TRUE	TRUE	1	TRUE	TRUE	1	1
FBgn0266319	106	88	79	53	185	141	TRUE	FALSE	FALSE	0	TRUE	TRUE	1	0
FBgn0266323	19	14	20	15	39	29	TRUE	TRUE	TRUE	1	TRUE	TRUE	1	1
FBgn0266327	134	144	124	114	258	258	TRUE	TRUE	TRUE	1	TRUE	TRUE	1	1
FBgn0266328	18	25	31	25	49	50	TRUE	TRUE	TRUE	1	TRUE	TRUE	1	1
FBgn0266329	59	63	40	60	99	123	TRUE	FALSE	TRUE	0	TRUE	TRUE	1	0
FBgn0266346	332	300	254	258	586	558	TRUE	TRUE	TRUE	1	TRUE	TRUE	1	1
FBgn0266347	278	240	284	201	562	441	TRUE	FALSE	FALSE	0	TRUE	TRUE	1	0
FBgn0266356	242	250	195	186	437	436	TRUE	TRUE	TRUE	1	TRUE	TRUE	1	1
FBgn0266357	37	26	30	30	67	56	TRUE	TRUE	TRUE	1	TRUE	TRUE	1	1
FBgn0266358	43	38	38	44	81	82	TRUE	TRUE	TRUE	1	TRUE	TRUE	1	1
FBgn0266363	16	18	19	19	35	37	TRUE	TRUE	TRUE	1	TRUE	TRUE	1	1
FBgn0266366	21	23	20	21	41	44	TRUE	TRUE	TRUE	1	TRUE	TRUE	1	1
FBgn0266369	187	201	178	166	365	367	TRUE	TRUE	TRUE	1	TRUE	TRUE	1	1
FBgn0266377	693	695	602	590	1295	1285	TRUE	TRUE	TRUE	1	TRUE	TRUE	1	1
FBgn0266378	74	55	48	50	122	105	TRUE	TRUE	TRUE	1	TRUE	TRUE	1	1
FBgn0266379	27	45	17	20	44	65	FALSE	TRUE	FALSE	0	FALSE	TRUE	0	0
FBgn0266380	47	57	46	42	93	99	TRUE	TRUE	TRUE	1	TRUE	TRUE	1	1
FBgn0266381	83	91	59	73	142	164	TRUE	TRUE	TRUE	1	TRUE	TRUE	1	1
FBgn0266382	42	47	42	25	84	72	TRUE	FALSE	TRUE	0	TRUE	FALSE	0	0
FBgn0266383	72	91	78	77	150	168	TRUE	TRUE	TRUE	1	TRUE	TRUE	1	1
FBgn0266390	86	60	73	45	159	105	FALSE	FALSE	FALSE	0	TRUE	FALSE	0	0
FBgn0266392	59	85	42	63	101	148	FALSE	FALSE	FALSE	0	TRUE	TRUE	1	0
FBgn0266394	22	20	23	32	45	52	TRUE	TRUE	TRUE	1	TRUE	TRUE	1	1
FBgn0266395	23	19	21	19	44	38	TRUE	TRUE	TRUE	1	TRUE	TRUE	1	1
FBgn0266396	69	85	53	57	122	142	TRUE	TRUE	TRUE	1	TRUE	TRUE	1	1
FBgn0266397	47	46	29	44	76	90	TRUE	TRUE	TRUE	1	TRUE	FALSE	0	0
FBgn0266399	23	21	17	25	40	46	TRUE	TRUE	TRUE	1	TRUE	TRUE	1	1
FBgn0266403	56	74	68	47	124	121	TRUE	FALSE	TRUE	0	TRUE	TRUE	1	0
FBgn0266405	51	59	62	50	113	109	TRUE	TRUE	TRUE	1	TRUE	TRUE	1	1
FBgn0266407	37	30	40	29	77	59	TRUE	TRUE	TRUE	1	TRUE	TRUE	1	1
FBgn0266408	109	112	108	84	217	196	TRUE	FALSE	TRUE	0	TRUE	TRUE	1	0
FBgn0266409	86	59	58	70	144	129	FALSE	TRUE	TRUE	0	TRUE	TRUE	1	0
FBgn0266410	218	245	176	196	394	441	TRUE	TRUE	TRUE	1	TRUE	TRUE	1	1
FBgn0266411	565	584	457	442	1022	1026	TRUE	TRUE	TRUE	1	TRUE	TRUE	1	1
FBgn0266412	42	34	30	40	72	74	TRUE	TRUE	TRUE	1	TRUE	TRUE	1	1
FBgn0266414	59	38	45	39	104	77	FALSE	TRUE	FALSE	0	FALSE	TRUE	0	0
FBgn0266415	41	45	33	31	74	76	TRUE	TRUE	TRUE	1	TRUE	TRUE	1	1
FBgn0266417	152	141	117	139	269	280	TRUE	TRUE	TRUE	1	TRUE	TRUE	1	1
FBgn0266418	666	634	509	499	1175	1133	TRUE	TRUE	TRUE	1	TRUE	TRUE	1	1
FBgn0266420	111	96	81	73	192	169	TRUE	TRUE	TRUE	1	TRUE	TRUE	1	1
FBgn0266432	313	284	219	244	532	528	TRUE	TRUE	TRUE	1	TRUE	TRUE	1	1
FBgn0266433	89	93	73	72	162	165	TRUE	TRUE	TRUE	1	TRUE	TRUE	1	1
FBgn0266436	70	60	58	49	128	109	TRUE	TRUE	TRUE	1	TRUE	TRUE	1	1
FBgn0266437	284	286	227	216	511	502	TRUE	TRUE	TRUE	1	TRUE	TRUE	1	1
FBgn0266441	146	124	89	88	235	212	TRUE	TRUE	TRUE	1	TRUE	TRUE	1	1
FBgn0266442	107	121	92	122	199	243	TRUE	FALSE	FALSE	0	TRUE	TRUE	1	0
FBgn0266443	52	51	33	58	85	109	TRUE	FALSE	FALSE	0	TRUE	FALSE	0	0
FBgn0266446	190	205	172	147	362	352	TRUE	TRUE	TRUE	1	TRUE	TRUE	1	1
FBgn0266448	83	84	48	51	131	135	TRUE	TRUE	TRUE	1	TRUE	TRUE	1	1
FBgn0266449	127	126	113	95	240	221	TRUE	TRUE	TRUE	1	TRUE	TRUE	1	1
FBgn0266450	105	118	76	89	181	207	TRUE	TRUE	TRUE	1	TRUE	TRUE	1	1
FBgn0266452	163	161	119	114	282	275	TRUE	TRUE	TRUE	1	TRUE	TRUE	1	1
FBgn0266454	48	26	38	39	86	65	FALSE	TRUE	TRUE	0	FALSE	TRUE	0	0
FBgn0266456	30	19	22	20	52	39	TRUE	TRUE	TRUE	1	FALSE	TRUE	0	0
FBgn0266464	270	302	199	247	469	549	TRUE	FALSE	FALSE	0	TRUE	TRUE	1	0
FBgn0266465	146	147	127	100	273	247	TRUE	FALSE	TRUE	0	TRUE	TRUE	1	0
FBgn0266518	48	38	32	25	80	63	TRUE	TRUE	TRUE	1	TRUE	TRUE	1	1
FBgn0266521	378	382	300	311	678	693	TRUE	TRUE	TRUE	1	TRUE	TRUE	1	1
FBgn0266534	95	93	78	85	173	178	TRUE	TRUE	TRUE	1	TRUE	TRUE	1	1
FBgn0266535	54	34	44	44	98	78	FALSE	TRUE	TRUE	0	FALSE	TRUE	0	0
FBgn0266536	60	54	51	38	111	92	TRUE	TRUE	TRUE	1	TRUE	TRUE	1	1
FBgn0266537	83	67	65	76	148	143	TRUE	TRUE	TRUE	1	TRUE	TRUE	1	1
FBgn0266557	386	445	309	331	695	776	FALSE	TRUE	FALSE	0	TRUE	TRUE	1	0
FBgn0266564	40	54	35	29	75	83	TRUE	TRUE	TRUE	1	TRUE	TRUE	1	1
FBgn0266565	37	32	27	27	64	59	TRUE	TRUE	TRUE	1	TRUE	TRUE	1	1
FBgn0266566	284	305	199	236	483	541	TRUE	FALSE	FALSE	0	TRUE	TRUE	1	0
FBgn0266573	28	25	29	35	57	60	TRUE	TRUE	TRUE	1	TRUE	TRUE	1	1
FBgn0266574	34	18	33	27	67	45	FALSE	TRUE	FALSE	0	FALSE	TRUE	0	0
FBgn0266577	78	79	54	60	132	139	TRUE	TRUE	TRUE	1	TRUE	TRUE	1	1
FBgn0266579	635	665	518	550	1153	1215	TRUE	TRUE	TRUE	1	TRUE	TRUE	1	1
FBgn0266580	280	302	254	257	534	559	TRUE	TRUE	TRUE	1	TRUE	TRUE	1	1
FBgn0266581	215	181	149	152	364	333	FALSE	TRUE	TRUE	0	TRUE	TRUE	1	0
FBgn0266582	74	79	75	59	149	138	TRUE	TRUE	TRUE	1	TRUE	TRUE	1	1
FBgn0266585	20	27	14	17	34	44	TRUE	TRUE	TRUE	1	TRUE	TRUE	1	1
FBgn0266586	38	40	27	36	65	76	TRUE	TRUE	TRUE	1	TRUE	TRUE	1	1
FBgn0266587	48	53	33	37	81	90	TRUE	TRUE	TRUE	1	TRUE	TRUE	1	1
FBgn0266588	41	33	26	21	67	54	TRUE	TRUE	TRUE	1	TRUE	TRUE	1	1
FBgn0266589	71	67	64	56	135	123	TRUE	TRUE	TRUE	1	TRUE	TRUE	1	1
FBgn0266590	57	51	59	72	116	123	TRUE	TRUE	TRUE	1	TRUE	TRUE	1	1
FBgn0266592	62	33	40	27	102	60	FALSE	TRUE	FALSE	0	FALSE	TRUE	0	0
FBgn0266593	27	22	23	15	50	37	TRUE	TRUE	TRUE	1	TRUE	FALSE	0	0
FBgn0266594	30	31	26	34	56	65	TRUE	TRUE	TRUE	1	TRUE	TRUE	1	1
FBgn0266595	65	73	67	60	132	133	TRUE	TRUE	TRUE	1	TRUE	TRUE	1	1
FBgn0266596	27	21	22	26	49	47	TRUE	TRUE	TRUE	1	TRUE	TRUE	1	1
FBgn0266599	78	70	44	54	122	124	TRUE	TRUE	TRUE	1	TRUE	TRUE	1	1
FBgn0266618	27	33	23	22	50	55	TRUE	TRUE	TRUE	1	TRUE	TRUE	1	1
FBgn0266620	91	95	96	81	187	176	TRUE	TRUE	TRUE	1	TRUE	TRUE	1	1
FBgn0266621	32	27	20	37	52	64	TRUE	FALSE	TRUE	0	TRUE	FALSE	0	0
FBgn0266624	140	130	113	110	253	240	TRUE	TRUE	TRUE	1	TRUE	TRUE	1	1
FBgn0266627	22	25	14	25	36	50	TRUE	TRUE	TRUE	1	TRUE	FALSE	0	0
FBgn0266629	29	31	35	29	64	60	TRUE	TRUE	TRUE	1	TRUE	TRUE	1	1
FBgn0266630	426	499	361	388	787	887	FALSE	TRUE	FALSE	0	TRUE	TRUE	1	0
FBgn0266631	56	87	42	62	98	149	FALSE	FALSE	FALSE	0	FALSE	TRUE	0	0
FBgn0266633	95	80	66	57	161	137	TRUE	TRUE	TRUE	1	TRUE	TRUE	1	1
FBgn0266639	44	63	50	38	94	101	FALSE	TRUE	TRUE	0	TRUE	TRUE	1	0
FBgn0266640	67	66	67	76	134	142	TRUE	TRUE	TRUE	1	TRUE	TRUE	1	1
FBgn0266641	106	73	86	94	192	167	FALSE	TRUE	TRUE	0	TRUE	TRUE	1	0
FBgn0266643	83	56	50	71	133	127	FALSE	FALSE	TRUE	0	TRUE	TRUE	1	0
FBgn0266646	53	56	58	63	111	119	TRUE	TRUE	TRUE	1	TRUE	TRUE	1	1
FBgn0266648	57	34	32	23	89	57	FALSE	TRUE	FALSE	0	FALSE	TRUE	0	0
FBgn0266649	114	116	104	102	218	218	TRUE	TRUE	TRUE	1	TRUE	TRUE	1	1
FBgn0266650	42	60	48	50	90	110	FALSE	TRUE	TRUE	0	TRUE	TRUE	1	0
FBgn0266651	70	88	67	55	137	143	TRUE	TRUE	TRUE	1	TRUE	TRUE	1	1
FBgn0266652	25	25	24	29	49	54	TRUE	TRUE	TRUE	1	TRUE	TRUE	1	1
FBgn0266666	40	33	30	30	70	63	TRUE	TRUE	TRUE	1	TRUE	TRUE	1	1
FBgn0266667	167	122	99	98	266	220	FALSE	TRUE	FALSE	0	TRUE	TRUE	1	0
FBgn0266668	194	178	152	121	346	299	TRUE	FALSE	FALSE	0	TRUE	TRUE	1	0
FBgn0266669	104	124	95	84	199	208	TRUE	TRUE	TRUE	1	TRUE	TRUE	1	1
FBgn0266670	109	102	74	79	183	181	TRUE	TRUE	TRUE	1	TRUE	TRUE	1	1
FBgn0266671	196	191	158	151	354	342	TRUE	TRUE	TRUE	1	TRUE	TRUE	1	1
FBgn0266672	28	29	21	22	49	51	TRUE	TRUE	TRUE	1	TRUE	TRUE	1	1
FBgn0266673	199	217	183	173	382	390	TRUE	TRUE	TRUE	1	TRUE	TRUE	1	1
FBgn0266674	243	248	240	217	483	465	TRUE	TRUE	TRUE	1	TRUE	TRUE	1	1
FBgn0266676	108	113	103	113	211	226	TRUE	TRUE	TRUE	1	TRUE	TRUE	1	1
FBgn0266679	57	53	49	60	106	113	TRUE	TRUE	TRUE	1	TRUE	TRUE	1	1
FBgn0266680	112	139	106	84	218	223	TRUE	TRUE	TRUE	1	TRUE	TRUE	1	1
FBgn0266682	24	37	28	35	52	72	TRUE	TRUE	FALSE	0	FALSE	TRUE	0	0
FBgn0266683	53	56	38	39	91	95	TRUE	TRUE	TRUE	1	TRUE	TRUE	1	1
FBgn0266684	74	58	52	51	126	109	TRUE	TRUE	TRUE	1	TRUE	TRUE	1	1
FBgn0266687	59	62	35	49	94	111	TRUE	TRUE	TRUE	1	TRUE	TRUE	1	1
FBgn0266688	21	18	16	20	37	38	TRUE	TRUE	TRUE	1	TRUE	TRUE	1	1
FBgn0266689	86	94	75	89	161	183	TRUE	TRUE	TRUE	1	TRUE	TRUE	1	1
FBgn0266693	73	79	75	81	148	160	TRUE	TRUE	TRUE	1	TRUE	TRUE	1	1
FBgn0266696	2266	2171	1853	1883	4119	4054	TRUE	TRUE	TRUE	1	TRUE	TRUE	1	1
FBgn0266697	21	11	15	21	36	32	TRUE	TRUE	TRUE	1	FALSE	TRUE	0	0
FBgn0266698	48	48	33	38	81	86	TRUE	TRUE	TRUE	1	TRUE	TRUE	1	1
FBgn0266699	55	41	37	23	92	64	TRUE	FALSE	FALSE	0	TRUE	FALSE	0	0
FBgn0266701	92	81	63	83	155	164	TRUE	TRUE	TRUE	1	TRUE	TRUE	1	1
FBgn0266703	50	64	51	68	101	132	TRUE	TRUE	FALSE	0	TRUE	TRUE	1	0
FBgn0266706	55	51	40	32	95	83	TRUE	TRUE	TRUE	1	TRUE	TRUE	1	1
FBgn0266708	41	34	46	44	87	78	TRUE	TRUE	TRUE	1	TRUE	TRUE	1	1
FBgn0266709	84	87	74	72	158	159	TRUE	TRUE	TRUE	1	TRUE	TRUE	1	1
FBgn0266711	20	17	13	18	33	35	TRUE	TRUE	TRUE	1	TRUE	TRUE	1	1
FBgn0266717	223	226	193	189	416	415	TRUE	TRUE	TRUE	1	TRUE	TRUE	1	1
FBgn0266719	338	408	326	321	664	729	FALSE	TRUE	FALSE	0	TRUE	TRUE	1	0
FBgn0266720	20	11	13	21	33	32	TRUE	TRUE	TRUE	1	FALSE	FALSE	0	0
FBgn0266721	68	72	67	73	135	145	TRUE	TRUE	TRUE	1	TRUE	TRUE	1	1
FBgn0266723	47	35	43	24	90	59	TRUE	FALSE	FALSE	0	TRUE	FALSE	0	0
FBgn0266724	46	44	38	39	84	83	TRUE	TRUE	TRUE	1	TRUE	TRUE	1	1
FBgn0266730	46	53	40	44	86	97	TRUE	TRUE	TRUE	1	TRUE	TRUE	1	1
FBgn0266734	73	53	43	43	116	96	FALSE	TRUE	TRUE	0	TRUE	TRUE	1	0
FBgn0266737	36	28	28	26	64	54	TRUE	TRUE	TRUE	1	TRUE	TRUE	1	1
FBgn0266742	35	30	23	28	58	58	TRUE	TRUE	TRUE	1	TRUE	TRUE	1	1
FBgn0266743	64	48	42	39	106	87	TRUE	TRUE	TRUE	1	TRUE	TRUE	1	1
FBgn0266748	44	38	42	37	86	75	TRUE	TRUE	TRUE	1	TRUE	TRUE	1	1
FBgn0266749	65	71	61	55	126	126	TRUE	TRUE	TRUE	1	TRUE	TRUE	1	1
FBgn0266750	470	428	385	378	855	806	TRUE	TRUE	TRUE	1	TRUE	TRUE	1	1
FBgn0266751	88	104	83	68	171	172	TRUE	TRUE	TRUE	1	TRUE	TRUE	1	1
FBgn0266753	149	171	151	145	300	316	TRUE	TRUE	TRUE	1	TRUE	TRUE	1	1
FBgn0266756	1058	990	900	894	1958	1884	TRUE	TRUE	TRUE	1	TRUE	TRUE	1	1
FBgn0266757	439	437	347	322	786	759	TRUE	TRUE	TRUE	1	TRUE	TRUE	1	1
FBgn0266758	441	437	398	389	839	826	TRUE	TRUE	TRUE	1	TRUE	TRUE	1	1
FBgn0266763	89	67	60	69	149	136	FALSE	TRUE	TRUE	0	TRUE	TRUE	1	0
FBgn0266764	25	30	15	28	40	58	TRUE	FALSE	FALSE	0	TRUE	FALSE	0	0
FBgn0266766	399	415	303	326	702	741	TRUE	TRUE	TRUE	1	TRUE	TRUE	1	1
FBgn0266769	32	34	29	29	61	63	TRUE	TRUE	TRUE	1	TRUE	TRUE	1	1
FBgn0266771	36	53	40	52	76	105	FALSE	TRUE	FALSE	0	TRUE	TRUE	1	0
FBgn0266772	18	24	24	34	42	58	TRUE	TRUE	TRUE	1	TRUE	TRUE	1	1
FBgn0266773	79	71	72	64	151	135	TRUE	TRUE	TRUE	1	TRUE	TRUE	1	1
FBgn0266774	76	74	65	64	141	138	TRUE	TRUE	TRUE	1	TRUE	TRUE	1	1
FBgn0266775	109	97	62	70	171	167	TRUE	TRUE	TRUE	1	TRUE	TRUE	1	1
FBgn0266776	17	18	21	17	38	35	TRUE	TRUE	TRUE	1	TRUE	TRUE	1	1
FBgn0266777	60	63	31	52	91	115	TRUE	FALSE	TRUE	0	TRUE	FALSE	0	0
FBgn0266778	28	46	25	27	53	73	FALSE	TRUE	FALSE	0	FALSE	TRUE	0	0
FBgn0266780	85	66	71	77	156	143	TRUE	TRUE	TRUE	1	TRUE	TRUE	1	1
FBgn0266781	40	53	43	39	83	92	TRUE	TRUE	TRUE	1	TRUE	TRUE	1	1
FBgn0266782	22	36	39	38	61	74	FALSE	TRUE	TRUE	0	FALSE	TRUE	0	0
FBgn0266783	39	34	31	28	70	62	TRUE	TRUE	TRUE	1	TRUE	TRUE	1	1
FBgn0266785	34	40	38	37	72	77	TRUE	TRUE	TRUE	1	TRUE	TRUE	1	1
FBgn0266786	37	34	36	42	73	76	TRUE	TRUE	TRUE	1	TRUE	TRUE	1	1
FBgn0266788	27	34	25	24	52	58	TRUE	TRUE	TRUE	1	TRUE	TRUE	1	1
FBgn0266789	31	34	24	30	55	64	TRUE	TRUE	TRUE	1	TRUE	TRUE	1	1
FBgn0266790	40	22	22	28	62	50	FALSE	TRUE	TRUE	0	FALSE	TRUE	0	0
FBgn0266791	46	52	53	50	99	102	TRUE	TRUE	TRUE	1	TRUE	TRUE	1	1
FBgn0266796	68	57	61	55	129	112	TRUE	TRUE	TRUE	1	TRUE	TRUE	1	1
FBgn0266797	53	53	39	60	92	113	TRUE	FALSE	TRUE	0	TRUE	FALSE	0	0
FBgn0266799	53	46	48	40	101	86	TRUE	TRUE	TRUE	1	TRUE	TRUE	1	1
FBgn0266800	117	83	102	65	219	148	FALSE	FALSE	FALSE	0	TRUE	FALSE	0	0
FBgn0266801	54	56	57	50	111	106	TRUE	TRUE	TRUE	1	TRUE	TRUE	1	1
FBgn0266804	108	119	102	95	210	214	TRUE	TRUE	TRUE	1	TRUE	TRUE	1	1
FBgn0266805	433	399	333	357	766	756	TRUE	TRUE	TRUE	1	TRUE	TRUE	1	1
FBgn0266808	20	19	22	21	42	40	TRUE	TRUE	TRUE	1	TRUE	TRUE	1	1
FBgn0266810	158	154	93	100	251	254	TRUE	TRUE	TRUE	1	TRUE	TRUE	1	1
FBgn0266811	44	40	36	42	80	82	TRUE	TRUE	TRUE	1	TRUE	TRUE	1	1
FBgn0266812	32	27	31	18	63	45	TRUE	FALSE	TRUE	0	TRUE	FALSE	0	0
FBgn0266814	127	99	87	76	214	175	FALSE	TRUE	FALSE	0	TRUE	TRUE	1	0
FBgn0266815	60	45	37	37	97	82	TRUE	TRUE	TRUE	1	TRUE	TRUE	1	1
FBgn0266816	83	85	74	84	157	169	TRUE	TRUE	TRUE	1	TRUE	TRUE	1	1
FBgn0266817	35	55	48	33	83	88	FALSE	TRUE	TRUE	0	FALSE	TRUE	0	0
FBgn0266818	128	104	121	96	249	200	TRUE	TRUE	FALSE	0	TRUE	TRUE	1	0
FBgn0266819	109	159	80	142	189	301	FALSE	FALSE	FALSE	0	TRUE	FALSE	0	0
FBgn0266820	31	45	22	19	53	64	TRUE	TRUE	TRUE	1	TRUE	TRUE	1	1
FBgn0266821	119	100	96	100	215	200	TRUE	TRUE	TRUE	1	TRUE	TRUE	1	1
FBgn0266822	422	450	372	385	794	835	TRUE	TRUE	TRUE	1	TRUE	TRUE	1	1
FBgn0266823	34	32	19	27	53	59	TRUE	TRUE	TRUE	1	TRUE	TRUE	1	1
FBgn0266824	37	51	46	40	83	91	TRUE	TRUE	TRUE	1	TRUE	TRUE	1	1
FBgn0266825	37	35	40	35	77	70	TRUE	TRUE	TRUE	1	TRUE	TRUE	1	1
FBgn0266826	48	41	39	28	87	69	TRUE	TRUE	TRUE	1	TRUE	TRUE	1	1
FBgn0266827	43	71	41	47	84	118	FALSE	TRUE	FALSE	0	FALSE	TRUE	0	0
FBgn0266828	82	74	67	64	149	138	TRUE	TRUE	TRUE	1	TRUE	TRUE	1	1
FBgn0266829	28	19	25	25	53	44	TRUE	TRUE	TRUE	1	TRUE	TRUE	1	1
FBgn0266830	38	49	34	38	72	87	TRUE	TRUE	TRUE	1	TRUE	TRUE	1	1
FBgn0266831	38	33	29	28	67	61	TRUE	TRUE	TRUE	1	TRUE	TRUE	1	1
FBgn0266833	53	36	39	38	92	74	FALSE	TRUE	TRUE	0	TRUE	TRUE	1	0
FBgn0266834	26	32	22	14	48	46	TRUE	TRUE	TRUE	1	TRUE	FALSE	0	0
FBgn0266835	17	15	25	14	42	29	TRUE	TRUE	TRUE	1	TRUE	FALSE	0	0
FBgn0266836	46	37	40	20	86	57	TRUE	FALSE	FALSE	0	TRUE	FALSE	0	0
FBgn0266837	25	37	30	30	55	67	TRUE	TRUE	TRUE	1	TRUE	TRUE	1	1
FBgn0266839	35	30	35	24	70	54	TRUE	TRUE	TRUE	1	TRUE	TRUE	1	1
FBgn0266840	11	28	20	21	31	49	FALSE	TRUE	FALSE	0	FALSE	TRUE	0	0
FBgn0266841	89	82	67	52	156	134	TRUE	TRUE	TRUE	1	TRUE	TRUE	1	1
FBgn0266842	35	30	47	36	82	66	TRUE	TRUE	TRUE	1	TRUE	TRUE	1	1
FBgn0266844	49	45	22	31	71	76	TRUE	TRUE	TRUE	1	TRUE	TRUE	1	1
FBgn0266845	49	39	31	31	80	70	TRUE	TRUE	TRUE	1	TRUE	TRUE	1	1
FBgn0266846	72	57	56	59	128	116	TRUE	TRUE	TRUE	1	TRUE	TRUE	1	1
FBgn0266847	40	39	36	26	76	65	TRUE	TRUE	TRUE	1	TRUE	TRUE	1	1
FBgn0266849	49	46	31	39	80	85	TRUE	TRUE	TRUE	1	TRUE	TRUE	1	1
FBgn0266850	220	212	179	169	399	381	TRUE	TRUE	TRUE	1	TRUE	TRUE	1	1
FBgn0266851	75	68	73	59	148	127	TRUE	TRUE	TRUE	1	TRUE	TRUE	1	1
FBgn0266852	57	59	58	55	115	114	TRUE	TRUE	TRUE	1	TRUE	TRUE	1	1
FBgn0266853	50	47	50	44	100	91	TRUE	TRUE	TRUE	1	TRUE	TRUE	1	1
FBgn0266854	36	71	44	58	80	129	FALSE	TRUE	FALSE	0	FALSE	TRUE	0	0
FBgn0266855	43	30	41	25	84	55	TRUE	FALSE	FALSE	0	TRUE	FALSE	0	0
FBgn0266858	144	160	118	124	262	284	TRUE	TRUE	TRUE	1	TRUE	TRUE	1	1
FBgn0266859	35	39	37	35	72	74	TRUE	TRUE	TRUE	1	TRUE	TRUE	1	1
FBgn0266860	40	53	30	49	70	102	TRUE	FALSE	FALSE	0	TRUE	FALSE	0	0
FBgn0266861	52	52	34	45	86	97	TRUE	TRUE	TRUE	1	TRUE	TRUE	1	1
FBgn0266862	63	54	39	58	102	112	TRUE	FALSE	TRUE	0	TRUE	TRUE	1	0
FBgn0266863	67	67	61	77	128	144	TRUE	TRUE	TRUE	1	TRUE	TRUE	1	1
FBgn0266864	57	80	68	46	125	126	FALSE	FALSE	TRUE	0	TRUE	TRUE	1	0
FBgn0266865	31	44	20	18	51	62	TRUE	TRUE	TRUE	1	TRUE	TRUE	1	1
FBgn0266866	41	33	34	33	75	66	TRUE	TRUE	TRUE	1	TRUE	TRUE	1	1
FBgn0266867	66	63	48	54	114	117	TRUE	TRUE	TRUE	1	TRUE	TRUE	1	1
FBgn0266868	52	64	45	69	97	133	TRUE	FALSE	FALSE	0	TRUE	FALSE	0	0
FBgn0266870	42	51	33	51	75	102	TRUE	FALSE	FALSE	0	TRUE	FALSE	0	0
FBgn0266871	27	33	38	32	65	65	TRUE	TRUE	TRUE	1	TRUE	TRUE	1	1
FBgn0266872	27	24	18	22	45	46	TRUE	TRUE	TRUE	1	TRUE	TRUE	1	1
FBgn0266873	44	74	45	61	89	135	FALSE	TRUE	FALSE	0	FALSE	TRUE	0	0
FBgn0266874	26	32	20	19	46	51	TRUE	TRUE	TRUE	1	TRUE	TRUE	1	1
FBgn0266875	57	58	55	53	112	111	TRUE	TRUE	TRUE	1	TRUE	TRUE	1	1
FBgn0266876	41	50	44	30	85	80	TRUE	TRUE	TRUE	1	TRUE	TRUE	1	1
FBgn0266877	42	61	49	37	91	98	FALSE	TRUE	TRUE	0	TRUE	TRUE	1	0
FBgn0266882	28	35	38	28	66	63	TRUE	TRUE	TRUE	1	TRUE	TRUE	1	1
FBgn0266883	41	47	34	46	75	93	TRUE	TRUE	TRUE	1	TRUE	TRUE	1	1
FBgn0266884	146	159	121	107	267	266	TRUE	TRUE	TRUE	1	TRUE	TRUE	1	1
FBgn0266885	64	64	45	50	109	114	TRUE	TRUE	TRUE	1	TRUE	TRUE	1	1
FBgn0266886	33	25	39	24	72	49	TRUE	FALSE	FALSE	0	TRUE	FALSE	0	0
FBgn0266887	46	33	55	34	101	67	TRUE	FALSE	FALSE	0	TRUE	FALSE	0	0
FBgn0266888	44	29	27	27	71	56	TRUE	TRUE	TRUE	1	FALSE	TRUE	0	0
FBgn0266889	25	23	16	21	41	44	TRUE	TRUE	TRUE	1	TRUE	TRUE	1	1
FBgn0266891	87	100	79	63	166	163	TRUE	TRUE	TRUE	1	TRUE	TRUE	1	1
FBgn0266892	39	39	34	34	73	73	TRUE	TRUE	TRUE	1	TRUE	TRUE	1	1
FBgn0266893	43	37	39	45	82	82	TRUE	TRUE	TRUE	1	TRUE	TRUE	1	1
FBgn0266894	26	27	39	29	65	56	TRUE	TRUE	TRUE	1	TRUE	TRUE	1	1
FBgn0266895	50	35	51	30	101	65	TRUE	FALSE	FALSE	0	TRUE	FALSE	0	0
FBgn0266896	23	26	21	28	44	54	TRUE	TRUE	TRUE	1	TRUE	TRUE	1	1
FBgn0266898	25	23	26	26	51	49	TRUE	TRUE	TRUE	1	TRUE	TRUE	1	1
FBgn0266899	66	78	58	67	124	145	TRUE	TRUE	TRUE	1	TRUE	TRUE	1	1
FBgn0266900	63	63	53	37	116	100	TRUE	TRUE	TRUE	1	TRUE	TRUE	1	1
FBgn0266901	181	166	178	137	359	303	TRUE	FALSE	FALSE	0	TRUE	TRUE	1	0
FBgn0266902	68	66	48	41	116	107	TRUE	TRUE	TRUE	1	TRUE	TRUE	1	1
FBgn0266903	179	151	165	119	344	270	TRUE	FALSE	FALSE	0	TRUE	TRUE	1	0
FBgn0266904	61	52	53	47	114	99	TRUE	TRUE	TRUE	1	TRUE	TRUE	1	1
FBgn0266905	50	71	56	63	106	134	FALSE	TRUE	FALSE	0	TRUE	TRUE	1	0
FBgn0266906	18	21	15	21	33	42	TRUE	TRUE	TRUE	1	TRUE	TRUE	1	1
FBgn0266909	21	19	32	31	53	50	TRUE	TRUE	TRUE	1	TRUE	TRUE	1	1
FBgn0266910	25	17	28	17	53	34	TRUE	TRUE	FALSE	0	TRUE	FALSE	0	0
FBgn0266911	43	21	24	29	67	50	FALSE	TRUE	TRUE	0	FALSE	TRUE	0	0
FBgn0266912	71	82	45	44	116	126	TRUE	TRUE	TRUE	1	TRUE	TRUE	1	1
FBgn0266913	22	26	19	20	41	46	TRUE	TRUE	TRUE	1	TRUE	TRUE	1	1
FBgn0266914	45	39	44	46	89	85	TRUE	TRUE	TRUE	1	TRUE	TRUE	1	1
FBgn0266915	66	55	48	49	114	104	TRUE	TRUE	TRUE	1	TRUE	TRUE	1	1
FBgn0266916	158	142	149	104	307	246	TRUE	FALSE	FALSE	0	TRUE	TRUE	1	0
FBgn0266917	102	86	103	88	205	174	TRUE	TRUE	TRUE	1	TRUE	TRUE	1	1
FBgn0266918	126	138	134	109	260	247	TRUE	TRUE	TRUE	1	TRUE	TRUE	1	1
FBgn0266925	99	109	97	73	196	182	TRUE	FALSE	TRUE	0	TRUE	TRUE	1	0
FBgn0266926	88	104	73	72	161	176	TRUE	TRUE	TRUE	1	TRUE	TRUE	1	1
FBgn0266927	30	29	23	25	53	54	TRUE	TRUE	TRUE	1	TRUE	TRUE	1	1
FBgn0266928	82	64	70	72	152	136	TRUE	TRUE	TRUE	1	TRUE	TRUE	1	1
FBgn0266931	25	17	22	19	47	36	TRUE	TRUE	TRUE	1	TRUE	TRUE	1	1
FBgn0266935	54	45	45	23	99	68	TRUE	FALSE	FALSE	0	TRUE	FALSE	0	0
FBgn0266936	73	59	59	57	132	116	TRUE	TRUE	TRUE	1	TRUE	TRUE	1	1
FBgn0266937	147	133	101	122	248	255	TRUE	TRUE	TRUE	1	TRUE	TRUE	1	1
FBgn0266938	65	60	63	51	128	111	TRUE	TRUE	TRUE	1	TRUE	TRUE	1	1
FBgn0266939	25	37	21	33	46	70	TRUE	TRUE	FALSE	0	TRUE	FALSE	0	0
FBgn0266940	77	68	73	73	150	141	TRUE	TRUE	TRUE	1	TRUE	TRUE	1	1
FBgn0266942	52	62	55	51	107	113	TRUE	TRUE	TRUE	1	TRUE	TRUE	1	1
FBgn0266947	42	29	33	27	75	56	TRUE	TRUE	TRUE	1	TRUE	TRUE	1	1
FBgn0266948	24	15	12	22	36	37	TRUE	TRUE	TRUE	1	FALSE	FALSE	0	0
FBgn0266953	77	53	78	49	155	102	FALSE	FALSE	FALSE	0	TRUE	FALSE	0	0
FBgn0266954	39	52	43	43	82	95	TRUE	TRUE	TRUE	1	TRUE	TRUE	1	1
FBgn0266955	46	41	43	29	89	70	TRUE	TRUE	TRUE	1	TRUE	TRUE	1	1
FBgn0266956	17	17	13	25	30	42	TRUE	FALSE	TRUE	0	TRUE	FALSE	0	0
FBgn0266957	47	44	46	41	93	85	TRUE	TRUE	TRUE	1	TRUE	TRUE	1	1
FBgn0266959	80	80	82	79	162	159	TRUE	TRUE	TRUE	1	TRUE	TRUE	1	1
FBgn0266960	26	30	23	22	49	52	TRUE	TRUE	TRUE	1	TRUE	TRUE	1	1
FBgn0266961	47	51	51	51	98	102	TRUE	TRUE	TRUE	1	TRUE	TRUE	1	1
FBgn0266962	81	81	58	73	139	154	TRUE	TRUE	TRUE	1	TRUE	TRUE	1	1
FBgn0266963	104	111	101	82	205	193	TRUE	TRUE	TRUE	1	TRUE	TRUE	1	1
FBgn0266964	23	36	31	35	54	71	TRUE	TRUE	TRUE	1	FALSE	TRUE	0	0
FBgn0266966	29	20	25	22	54	42	TRUE	TRUE	TRUE	1	TRUE	TRUE	1	1
FBgn0266968	39	53	42	40	81	93	TRUE	TRUE	TRUE	1	TRUE	TRUE	1	1
FBgn0266969	26	17	18	18	44	35	TRUE	TRUE	TRUE	1	FALSE	TRUE	0	0
FBgn0266970	59	50	35	44	94	94	TRUE	TRUE	TRUE	1	TRUE	TRUE	1	1
FBgn0266971	30	28	25	26	55	54	TRUE	TRUE	TRUE	1	TRUE	TRUE	1	1
FBgn0266972	52	45	47	59	99	104	TRUE	TRUE	TRUE	1	TRUE	TRUE	1	1
FBgn0266973	36	38	27	25	63	63	TRUE	TRUE	TRUE	1	TRUE	TRUE	1	1
FBgn0266974	25	31	24	33	49	64	TRUE	TRUE	TRUE	1	TRUE	TRUE	1	1
FBgn0266975	42	56	40	34	82	90	TRUE	TRUE	TRUE	1	TRUE	TRUE	1	1
FBgn0266976	15	23	27	28	42	51	TRUE	TRUE	TRUE	1	FALSE	TRUE	0	0
FBgn0266978	49	51	37	44	86	95	TRUE	TRUE	TRUE	1	TRUE	TRUE	1	1
FBgn0266979	35	35	34	25	69	60	TRUE	TRUE	TRUE	1	TRUE	TRUE	1	1
FBgn0266980	45	36	32	46	77	82	TRUE	TRUE	TRUE	1	TRUE	TRUE	1	1
FBgn0266982	39	31	26	12	65	43	TRUE	FALSE	FALSE	0	TRUE	FALSE	0	0
FBgn0266983	51	27	34	28	85	55	FALSE	TRUE	FALSE	0	FALSE	TRUE	0	0
FBgn0266984	63	76	73	54	136	130	TRUE	TRUE	TRUE	1	TRUE	TRUE	1	1
FBgn0266986	63	60	45	52	108	112	TRUE	TRUE	TRUE	1	TRUE	TRUE	1	1
FBgn0266988	33	26	17	33	50	59	TRUE	FALSE	TRUE	0	TRUE	FALSE	0	0
FBgn0266989	14	18	26	18	40	36	TRUE	TRUE	TRUE	1	TRUE	TRUE	1	1
FBgn0266990	13	27	8	40	21	67	FALSE	FALSE	FALSE	0	FALSE	FALSE	0	0
FBgn0266993	30	26	22	24	52	50	TRUE	TRUE	TRUE	1	TRUE	TRUE	1	1
FBgn0267002	656	685	585	544	1241	1229	TRUE	TRUE	TRUE	1	TRUE	TRUE	1	1
FBgn0267003	22	20	13	20	35	40	TRUE	TRUE	TRUE	1	TRUE	FALSE	0	0
FBgn0267004	46	43	41	41	87	84	TRUE	TRUE	TRUE	1	TRUE	TRUE	1	1
FBgn0267005	15	19	18	15	33	34	TRUE	TRUE	TRUE	1	TRUE	TRUE	1	1
FBgn0267006	52	52	52	49	104	101	TRUE	TRUE	TRUE	1	TRUE	TRUE	1	1
FBgn0267007	34	41	24	45	58	86	TRUE	FALSE	FALSE	0	TRUE	FALSE	0	0
FBgn0267008	20	29	24	27	44	56	TRUE	TRUE	TRUE	1	TRUE	TRUE	1	1
FBgn0267009	45	34	30	32	75	66	TRUE	TRUE	TRUE	1	TRUE	TRUE	1	1
FBgn0267010	41	35	24	25	65	60	TRUE	TRUE	TRUE	1	TRUE	TRUE	1	1
FBgn0267012	89	75	75	80	164	155	TRUE	TRUE	TRUE	1	TRUE	TRUE	1	1
FBgn0267013	28	50	30	32	58	82	FALSE	TRUE	FALSE	0	FALSE	TRUE	0	0
FBgn0267014	66	57	48	51	114	108	TRUE	TRUE	TRUE	1	TRUE	TRUE	1	1
FBgn0267017	53	55	41	57	94	112	TRUE	TRUE	TRUE	1	TRUE	TRUE	1	1
FBgn0267018	35	33	31	40	66	73	TRUE	TRUE	TRUE	1	TRUE	TRUE	1	1
FBgn0267023	27	28	24	24	51	52	TRUE	TRUE	TRUE	1	TRUE	TRUE	1	1
FBgn0267028	48	50	41	42	89	92	TRUE	TRUE	TRUE	1	TRUE	TRUE	1	1
FBgn0267104	46	34	32	16	78	50	TRUE	FALSE	FALSE	0	TRUE	FALSE	0	0
FBgn0267106	26	20	26	21	52	41	TRUE	TRUE	TRUE	1	TRUE	TRUE	1	1
FBgn0267107	66	57	52	54	118	111	TRUE	TRUE	TRUE	1	TRUE	TRUE	1	1
FBgn0267111	141	139	125	129	266	268	TRUE	TRUE	TRUE	1	TRUE	TRUE	1	1
FBgn0267112	41	37	31	27	72	64	TRUE	TRUE	TRUE	1	TRUE	TRUE	1	1
FBgn0267113	128	113	80	78	208	191	TRUE	TRUE	TRUE	1	TRUE	TRUE	1	1
FBgn0267116	101	89	69	75	170	164	TRUE	TRUE	TRUE	1	TRUE	TRUE	1	1
FBgn0267118	51	62	56	51	107	113	TRUE	TRUE	TRUE	1	TRUE	TRUE	1	1
FBgn0267120	28	32	25	19	53	51	TRUE	TRUE	TRUE	1	TRUE	TRUE	1	1
FBgn0267121	43	40	26	29	69	69	TRUE	TRUE	TRUE	1	TRUE	TRUE	1	1
FBgn0267122	67	72	52	69	119	141	TRUE	TRUE	TRUE	1	TRUE	TRUE	1	1
FBgn0267123	96	67	66	85	162	152	FALSE	TRUE	TRUE	0	TRUE	TRUE	1	0
FBgn0267124	58	45	42	35	100	80	TRUE	TRUE	TRUE	1	TRUE	TRUE	1	1
FBgn0267125	51	57	48	35	99	92	TRUE	TRUE	TRUE	1	TRUE	TRUE	1	1
FBgn0267127	141	102	117	94	258	196	FALSE	TRUE	FALSE	0	TRUE	TRUE	1	0
FBgn0267128	47	47	45	44	92	91	TRUE	TRUE	TRUE	1	TRUE	TRUE	1	1
FBgn0267129	20	26	17	28	37	54	TRUE	TRUE	FALSE	0	TRUE	FALSE	0	0
FBgn0267131	254	224	188	201	442	425	TRUE	TRUE	TRUE	1	TRUE	TRUE	1	1
FBgn0267133	153	156	154	127	307	283	TRUE	TRUE	TRUE	1	TRUE	TRUE	1	1
FBgn0267134	39	31	23	28	62	59	TRUE	TRUE	TRUE	1	TRUE	TRUE	1	1
FBgn0267136	101	111	81	78	182	189	TRUE	TRUE	TRUE	1	TRUE	TRUE	1	1
FBgn0267137	46	41	51	47	97	88	TRUE	TRUE	TRUE	1	TRUE	TRUE	1	1
FBgn0267138	64	67	53	54	117	121	TRUE	TRUE	TRUE	1	TRUE	TRUE	1	1
FBgn0267139	29	47	37	26	66	73	FALSE	TRUE	TRUE	0	FALSE	TRUE	0	0
FBgn0267140	35	39	30	16	65	55	TRUE	FALSE	TRUE	0	TRUE	FALSE	0	0
FBgn0267142	42	49	46	46	88	95	TRUE	TRUE	TRUE	1	TRUE	TRUE	1	1
FBgn0267143	89	103	83	77	172	180	TRUE	TRUE	TRUE	1	TRUE	TRUE	1	1
FBgn0267144	41	50	57	49	98	99	TRUE	TRUE	TRUE	1	TRUE	TRUE	1	1
FBgn0267145	30	19	26	23	56	42	TRUE	TRUE	TRUE	1	FALSE	TRUE	0	0
FBgn0267146	24	20	28	28	52	48	TRUE	TRUE	TRUE	1	TRUE	TRUE	1	1
FBgn0267148	28	32	37	25	65	57	TRUE	TRUE	TRUE	1	TRUE	TRUE	1	1
FBgn0267150	45	33	42	29	87	62	TRUE	TRUE	FALSE	0	TRUE	TRUE	1	0
FBgn0267153	68	63	52	45	120	108	TRUE	TRUE	TRUE	1	TRUE	TRUE	1	1
FBgn0267154	21	32	20	21	41	53	TRUE	TRUE	TRUE	1	FALSE	TRUE	0	0
FBgn0267155	19	20	22	24	41	44	TRUE	TRUE	TRUE	1	TRUE	TRUE	1	1
FBgn0267156	29	38	29	43	58	81	TRUE	TRUE	FALSE	0	TRUE	TRUE	1	0
FBgn0267159	54	47	36	43	90	90	TRUE	TRUE	TRUE	1	TRUE	TRUE	1	1
FBgn0267160	60	67	55	59	115	126	TRUE	TRUE	TRUE	1	TRUE	TRUE	1	1
FBgn0267190	47	55	38	43	85	98	TRUE	TRUE	TRUE	1	TRUE	TRUE	1	1
FBgn0267191	54	67	50	55	104	122	TRUE	TRUE	TRUE	1	TRUE	TRUE	1	1
FBgn0267192	63	53	57	43	120	96	TRUE	TRUE	TRUE	1	TRUE	TRUE	1	1
FBgn0267194	54	44	29	43	83	87	TRUE	TRUE	TRUE	1	TRUE	TRUE	1	1
FBgn0267195	30	34	35	29	65	63	TRUE	TRUE	TRUE	1	TRUE	TRUE	1	1
FBgn0267197	35	35	27	18	62	53	TRUE	TRUE	TRUE	1	TRUE	TRUE	1	1
FBgn0267201	47	42	33	38	80	80	TRUE	TRUE	TRUE	1	TRUE	TRUE	1	1
FBgn0267202	39	31	32	29	71	60	TRUE	TRUE	TRUE	1	TRUE	TRUE	1	1
FBgn0267203	36	36	24	32	60	68	TRUE	TRUE	TRUE	1	TRUE	TRUE	1	1
FBgn0267204	39	35	37	28	76	63	TRUE	TRUE	TRUE	1	TRUE	TRUE	1	1
FBgn0267205	83	92	77	74	160	166	TRUE	TRUE	TRUE	1	TRUE	TRUE	1	1
FBgn0267207	28	30	15	32	43	62	TRUE	FALSE	FALSE	0	TRUE	FALSE	0	0
FBgn0267209	19	19	11	27	30	46	TRUE	FALSE	FALSE	0	TRUE	FALSE	0	0
FBgn0267210	44	56	52	44	96	100	TRUE	TRUE	TRUE	1	TRUE	TRUE	1	1
FBgn0267211	102	102	82	98	184	200	TRUE	TRUE	TRUE	1	TRUE	TRUE	1	1
FBgn0267212	53	79	45	59	98	138	FALSE	TRUE	FALSE	0	TRUE	TRUE	1	0
FBgn0267213	42	33	46	41	88	74	TRUE	TRUE	TRUE	1	TRUE	TRUE	1	1
FBgn0267214	100	94	78	71	178	165	TRUE	TRUE	TRUE	1	TRUE	TRUE	1	1
FBgn0267215	60	43	30	49	90	92	TRUE	FALSE	TRUE	0	TRUE	FALSE	0	0
FBgn0267216	46	48	35	48	81	96	TRUE	TRUE	TRUE	1	TRUE	TRUE	1	1
FBgn0267217	24	35	28	28	52	63	TRUE	TRUE	TRUE	1	TRUE	TRUE	1	1
FBgn0267218	88	92	82	81	170	173	TRUE	TRUE	TRUE	1	TRUE	TRUE	1	1
FBgn0267220	60	57	42	55	102	112	TRUE	TRUE	TRUE	1	TRUE	TRUE	1	1
FBgn0267222	76	53	67	56	143	109	FALSE	TRUE	FALSE	0	TRUE	TRUE	1	0
FBgn0267229	196	158	162	150	358	308	FALSE	TRUE	FALSE	0	TRUE	TRUE	1	0
FBgn0267230	26	33	34	21	60	54	TRUE	TRUE	TRUE	1	TRUE	FALSE	0	0
FBgn0267233	57	48	38	36	95	84	TRUE	TRUE	TRUE	1	TRUE	TRUE	1	1
FBgn0267234	26	22	20	24	46	46	TRUE	TRUE	TRUE	1	TRUE	TRUE	1	1
FBgn0267235	40	40	30	34	70	74	TRUE	TRUE	TRUE	1	TRUE	TRUE	1	1
FBgn0267236	42	25	19	41	61	66	FALSE	FALSE	TRUE	0	FALSE	FALSE	0	0
FBgn0267238	37	38	43	37	80	75	TRUE	TRUE	TRUE	1	TRUE	TRUE	1	1
FBgn0267239	24	33	21	26	45	59	TRUE	TRUE	TRUE	1	TRUE	TRUE	1	1
FBgn0267240	46	73	45	53	91	126	FALSE	TRUE	FALSE	0	FALSE	TRUE	0	0
FBgn0267241	36	36	35	42	71	78	TRUE	TRUE	TRUE	1	TRUE	TRUE	1	1
FBgn0267242	32	50	35	34	67	84	FALSE	TRUE	TRUE	0	FALSE	TRUE	0	0
FBgn0267243	269	255	196	181	465	436	TRUE	TRUE	TRUE	1	TRUE	TRUE	1	1
FBgn0267244	44	33	27	27	71	60	TRUE	TRUE	TRUE	1	TRUE	TRUE	1	1
FBgn0267246	18	28	19	20	37	48	TRUE	TRUE	TRUE	1	FALSE	TRUE	0	0
FBgn0267247	37	43	35	27	72	70	TRUE	TRUE	TRUE	1	TRUE	TRUE	1	1
FBgn0267248	54	56	57	37	111	93	TRUE	FALSE	TRUE	0	TRUE	FALSE	0	0
FBgn0267249	29	32	23	27	52	59	TRUE	TRUE	TRUE	1	TRUE	TRUE	1	1
FBgn0267252	893	931	772	757	1665	1688	TRUE	TRUE	TRUE	1	TRUE	TRUE	1	1
FBgn0267254	54	46	57	50	111	96	TRUE	TRUE	TRUE	1	TRUE	TRUE	1	1
FBgn0267256	28	36	27	44	55	80	TRUE	FALSE	FALSE	0	TRUE	FALSE	0	0
FBgn0267257	122	118	109	109	231	227	TRUE	TRUE	TRUE	1	TRUE	TRUE	1	1
FBgn0267258	52	40	33	47	85	87	TRUE	TRUE	TRUE	1	TRUE	TRUE	1	1
FBgn0267261	60	83	50	58	110	141	FALSE	TRUE	FALSE	0	TRUE	TRUE	1	0
FBgn0267262	39	38	26	30	65	68	TRUE	TRUE	TRUE	1	TRUE	TRUE	1	1
FBgn0267263	36	37	31	35	67	72	TRUE	TRUE	TRUE	1	TRUE	TRUE	1	1
FBgn0267264	188	219	174	177	362	396	TRUE	TRUE	TRUE	1	TRUE	TRUE	1	1
FBgn0267266	61	64	70	60	131	124	TRUE	TRUE	TRUE	1	TRUE	TRUE	1	1
FBgn0267267	21	32	40	29	61	61	TRUE	TRUE	TRUE	1	FALSE	TRUE	0	0
FBgn0267268	44	28	35	38	79	66	FALSE	TRUE	TRUE	0	FALSE	TRUE	0	0
FBgn0267269	136	126	124	144	260	270	TRUE	TRUE	TRUE	1	TRUE	TRUE	1	1
FBgn0267270	103	111	87	74	190	185	TRUE	TRUE	TRUE	1	TRUE	TRUE	1	1
FBgn0267271	38	49	40	24	78	73	TRUE	FALSE	TRUE	0	TRUE	FALSE	0	0
FBgn0267276	32	33	19	28	51	61	TRUE	TRUE	TRUE	1	TRUE	TRUE	1	1
FBgn0267279	9	23	11	34	20	57	FALSE	FALSE	FALSE	0	FALSE	FALSE	0	0
FBgn0267280	39	57	33	39	72	96	FALSE	TRUE	FALSE	0	TRUE	TRUE	1	0
FBgn0267283	68	60	63	58	131	118	TRUE	TRUE	TRUE	1	TRUE	TRUE	1	1
FBgn0267284	56	45	35	43	91	88	TRUE	TRUE	TRUE	1	TRUE	TRUE	1	1
FBgn0267285	29	16	25	28	54	44	FALSE	TRUE	TRUE	0	FALSE	TRUE	0	0
FBgn0267286	49	59	35	48	84	107	TRUE	TRUE	TRUE	1	TRUE	TRUE	1	1
FBgn0267288	20	26	40	27	60	53	TRUE	TRUE	TRUE	1	TRUE	TRUE	1	1
FBgn0267289	45	41	21	32	66	73	TRUE	TRUE	TRUE	1	TRUE	FALSE	0	0
FBgn0267290	70	85	71	75	141	160	TRUE	TRUE	TRUE	1	TRUE	TRUE	1	1
FBgn0267291	34	16	26	15	60	31	FALSE	TRUE	FALSE	0	FALSE	FALSE	0	0
FBgn0267292	18	29	14	28	32	57	TRUE	FALSE	FALSE	0	FALSE	FALSE	0	0
FBgn0267294	52	61	37	41	89	102	TRUE	TRUE	TRUE	1	TRUE	TRUE	1	1
FBgn0267296	54	66	50	38	104	104	TRUE	TRUE	TRUE	1	TRUE	TRUE	1	1
FBgn0267301	62	56	47	53	109	109	TRUE	TRUE	TRUE	1	TRUE	TRUE	1	1
FBgn0267303	81	47	40	50	121	97	FALSE	TRUE	TRUE	0	FALSE	TRUE	0	0
FBgn0267304	18	16	18	31	36	47	TRUE	FALSE	TRUE	0	TRUE	FALSE	0	0
FBgn0267305	49	37	41	36	90	73	TRUE	TRUE	TRUE	1	TRUE	TRUE	1	1
FBgn0267306	19	12	33	21	52	33	TRUE	TRUE	FALSE	0	FALSE	FALSE	0	0
FBgn0267307	51	57	56	41	107	98	TRUE	TRUE	TRUE	1	TRUE	TRUE	1	1
FBgn0267309	34	33	30	17	64	50	TRUE	FALSE	TRUE	0	TRUE	FALSE	0	0
FBgn0267313	57	56	49	49	106	105	TRUE	TRUE	TRUE	1	TRUE	TRUE	1	1
FBgn0267314	30	23	23	30	53	53	TRUE	TRUE	TRUE	1	TRUE	TRUE	1	1
FBgn0267315	65	50	42	42	107	92	TRUE	TRUE	TRUE	1	TRUE	TRUE	1	1
FBgn0267316	60	61	35	38	95	99	TRUE	TRUE	TRUE	1	TRUE	TRUE	1	1
FBgn0267317	49	41	47	48	96	89	TRUE	TRUE	TRUE	1	TRUE	TRUE	1	1
FBgn0267319	27	19	23	28	50	47	TRUE	TRUE	TRUE	1	TRUE	TRUE	1	1
FBgn0267321	29	26	22	16	51	42	TRUE	TRUE	TRUE	1	TRUE	TRUE	1	1
FBgn0267323	50	68	52	49	102	117	TRUE	TRUE	TRUE	1	TRUE	TRUE	1	1
FBgn0267326	211	228	204	165	415	393	TRUE	FALSE	TRUE	0	TRUE	TRUE	1	0
FBgn0267327	55	52	49	52	104	104	TRUE	TRUE	TRUE	1	TRUE	TRUE	1	1
FBgn0267330	108	110	70	79	178	189	TRUE	TRUE	TRUE	1	TRUE	TRUE	1	1
FBgn0267336	429	402	320	302	749	704	TRUE	TRUE	TRUE	1	TRUE	TRUE	1	1
FBgn0267337	186	161	167	161	353	322	TRUE	TRUE	TRUE	1	TRUE	TRUE	1	1
FBgn0267339	88	75	71	84	159	159	TRUE	TRUE	TRUE	1	TRUE	TRUE	1	1
FBgn0267348	573	592	483	476	1056	1068	TRUE	TRUE	TRUE	1	TRUE	TRUE	1	1
FBgn0267351	203	211	187	162	390	373	TRUE	TRUE	TRUE	1	TRUE	TRUE	1	1
FBgn0267363	18	32	26	25	44	57	FALSE	TRUE	TRUE	0	FALSE	TRUE	0	0
FBgn0267365	93	73	78	66	171	139	TRUE	TRUE	FALSE	0	TRUE	TRUE	1	0
FBgn0267366	79	89	57	71	136	160	TRUE	TRUE	TRUE	1	TRUE	TRUE	1	1
FBgn0267376	153	167	112	104	265	271	TRUE	TRUE	TRUE	1	TRUE	TRUE	1	1
FBgn0267378	72	70	64	64	136	134	TRUE	TRUE	TRUE	1	TRUE	TRUE	1	1
FBgn0267383	24	32	23	22	47	54	TRUE	TRUE	TRUE	1	TRUE	TRUE	1	1
FBgn0267385	48	44	48	55	96	99	TRUE	TRUE	TRUE	1	TRUE	TRUE	1	1
FBgn0267390	300	240	250	227	550	467	FALSE	TRUE	FALSE	0	TRUE	TRUE	1	0
FBgn0267400	43	54	43	28	86	82	TRUE	FALSE	TRUE	0	TRUE	FALSE	0	0
FBgn0267408	219	265	193	180	412	445	FALSE	TRUE	TRUE	0	TRUE	TRUE	1	0
FBgn0267429	44	31	39	33	83	64	TRUE	TRUE	TRUE	1	TRUE	TRUE	1	1
FBgn0267430	34	45	51	55	85	100	TRUE	TRUE	TRUE	1	TRUE	TRUE	1	1
FBgn0267431	51	50	47	66	98	116	TRUE	FALSE	TRUE	0	TRUE	TRUE	1	0
FBgn0267435	312	323	212	205	524	528	TRUE	TRUE	TRUE	1	TRUE	TRUE	1	1
FBgn0267438	61	51	56	44	117	95	TRUE	TRUE	TRUE	1	TRUE	TRUE	1	1
FBgn0267440	22	22	15	16	37	38	TRUE	TRUE	TRUE	1	TRUE	TRUE	1	1
FBgn0267443	21	22	23	20	44	42	TRUE	TRUE	TRUE	1	TRUE	TRUE	1	1
FBgn0267454	45	40	51	38	96	78	TRUE	TRUE	TRUE	1	TRUE	TRUE	1	1
FBgn0267459	54	63	54	46	108	109	TRUE	TRUE	TRUE	1	TRUE	TRUE	1	1
FBgn0267460	61	48	37	42	98	90	TRUE	TRUE	TRUE	1	TRUE	TRUE	1	1
FBgn0267461	131	133	123	94	254	227	TRUE	FALSE	TRUE	0	TRUE	TRUE	1	0
FBgn0267462	24	22	24	17	48	39	TRUE	TRUE	TRUE	1	TRUE	TRUE	1	1
FBgn0267463	37	35	28	30	65	65	TRUE	TRUE	TRUE	1	TRUE	TRUE	1	1
FBgn0267469	66	75	35	55	101	130	TRUE	FALSE	FALSE	0	TRUE	FALSE	0	0
FBgn0267470	38	33	32	28	70	61	TRUE	TRUE	TRUE	1	TRUE	TRUE	1	1
FBgn0267471	67	71	64	55	131	126	TRUE	TRUE	TRUE	1	TRUE	TRUE	1	1
FBgn0267473	93	104	93	76	186	180	TRUE	TRUE	TRUE	1	TRUE	TRUE	1	1
FBgn0267474	88	99	68	68	156	167	TRUE	TRUE	TRUE	1	TRUE	TRUE	1	1
FBgn0267475	62	69	57	67	119	136	TRUE	TRUE	TRUE	1	TRUE	TRUE	1	1
FBgn0267476	72	64	47	59	119	123	TRUE	TRUE	TRUE	1	TRUE	TRUE	1	1
FBgn0267480	45	68	36	48	81	116	FALSE	TRUE	FALSE	0	FALSE	TRUE	0	0
FBgn0267483	19	23	24	13	43	36	TRUE	FALSE	TRUE	0	TRUE	FALSE	0	0
FBgn0267486	157	154	140	136	297	290	TRUE	TRUE	TRUE	1	TRUE	TRUE	1	1
FBgn0267487	511	460	404	403	915	863	TRUE	TRUE	TRUE	1	TRUE	TRUE	1	1
FBgn0267488	618	577	490	532	1108	1109	TRUE	TRUE	TRUE	1	TRUE	TRUE	1	1
FBgn0267526	62	71	42	53	104	124	TRUE	TRUE	TRUE	1	TRUE	TRUE	1	1
FBgn0267528	26	26	19	23	45	49	TRUE	TRUE	TRUE	1	TRUE	TRUE	1	1
FBgn0267536	106	84	87	74	193	158	TRUE	TRUE	FALSE	0	TRUE	TRUE	1	0
FBgn0267537	92	100	93	79	185	179	TRUE	TRUE	TRUE	1	TRUE	TRUE	1	1
FBgn0267539	108	128	95	111	203	239	TRUE	TRUE	FALSE	0	TRUE	TRUE	1	0
FBgn0267541	84	72	51	62	135	134	TRUE	TRUE	TRUE	1	TRUE	TRUE	1	1
FBgn0267542	25	36	45	27	70	63	TRUE	FALSE	TRUE	0	TRUE	FALSE	0	0
FBgn0267544	54	58	62	51	116	109	TRUE	TRUE	TRUE	1	TRUE	TRUE	1	1
FBgn0267547	46	68	60	58	106	126	FALSE	TRUE	TRUE	0	TRUE	TRUE	1	0
FBgn0267548	29	34	25	32	54	66	TRUE	TRUE	TRUE	1	TRUE	TRUE	1	1
FBgn0267550	30	21	17	28	47	49	TRUE	TRUE	TRUE	1	TRUE	FALSE	0	0
FBgn0267557	57	65	53	74	110	139	TRUE	FALSE	FALSE	0	TRUE	TRUE	1	0
FBgn0267558	27	41	25	19	52	60	TRUE	TRUE	TRUE	1	FALSE	TRUE	0	0
FBgn0267559	43	59	49	40	92	99	TRUE	TRUE	TRUE	1	TRUE	TRUE	1	1
FBgn0267560	21	39	25	23	46	62	FALSE	TRUE	TRUE	0	FALSE	TRUE	0	0
FBgn0267561	68	54	39	45	107	99	TRUE	TRUE	TRUE	1	TRUE	TRUE	1	1
FBgn0267564	38	37	32	38	70	75	TRUE	TRUE	TRUE	1	TRUE	TRUE	1	1
FBgn0267566	25	22	21	16	46	38	TRUE	TRUE	TRUE	1	TRUE	TRUE	1	1
FBgn0267569	26	28	21	20	47	48	TRUE	TRUE	TRUE	1	TRUE	TRUE	1	1
FBgn0267570	192	187	146	180	338	367	TRUE	FALSE	TRUE	0	TRUE	TRUE	1	0
FBgn0267571	147	161	96	120	243	281	TRUE	TRUE	TRUE	1	TRUE	TRUE	1	1
FBgn0267572	204	240	178	183	382	423	FALSE	TRUE	TRUE	0	TRUE	TRUE	1	0
FBgn0267573	142	161	137	130	279	291	TRUE	TRUE	TRUE	1	TRUE	TRUE	1	1
FBgn0267574	22	20	22	26	44	46	TRUE	TRUE	TRUE	1	TRUE	TRUE	1	1
FBgn0267575	57	26	34	33	91	59	FALSE	TRUE	FALSE	0	FALSE	TRUE	0	0
FBgn0267576	163	133	117	122	280	255	FALSE	TRUE	TRUE	0	TRUE	TRUE	1	0
FBgn0267579	211	202	160	141	371	343	TRUE	TRUE	TRUE	1	TRUE	TRUE	1	1
FBgn0267580	35	35	36	39	71	74	TRUE	TRUE	TRUE	1	TRUE	TRUE	1	1
FBgn0267581	57	42	47	43	104	85	TRUE	TRUE	TRUE	1	TRUE	TRUE	1	1
FBgn0267582	25	30	22	24	47	54	TRUE	TRUE	TRUE	1	TRUE	TRUE	1	1
FBgn0267585	69	48	45	55	114	103	FALSE	TRUE	TRUE	0	TRUE	TRUE	1	0
FBgn0267586	29	21	20	24	49	45	TRUE	TRUE	TRUE	1	TRUE	TRUE	1	1
FBgn0267597	44	32	32	31	76	63	TRUE	TRUE	TRUE	1	TRUE	TRUE	1	1
FBgn0267598	49	38	47	45	96	83	TRUE	TRUE	TRUE	1	TRUE	TRUE	1	1
FBgn0267599	62	57	37	34	99	91	TRUE	TRUE	TRUE	1	TRUE	TRUE	1	1
FBgn0267602	29	26	32	25	61	51	TRUE	TRUE	TRUE	1	TRUE	TRUE	1	1
FBgn0267603	57	50	52	41	109	91	TRUE	TRUE	TRUE	1	TRUE	TRUE	1	1
FBgn0267604	60	47	37	37	97	84	TRUE	TRUE	TRUE	1	TRUE	TRUE	1	1
FBgn0267611	101	115	96	123	197	238	TRUE	FALSE	FALSE	0	TRUE	TRUE	1	0
FBgn0267615	27	33	34	26	61	59	TRUE	TRUE	TRUE	1	TRUE	TRUE	1	1
FBgn0267616	38	44	33	31	71	75	TRUE	TRUE	TRUE	1	TRUE	TRUE	1	1
FBgn0267618	41	49	44	42	85	91	TRUE	TRUE	TRUE	1	TRUE	TRUE	1	1
FBgn0267619	79	86	74	58	153	144	TRUE	TRUE	TRUE	1	TRUE	TRUE	1	1
FBgn0267621	21	12	10	22	31	34	TRUE	FALSE	TRUE	0	FALSE	FALSE	0	0
FBgn0267623	30	26	23	18	53	44	TRUE	TRUE	TRUE	1	TRUE	TRUE	1	1
FBgn0267624	37	30	46	37	83	67	TRUE	TRUE	TRUE	1	TRUE	TRUE	1	1
FBgn0267627	26	31	20	16	46	47	TRUE	TRUE	TRUE	1	TRUE	TRUE	1	1
FBgn0267629	30	50	19	36	49	86	FALSE	FALSE	FALSE	0	FALSE	FALSE	0	0
FBgn0267633	45	52	49	43	94	95	TRUE	TRUE	TRUE	1	TRUE	TRUE	1	1
FBgn0267635	40	38	34	46	74	84	TRUE	TRUE	TRUE	1	TRUE	TRUE	1	1
FBgn0267638	32	41	43	45	75	86	TRUE	TRUE	TRUE	1	TRUE	TRUE	1	1
FBgn0267639	49	41	41	45	90	86	TRUE	TRUE	TRUE	1	TRUE	TRUE	1	1
FBgn0267640	78	83	75	76	153	159	TRUE	TRUE	TRUE	1	TRUE	TRUE	1	1
FBgn0267641	60	43	45	46	105	89	TRUE	TRUE	TRUE	1	TRUE	TRUE	1	1
FBgn0267643	85	77	59	66	144	143	TRUE	TRUE	TRUE	1	TRUE	TRUE	1	1
FBgn0267644	97	97	73	92	170	189	TRUE	TRUE	TRUE	1	TRUE	TRUE	1	1
FBgn0267645	36	31	51	35	87	66	TRUE	TRUE	TRUE	1	TRUE	TRUE	1	1
FBgn0267646	71	60	49	46	120	106	TRUE	TRUE	TRUE	1	TRUE	TRUE	1	1
FBgn0267647	21	14	12	21	33	35	TRUE	TRUE	TRUE	1	TRUE	FALSE	0	0
FBgn0267653	60	71	59	66	119	137	TRUE	TRUE	TRUE	1	TRUE	TRUE	1	1
FBgn0267655	32	42	28	30	60	72	TRUE	TRUE	TRUE	1	TRUE	TRUE	1	1
FBgn0267656	23	19	14	19	37	38	TRUE	TRUE	TRUE	1	TRUE	TRUE	1	1
FBgn0267658	107	120	101	91	208	211	TRUE	TRUE	TRUE	1	TRUE	TRUE	1	1
FBgn0267659	51	51	30	36	81	87	TRUE	TRUE	TRUE	1	TRUE	TRUE	1	1
FBgn0267660	63	51	56	60	119	111	TRUE	TRUE	TRUE	1	TRUE	TRUE	1	1
FBgn0267662	61	38	39	57	100	95	FALSE	FALSE	TRUE	0	FALSE	TRUE	0	0
FBgn0267663	59	67	64	54	123	121	TRUE	TRUE	TRUE	1	TRUE	TRUE	1	1
FBgn0267664	48	40	32	30	80	70	TRUE	TRUE	TRUE	1	TRUE	TRUE	1	1
FBgn0267665	1405	1317	1197	1142	2602	2459	FALSE	TRUE	FALSE	0	TRUE	TRUE	1	0
FBgn0267666	322	315	285	278	607	593	TRUE	TRUE	TRUE	1	TRUE	TRUE	1	1
FBgn0267667	174	179	142	119	316	298	TRUE	TRUE	TRUE	1	TRUE	TRUE	1	1
FBgn0267668	580	627	541	575	1121	1202	TRUE	TRUE	FALSE	0	TRUE	TRUE	1	0
FBgn0267671	52	42	24	32	76	74	TRUE	TRUE	TRUE	1	TRUE	TRUE	1	1
FBgn0267673	27	29	27	41	54	70	TRUE	TRUE	TRUE	1	TRUE	FALSE	0	0
FBgn0267674	45	26	32	18	77	44	FALSE	FALSE	FALSE	0	FALSE	FALSE	0	0
FBgn0267675	30	30	35	27	65	57	TRUE	TRUE	TRUE	1	TRUE	TRUE	1	1
FBgn0267677	58	53	45	60	103	113	TRUE	TRUE	TRUE	1	TRUE	TRUE	1	1
FBgn0267678	31	29	33	24	64	53	TRUE	TRUE	TRUE	1	TRUE	TRUE	1	1
FBgn0267679	72	69	74	61	146	130	TRUE	TRUE	TRUE	1	TRUE	TRUE	1	1
FBgn0267680	78	81	71	83	149	164	TRUE	TRUE	TRUE	1	TRUE	TRUE	1	1
FBgn0267681	75	70	73	73	148	143	TRUE	TRUE	TRUE	1	TRUE	TRUE	1	1
FBgn0267683	39	22	31	27	70	49	FALSE	TRUE	FALSE	0	FALSE	TRUE	0	0
FBgn0267688	36	37	36	26	72	63	TRUE	TRUE	TRUE	1	TRUE	TRUE	1	1
FBgn0267689	371	373	356	310	727	683	TRUE	FALSE	TRUE	0	TRUE	TRUE	1	0
FBgn0267690	113	101	106	88	219	189	TRUE	TRUE	TRUE	1	TRUE	TRUE	1	1
FBgn0267691	67	76	41	57	108	133	TRUE	TRUE	TRUE	1	TRUE	TRUE	1	1
FBgn0267692	68	60	45	43	113	103	TRUE	TRUE	TRUE	1	TRUE	TRUE	1	1
FBgn0267693	142	161	123	133	265	294	TRUE	TRUE	TRUE	1	TRUE	TRUE	1	1
FBgn0267694	27	28	33	27	60	55	TRUE	TRUE	TRUE	1	TRUE	TRUE	1	1
FBgn0267695	110	135	100	105	210	240	TRUE	TRUE	TRUE	1	TRUE	TRUE	1	1
FBgn0267696	56	82	64	72	120	154	FALSE	TRUE	FALSE	0	TRUE	TRUE	1	0
FBgn0267697	42	48	40	51	82	99	TRUE	TRUE	TRUE	1	TRUE	TRUE	1	1
FBgn0267698	60	58	55	53	115	111	TRUE	TRUE	TRUE	1	TRUE	TRUE	1	1
FBgn0267702	123	122	112	96	235	218	TRUE	TRUE	TRUE	1	TRUE	TRUE	1	1
FBgn0267703	81	60	73	81	154	141	FALSE	TRUE	TRUE	0	TRUE	TRUE	1	0
FBgn0267706	88	92	84	78	172	170	TRUE	TRUE	TRUE	1	TRUE	TRUE	1	1
FBgn0267708	58	62	41	53	99	115	TRUE	TRUE	TRUE	1	TRUE	TRUE	1	1
FBgn0267709	67	56	60	57	127	113	TRUE	TRUE	TRUE	1	TRUE	TRUE	1	1
FBgn0267710	48	48	42	43	90	91	TRUE	TRUE	TRUE	1	TRUE	TRUE	1	1
FBgn0267712	23	14	25	22	48	36	TRUE	TRUE	TRUE	1	FALSE	TRUE	0	0
FBgn0267713	84	97	64	62	148	159	TRUE	TRUE	TRUE	1	TRUE	TRUE	1	1
FBgn0267714	25	30	22	29	47	59	TRUE	TRUE	TRUE	1	TRUE	TRUE	1	1
FBgn0267719	35	22	31	40	66	62	TRUE	TRUE	TRUE	1	FALSE	TRUE	0	0
FBgn0267720	66	73	62	69	128	142	TRUE	TRUE	TRUE	1	TRUE	TRUE	1	1
FBgn0267722	18	21	30	11	48	32	TRUE	FALSE	FALSE	0	TRUE	FALSE	0	0
FBgn0267726	45	35	45	38	90	73	TRUE	TRUE	TRUE	1	TRUE	TRUE	1	1
FBgn0267727	168	200	154	147	322	347	TRUE	TRUE	TRUE	1	TRUE	TRUE	1	1
FBgn0267728	137	116	120	132	257	248	TRUE	TRUE	TRUE	1	TRUE	TRUE	1	1
FBgn0267729	46	40	43	43	89	83	TRUE	TRUE	TRUE	1	TRUE	TRUE	1	1
FBgn0267730	289	270	247	287	536	557	TRUE	FALSE	TRUE	0	TRUE	TRUE	1	0
FBgn0267731	82	78	46	55	128	133	TRUE	TRUE	TRUE	1	TRUE	TRUE	1	1
FBgn0267732	58	59	48	59	106	118	TRUE	TRUE	TRUE	1	TRUE	TRUE	1	1
FBgn0267733	39	30	24	28	63	58	TRUE	TRUE	TRUE	1	TRUE	TRUE	1	1
FBgn0267735	45	42	30	31	75	73	TRUE	TRUE	TRUE	1	TRUE	TRUE	1	1
FBgn0267738	68	37	36	30	104	67	FALSE	TRUE	FALSE	0	FALSE	TRUE	0	0
FBgn0267739	16	21	22	17	38	38	TRUE	TRUE	TRUE	1	TRUE	TRUE	1	1
FBgn0267742	38	43	30	31	68	74	TRUE	TRUE	TRUE	1	TRUE	TRUE	1	1
FBgn0267744	37	27	32	23	69	50	TRUE	TRUE	FALSE	0	TRUE	TRUE	1	0
FBgn0267745	67	75	53	51	120	126	TRUE	TRUE	TRUE	1	TRUE	TRUE	1	1
FBgn0267746	39	22	28	11	67	33	FALSE	FALSE	FALSE	0	FALSE	FALSE	0	0
FBgn0267747	17	31	29	20	46	51	FALSE	TRUE	TRUE	0	FALSE	TRUE	0	0
FBgn0267748	22	30	13	32	35	62	TRUE	FALSE	FALSE	0	TRUE	FALSE	0	0
FBgn0267751	21	27	23	31	44	58	TRUE	TRUE	TRUE	1	TRUE	TRUE	1	1
FBgn0267752	48	58	42	48	90	106	TRUE	TRUE	TRUE	1	TRUE	TRUE	1	1
FBgn0267753	109	90	90	61	199	151	TRUE	FALSE	FALSE	0	TRUE	TRUE	1	0
FBgn0267754	29	36	24	25	53	61	TRUE	TRUE	TRUE	1	TRUE	TRUE	1	1
FBgn0267755	46	57	49	51	95	108	TRUE	TRUE	TRUE	1	TRUE	TRUE	1	1
FBgn0267757	74	62	60	58	134	120	TRUE	TRUE	TRUE	1	TRUE	TRUE	1	1
FBgn0267758	94	105	89	75	183	180	TRUE	TRUE	TRUE	1	TRUE	TRUE	1	1
FBgn0267759	40	40	39	32	79	72	TRUE	TRUE	TRUE	1	TRUE	TRUE	1	1
FBgn0267760	47	58	45	34	92	92	TRUE	TRUE	TRUE	1	TRUE	TRUE	1	1
FBgn0267763	77	63	52	46	129	109	TRUE	TRUE	TRUE	1	TRUE	TRUE	1	1
FBgn0267764	63	67	55	56	118	123	TRUE	TRUE	TRUE	1	TRUE	TRUE	1	1
FBgn0267769	77	83	72	75	149	158	TRUE	TRUE	TRUE	1	TRUE	TRUE	1	1
FBgn0267771	33	29	28	49	61	78	TRUE	FALSE	TRUE	0	TRUE	FALSE	0	0
FBgn0267772	41	46	27	37	68	83	TRUE	TRUE	TRUE	1	TRUE	TRUE	1	1
FBgn0267775	54	44	42	37	96	81	TRUE	TRUE	TRUE	1	TRUE	TRUE	1	1
FBgn0267777	120	131	92	104	212	235	TRUE	TRUE	TRUE	1	TRUE	TRUE	1	1
FBgn0267779	68	64	62	61	130	125	TRUE	TRUE	TRUE	1	TRUE	TRUE	1	1
FBgn0267780	76	68	48	64	124	132	TRUE	TRUE	TRUE	1	TRUE	TRUE	1	1
FBgn0267781	19	27	22	19	41	46	TRUE	TRUE	TRUE	1	TRUE	TRUE	1	1
FBgn0267782	79	78	75	70	154	148	TRUE	TRUE	TRUE	1	TRUE	TRUE	1	1
FBgn0267783	29	32	29	30	58	62	TRUE	TRUE	TRUE	1	TRUE	TRUE	1	1
FBgn0267785	52	53	65	37	117	90	TRUE	FALSE	FALSE	0	TRUE	FALSE	0	0
FBgn0267786	61	47	55	50	116	97	TRUE	TRUE	TRUE	1	TRUE	TRUE	1	1
FBgn0267787	30	21	26	21	56	42	TRUE	TRUE	TRUE	1	TRUE	TRUE	1	1
FBgn0267789	54	50	33	37	87	87	TRUE	TRUE	TRUE	1	TRUE	TRUE	1	1
FBgn0267790	108	68	46	63	154	131	FALSE	TRUE	TRUE	0	FALSE	TRUE	0	0
FBgn0267791	229	229	188	168	417	397	TRUE	TRUE	TRUE	1	TRUE	TRUE	1	1
FBgn0267792	223	194	163	156	386	350	TRUE	TRUE	TRUE	1	TRUE	TRUE	1	1
FBgn0267793	698	711	565	544	1263	1255	TRUE	TRUE	TRUE	1	TRUE	TRUE	1	1
FBgn0267794	186	215	155	157	341	372	TRUE	TRUE	TRUE	1	TRUE	TRUE	1	1
FBgn0267795	416	464	338	377	754	841	TRUE	TRUE	FALSE	0	TRUE	TRUE	1	0
FBgn0267796	588	584	510	470	1098	1054	TRUE	TRUE	TRUE	1	TRUE	TRUE	1	1
FBgn0267798	24	13	21	15	45	28	FALSE	TRUE	FALSE	0	FALSE	TRUE	0	0
FBgn0267799	30	22	29	13	59	35	TRUE	FALSE	FALSE	0	TRUE	FALSE	0	0
FBgn0267802	26	28	18	18	44	46	TRUE	TRUE	TRUE	1	TRUE	TRUE	1	1
FBgn0267806	29	29	35	23	64	52	TRUE	TRUE	TRUE	1	TRUE	FALSE	0	0
FBgn0267807	52	36	27	13	79	49	TRUE	FALSE	FALSE	0	TRUE	FALSE	0	0
FBgn0267817	70	64	66	55	136	119	TRUE	TRUE	TRUE	1	TRUE	TRUE	1	1
FBgn0267818	23	20	15	18	38	38	TRUE	TRUE	TRUE	1	TRUE	TRUE	1	1
FBgn0267820	28	35	34	39	62	74	TRUE	TRUE	TRUE	1	TRUE	TRUE	1	1
FBgn0267821	78	89	68	82	146	171	TRUE	TRUE	TRUE	1	TRUE	TRUE	1	1
FBgn0267823	91	107	55	86	146	193	TRUE	FALSE	FALSE	0	TRUE	FALSE	0	0
FBgn0267824	69	73	75	70	144	143	TRUE	TRUE	TRUE	1	TRUE	TRUE	1	1
FBgn0267827	53	33	31	42	84	75	FALSE	TRUE	TRUE	0	FALSE	TRUE	0	0
FBgn0267828	267	289	217	211	484	500	TRUE	TRUE	TRUE	1	TRUE	TRUE	1	1
FBgn0267849	87	97	97	75	184	172	TRUE	TRUE	TRUE	1	TRUE	TRUE	1	1
FBgn0267861	72	65	74	53	146	118	TRUE	FALSE	FALSE	0	TRUE	TRUE	1	0
FBgn0267915	89	95	76	72	165	167	TRUE	TRUE	TRUE	1	TRUE	TRUE	1	1
FBgn0267916	70	95	78	67	148	162	FALSE	TRUE	TRUE	0	TRUE	TRUE	1	0
FBgn0267917	51	51	63	43	114	94	TRUE	FALSE	TRUE	0	TRUE	TRUE	1	0
FBgn0267918	75	67	66	64	141	131	TRUE	TRUE	TRUE	1	TRUE	TRUE	1	1
FBgn0267919	52	40	41	40	93	80	TRUE	TRUE	TRUE	1	TRUE	TRUE	1	1
FBgn0267921	71	52	49	57	120	109	TRUE	TRUE	TRUE	1	TRUE	TRUE	1	1
FBgn0267922	70	86	70	65	140	151	TRUE	TRUE	TRUE	1	TRUE	TRUE	1	1
FBgn0267923	147	167	129	147	276	314	TRUE	TRUE	TRUE	1	TRUE	TRUE	1	1
FBgn0267924	17	14	15	16	32	30	TRUE	TRUE	TRUE	1	TRUE	TRUE	1	1
FBgn0267925	94	77	62	59	156	136	TRUE	TRUE	TRUE	1	TRUE	TRUE	1	1
FBgn0267926	26	30	31	37	57	67	TRUE	TRUE	TRUE	1	TRUE	TRUE	1	1
FBgn0267927	165	149	148	124	313	273	TRUE	TRUE	TRUE	1	TRUE	TRUE	1	1
FBgn0267928	70	74	52	49	122	123	TRUE	TRUE	TRUE	1	TRUE	TRUE	1	1
FBgn0267929	42	44	37	28	79	72	TRUE	TRUE	TRUE	1	TRUE	TRUE	1	1
FBgn0267932	83	77	89	78	172	155	TRUE	TRUE	TRUE	1	TRUE	TRUE	1	1
FBgn0267933	39	36	26	28	65	64	TRUE	TRUE	TRUE	1	TRUE	TRUE	1	1
FBgn0267934	261	284	190	214	451	498	TRUE	TRUE	TRUE	1	TRUE	TRUE	1	1
FBgn0267935	58	51	57	58	115	109	TRUE	TRUE	TRUE	1	TRUE	TRUE	1	1
FBgn0267936	73	67	69	65	142	132	TRUE	TRUE	TRUE	1	TRUE	TRUE	1	1
FBgn0267937	42	62	40	50	82	112	FALSE	TRUE	FALSE	0	TRUE	TRUE	1	0
FBgn0267938	123	129	101	104	224	233	TRUE	TRUE	TRUE	1	TRUE	TRUE	1	1
FBgn0267939	133	117	101	87	234	204	TRUE	TRUE	TRUE	1	TRUE	TRUE	1	1
FBgn0267941	26	32	20	27	46	59	TRUE	TRUE	TRUE	1	TRUE	TRUE	1	1
FBgn0267944	26	10	20	15	46	25	FALSE	TRUE	FALSE	0	FALSE	TRUE	0	0
FBgn0267945	22	12	20	27	42	39	TRUE	TRUE	TRUE	1	FALSE	TRUE	0	0
FBgn0267946	57	53	42	28	99	81	TRUE	TRUE	TRUE	1	TRUE	TRUE	1	1
FBgn0267948	21	18	19	14	40	32	TRUE	TRUE	TRUE	1	TRUE	TRUE	1	1
FBgn0267949	65	60	59	68	124	128	TRUE	TRUE	TRUE	1	TRUE	TRUE	1	1
FBgn0267950	54	64	43	53	97	117	TRUE	TRUE	TRUE	1	TRUE	TRUE	1	1
FBgn0267951	19	22	21	25	40	47	TRUE	TRUE	TRUE	1	TRUE	TRUE	1	1
FBgn0267952	75	85	54	77	129	162	TRUE	FALSE	FALSE	0	TRUE	TRUE	1	0
FBgn0267953	152	152	106	114	258	266	TRUE	TRUE	TRUE	1	TRUE	TRUE	1	1
FBgn0267954	86	74	73	55	159	129	TRUE	TRUE	FALSE	0	TRUE	TRUE	1	0
FBgn0267955	42	52	53	44	95	96	TRUE	TRUE	TRUE	1	TRUE	TRUE	1	1
FBgn0267956	70	49	46	49	116	98	FALSE	TRUE	TRUE	0	TRUE	TRUE	1	0
FBgn0267957	83	58	68	64	151	122	FALSE	TRUE	FALSE	0	TRUE	TRUE	1	0
FBgn0267958	49	56	50	51	99	107	TRUE	TRUE	TRUE	1	TRUE	TRUE	1	1
FBgn0267959	44	45	31	35	75	80	TRUE	TRUE	TRUE	1	TRUE	TRUE	1	1
FBgn0267960	77	62	44	69	121	131	TRUE	FALSE	TRUE	0	TRUE	FALSE	0	0
FBgn0267961	54	47	56	43	110	90	TRUE	TRUE	TRUE	1	TRUE	TRUE	1	1
FBgn0267966	34	43	37	33	71	76	TRUE	TRUE	TRUE	1	TRUE	TRUE	1	1
FBgn0267972	75	83	60	62	135	145	TRUE	TRUE	TRUE	1	TRUE	TRUE	1	1
FBgn0267975	369	356	302	281	671	637	TRUE	TRUE	TRUE	1	TRUE	TRUE	1	1
FBgn0267978	198	223	167	192	365	415	TRUE	TRUE	FALSE	0	TRUE	TRUE	1	0
FBgn0267982	27	27	29	23	56	50	TRUE	TRUE	TRUE	1	TRUE	TRUE	1	1
FBgn0267983	22	21	18	28	40	49	TRUE	TRUE	TRUE	1	TRUE	FALSE	0	0
FBgn0267985	29	31	22	22	51	53	TRUE	TRUE	TRUE	1	TRUE	TRUE	1	1
FBgn0267986	85	67	68	63	153	130	TRUE	TRUE	TRUE	1	TRUE	TRUE	1	1
FBgn0267987	42	35	43	38	85	73	TRUE	TRUE	TRUE	1	TRUE	TRUE	1	1
FBgn0267989	18	22	17	20	35	42	TRUE	TRUE	TRUE	1	TRUE	TRUE	1	1
FBgn0267991	97	100	91	91	188	191	TRUE	TRUE	TRUE	1	TRUE	TRUE	1	1
FBgn0267992	75	81	61	62	136	143	TRUE	TRUE	TRUE	1	TRUE	TRUE	1	1
FBgn0267993	113	148	114	150	227	298	FALSE	FALSE	FALSE	0	TRUE	TRUE	1	0
FBgn0268063	214	205	175	169	389	374	TRUE	TRUE	TRUE	1	TRUE	TRUE	1	1
FBgn0270924	208	184	133	170	341	354	TRUE	FALSE	TRUE	0	TRUE	TRUE	1	0
FBgn0270925	118	117	113	106	231	223	TRUE	TRUE	TRUE	1	TRUE	TRUE	1	1
FBgn0270928	383	407	369	333	752	740	TRUE	TRUE	TRUE	1	TRUE	TRUE	1	1
FBgn0275432	24	26	29	23	53	49	TRUE	TRUE	TRUE	1	TRUE	TRUE	1	1
FBgn0275433	33	28	15	29	48	57	TRUE	FALSE	TRUE	0	TRUE	FALSE	0	0
FBgn0275436	99	95	79	65	178	160	TRUE	TRUE	TRUE	1	TRUE	TRUE	1	1
FBgn0278597	95	108	70	80	165	188	TRUE	TRUE	TRUE	1	TRUE	TRUE	1	1
FBgn0278598	127	103	99	90	226	193	TRUE	TRUE	TRUE	1	TRUE	TRUE	1	1
FBgn0283426	119	115	118	98	237	213	TRUE	TRUE	TRUE	1	TRUE	TRUE	1	1
FBgn0283427	203	228	191	176	394	404	TRUE	TRUE	TRUE	1	TRUE	TRUE	1	1
FBgn0283428	113	100	83	93	196	193	TRUE	TRUE	TRUE	1	TRUE	TRUE	1	1
FBgn0283437	241	258	245	207	486	465	TRUE	FALSE	TRUE	0	TRUE	TRUE	1	0
FBgn0283438	84	77	58	66	142	143	TRUE	TRUE	TRUE	1	TRUE	TRUE	1	1
FBgn0283440	117	116	100	104	217	220	TRUE	TRUE	TRUE	1	TRUE	TRUE	1	1
FBgn0283442	97	85	79	82	176	167	TRUE	TRUE	TRUE	1	TRUE	TRUE	1	1
FBgn0283461	60	50	38	36	98	86	TRUE	TRUE	TRUE	1	TRUE	TRUE	1	1
FBgn0283467	88	81	76	64	164	145	TRUE	TRUE	TRUE	1	TRUE	TRUE	1	1
FBgn0283468	153	148	152	128	305	276	TRUE	TRUE	TRUE	1	TRUE	TRUE	1	1
FBgn0283472	341	341	258	291	599	632	TRUE	TRUE	TRUE	1	TRUE	TRUE	1	1
FBgn0283477	126	147	133	113	259	260	TRUE	TRUE	TRUE	1	TRUE	TRUE	1	1
FBgn0283478	134	132	107	92	241	224	TRUE	TRUE	TRUE	1	TRUE	TRUE	1	1
FBgn0283479	93	64	58	53	151	117	FALSE	TRUE	FALSE	0	TRUE	TRUE	1	0
FBgn0283480	149	163	141	138	290	301	TRUE	TRUE	TRUE	1	TRUE	TRUE	1	1
FBgn0283499	643	692	598	577	1241	1269	TRUE	TRUE	TRUE	1	TRUE	TRUE	1	1
FBgn0283500	156	157	133	132	289	289	TRUE	TRUE	TRUE	1	TRUE	TRUE	1	1
FBgn0283501	204	253	175	220	379	473	FALSE	FALSE	FALSE	0	TRUE	TRUE	1	0
FBgn0283503	382	372	288	279	670	651	TRUE	TRUE	TRUE	1	TRUE	TRUE	1	1
FBgn0283508	261	261	208	200	469	461	TRUE	TRUE	TRUE	1	TRUE	TRUE	1	1
FBgn0283509	89	103	66	83	155	186	TRUE	TRUE	TRUE	1	TRUE	TRUE	1	1
FBgn0283510	152	129	145	126	297	255	TRUE	TRUE	FALSE	0	TRUE	TRUE	1	0
FBgn0283521	1537	1419	1228	1251	2765	2670	FALSE	TRUE	TRUE	0	TRUE	TRUE	1	0
FBgn0283525	120	114	71	84	191	198	TRUE	TRUE	TRUE	1	TRUE	TRUE	1	1
FBgn0283531	478	532	349	415	827	947	FALSE	FALSE	FALSE	0	TRUE	TRUE	1	0
FBgn0283551	21	23	29	28	50	51	TRUE	TRUE	TRUE	1	TRUE	TRUE	1	1
FBgn0283625	64	64	48	56	112	120	TRUE	TRUE	TRUE	1	TRUE	TRUE	1	1
FBgn0283626	40	67	44	53	84	120	FALSE	TRUE	FALSE	0	FALSE	TRUE	0	0
FBgn0283627	43	49	40	29	83	78	TRUE	TRUE	TRUE	1	TRUE	TRUE	1	1
FBgn0283649	25	24	23	15	48	39	TRUE	TRUE	TRUE	1	TRUE	FALSE	0	0
FBgn0283651	524	573	469	434	993	1007	TRUE	TRUE	TRUE	1	TRUE	TRUE	1	1
FBgn0283652	28	38	38	21	66	59	TRUE	FALSE	TRUE	0	TRUE	FALSE	0	0
FBgn0283658	248	272	197	200	445	472	TRUE	TRUE	TRUE	1	TRUE	TRUE	1	1
FBgn0283659	99	107	86	69	185	176	TRUE	TRUE	TRUE	1	TRUE	TRUE	1	1
FBgn0283666	100	131	74	112	174	243	FALSE	FALSE	FALSE	0	TRUE	FALSE	0	0
FBgn0283678	96	126	84	98	180	224	FALSE	TRUE	FALSE	0	TRUE	TRUE	1	0
FBgn0283681	45	62	35	32	80	94	TRUE	TRUE	TRUE	1	TRUE	TRUE	1	1
FBgn0283682	284	314	286	247	570	561	TRUE	FALSE	TRUE	0	TRUE	TRUE	1	0
FBgn0283724	243	280	224	199	467	479	TRUE	TRUE	TRUE	1	TRUE	TRUE	1	1
FBgn0283728	96	120	103	67	199	187	TRUE	FALSE	TRUE	0	TRUE	FALSE	0	0
FBgn0284082	70	47	46	55	116	102	FALSE	TRUE	TRUE	0	TRUE	TRUE	1	0
FBgn0284084	164	164	131	134	295	298	TRUE	TRUE	TRUE	1	TRUE	TRUE	1	1
FBgn0284220	96	105	90	107	186	212	TRUE	TRUE	TRUE	1	TRUE	TRUE	1	1
FBgn0284221	527	453	391	447	918	900	FALSE	FALSE	TRUE	0	TRUE	TRUE	1	0
FBgn0284238	42	47	27	30	69	77	TRUE	TRUE	TRUE	1	TRUE	TRUE	1	1
FBgn0284243	131	154	86	130	217	284	TRUE	FALSE	FALSE	0	TRUE	FALSE	0	0
FBgn0284244	220	224	213	187	433	411	TRUE	TRUE	TRUE	1	TRUE	TRUE	1	1
FBgn0284245	130	112	99	111	229	223	TRUE	TRUE	TRUE	1	TRUE	TRUE	1	1
FBgn0284246	63	73	60	53	123	126	TRUE	TRUE	TRUE	1	TRUE	TRUE	1	1
FBgn0284247	1003	915	868	793	1871	1708	FALSE	FALSE	FALSE	0	TRUE	TRUE	1	0
FBgn0284248	53	54	55	51	108	105	TRUE	TRUE	TRUE	1	TRUE	TRUE	1	1
FBgn0284249	42	35	40	30	82	65	TRUE	TRUE	TRUE	1	TRUE	TRUE	1	1
FBgn0284250	446	431	409	381	855	812	TRUE	TRUE	TRUE	1	TRUE	TRUE	1	1
FBgn0284251	185	161	147	151	332	312	TRUE	TRUE	TRUE	1	TRUE	TRUE	1	1
FBgn0284252	235	178	179	172	414	350	FALSE	TRUE	FALSE	0	TRUE	TRUE	1	0
FBgn0284253	380	384	282	332	662	716	TRUE	FALSE	TRUE	0	TRUE	TRUE	1	0
FBgn0284254	13	25	17	18	30	43	FALSE	TRUE	TRUE	0	FALSE	TRUE	0	0
FBgn0284255	83	56	49	40	132	96	FALSE	TRUE	FALSE	0	TRUE	TRUE	1	0
FBgn0284256	231	261	227	229	458	490	TRUE	TRUE	TRUE	1	TRUE	TRUE	1	1
FBgn0284257	252	213	250	195	502	408	FALSE	FALSE	FALSE	0	TRUE	TRUE	1	0
FBgn0284409	22	25	19	19	41	44	TRUE	TRUE	TRUE	1	TRUE	TRUE	1	1
FBgn0284410	30	29	21	26	51	55	TRUE	TRUE	TRUE	1	TRUE	TRUE	1	1
FBgn0284411	48	59	47	43	95	102	TRUE	TRUE	TRUE	1	TRUE	TRUE	1	1
FBgn0284413	39	38	48	33	87	71	TRUE	TRUE	TRUE	1	TRUE	TRUE	1	1
FBgn0284414	64	85	57	78	121	163	TRUE	FALSE	FALSE	0	TRUE	TRUE	1	0
FBgn0284415	70	58	56	62	126	120	TRUE	TRUE	TRUE	1	TRUE	TRUE	1	1
FBgn0284416	60	54	44	46	104	100	TRUE	TRUE	TRUE	1	TRUE	TRUE	1	1
FBgn0284417	24	41	32	28	56	69	FALSE	TRUE	TRUE	0	FALSE	TRUE	0	0
FBgn0284418	19	25	23	22	42	47	TRUE	TRUE	TRUE	1	TRUE	TRUE	1	1
FBgn0284419	28	21	20	23	48	44	TRUE	TRUE	TRUE	1	TRUE	TRUE	1	1
FBgn0284420	28	21	34	23	62	44	TRUE	TRUE	FALSE	0	TRUE	TRUE	1	0
FBgn0284421	64	62	67	53	131	115	TRUE	TRUE	TRUE	1	TRUE	TRUE	1	1
FBgn0284436	112	87	69	86	181	173	FALSE	TRUE	TRUE	0	TRUE	TRUE	1	0
FBgn0285892	275	279	222	208	497	487	TRUE	TRUE	TRUE	1	TRUE	TRUE	1	1
FBgn0285896	371	314	257	299	628	613	FALSE	FALSE	TRUE	0	TRUE	TRUE	1	0
FBgn0285911	119	144	114	125	233	269	TRUE	TRUE	TRUE	1	TRUE	TRUE	1	1
FBgn0285912	127	103	97	83	224	186	TRUE	TRUE	FALSE	0	TRUE	TRUE	1	0
FBgn0285913	160	148	135	135	295	283	TRUE	TRUE	TRUE	1	TRUE	TRUE	1	1
FBgn0285917	492	449	402	389	894	838	TRUE	TRUE	TRUE	1	TRUE	TRUE	1	1
FBgn0285925	289	322	233	273	522	595	TRUE	FALSE	FALSE	0	TRUE	TRUE	1	0
FBgn0285937	22	35	16	23	38	58	TRUE	TRUE	FALSE	0	FALSE	TRUE	0	0
FBgn0285938	131	132	95	87	226	219	TRUE	TRUE	TRUE	1	TRUE	TRUE	1	1
FBgn0285943	234	219	179	162	413	381	TRUE	TRUE	TRUE	1	TRUE	TRUE	1	1
FBgn0285948	92	68	59	65	151	133	FALSE	TRUE	TRUE	0	TRUE	TRUE	1	0
FBgn0285949	32	28	28	26	60	54	TRUE	TRUE	TRUE	1	TRUE	TRUE	1	1
FBgn0285950	15	19	19	14	34	33	TRUE	TRUE	TRUE	1	TRUE	TRUE	1	1
FBgn0285951	16	15	15	16	31	31	TRUE	TRUE	TRUE	1	TRUE	TRUE	1	1
FBgn0285952	47	38	36	41	83	79	TRUE	TRUE	TRUE	1	TRUE	TRUE	1	1
FBgn0285955	541	522	431	423	972	945	TRUE	TRUE	TRUE	1	TRUE	TRUE	1	1
FBgn0285962	38	42	53	29	91	71	TRUE	FALSE	TRUE	0	TRUE	FALSE	0	0
FBgn0285963	556	600	469	515	1025	1115	TRUE	TRUE	FALSE	0	TRUE	TRUE	1	0
FBgn0285971	109	111	78	88	187	199	TRUE	TRUE	TRUE	1	TRUE	TRUE	1	1
FBgn0285991	61	57	67	64	128	121	TRUE	TRUE	TRUE	1	TRUE	TRUE	1	1
FBgn0286027	107	86	89	86	196	172	TRUE	TRUE	TRUE	1	TRUE	TRUE	1	1
FBgn0286028	79	79	77	63	156	142	TRUE	TRUE	TRUE	1	TRUE	TRUE	1	1
FBgn0286030	42	54	24	46	66	100	TRUE	FALSE	FALSE	0	TRUE	FALSE	0	0
FBgn0286031	34	45	49	30	83	75	TRUE	FALSE	TRUE	0	TRUE	FALSE	0	0
FBgn0286033	55	50	36	53	91	103	TRUE	FALSE	TRUE	0	TRUE	TRUE	1	0
FBgn0286034	133	162	108	101	241	263	TRUE	TRUE	TRUE	1	TRUE	TRUE	1	1
FBgn0286042	22	37	21	31	43	68	FALSE	TRUE	FALSE	0	FALSE	TRUE	0	0
FBgn0286051	144	144	117	134	261	278	TRUE	TRUE	TRUE	1	TRUE	TRUE	1	1
FBgn0286070	315	342	275	274	590	616	TRUE	TRUE	TRUE	1	TRUE	TRUE	1	1
FBgn0286071	533	593	464	420	997	1013	FALSE	TRUE	TRUE	0	TRUE	TRUE	1	0
FBgn0286075	103	144	122	110	225	254	FALSE	TRUE	TRUE	0	TRUE	TRUE	1	0
FBgn0286198	360	302	308	261	668	563	FALSE	FALSE	FALSE	0	TRUE	TRUE	1	0
FBgn0286199	150	117	124	126	274	243	FALSE	TRUE	TRUE	0	TRUE	TRUE	1	0
FBgn0286203	327	310	289	272	616	582	TRUE	TRUE	TRUE	1	TRUE	TRUE	1	1
FBgn0286204	183	168	143	126	326	294	TRUE	TRUE	TRUE	1	TRUE	TRUE	1	1
FBgn0286213	30	30	30	22	60	52	TRUE	TRUE	TRUE	1	TRUE	TRUE	1	1
FBgn0286507	23	24	19	22	42	46	TRUE	TRUE	TRUE	1	TRUE	TRUE	1	1
FBgn0286511	284	290	234	216	518	506	TRUE	TRUE	TRUE	1	TRUE	TRUE	1	1
FBgn0286516	63	62	72	66	135	128	TRUE	TRUE	TRUE	1	TRUE	TRUE	1	1
FBgn0286567	296	337	276	252	572	589	TRUE	TRUE	TRUE	1	TRUE	TRUE	1	1
FBgn0286723	163	200	143	146	306	346	FALSE	TRUE	TRUE	0	TRUE	TRUE	1	0
FBgn0286728	37	42	41	27	78	69	TRUE	TRUE	TRUE	1	TRUE	FALSE	0	0
FBgn0286730	29	25	23	13	52	38	TRUE	TRUE	TRUE	1	TRUE	FALSE	0	0
FBgn0286731	30	29	20	23	50	52	TRUE	TRUE	TRUE	1	TRUE	TRUE	1	1
FBgn0286733	26	13	16	15	42	28	FALSE	TRUE	TRUE	0	FALSE	TRUE	0	0
FBgn0286735	40	32	22	32	62	64	TRUE	TRUE	TRUE	1	TRUE	TRUE	1	1
FBgn0286736	50	48	37	41	87	89	TRUE	TRUE	TRUE	1	TRUE	TRUE	1	1
FBgn0286778	252	277	211	223	463	500	TRUE	TRUE	TRUE	1	TRUE	TRUE	1	1
FBgn0286781	106	160	87	99	193	259	FALSE	TRUE	FALSE	0	FALSE	TRUE	0	0
FBgn0286782	197	190	146	169	343	359	TRUE	TRUE	TRUE	1	TRUE	TRUE	1	1
FBgn0286783	73	67	60	58	133	125	TRUE	TRUE	TRUE	1	TRUE	TRUE	1	1
FBgn0286784	88	98	63	94	151	192	TRUE	FALSE	FALSE	0	TRUE	TRUE	1	0
FBgn0286785	388	371	299	338	687	709	TRUE	TRUE	TRUE	1	TRUE	TRUE	1	1
FBgn0286786	30	30	32	23	62	53	TRUE	TRUE	TRUE	1	TRUE	TRUE	1	1
FBgn0286788	93	108	82	72	175	180	TRUE	TRUE	TRUE	1	TRUE	TRUE	1	1
FBgn0286813	201	190	160	133	361	323	TRUE	TRUE	TRUE	1	TRUE	TRUE	1	1
FBgn0286818	47	38	39	24	86	62	TRUE	FALSE	FALSE	0	TRUE	FALSE	0	0
FBgn0286827	435	457	373	377	808	834	TRUE	TRUE	TRUE	1	TRUE	TRUE	1	1
FBgn0286828	133	130	112	101	245	231	TRUE	TRUE	TRUE	1	TRUE	TRUE	1	1
FBgn0286834	9	25	10	24	19	49	FALSE	FALSE	FALSE	0	FALSE	FALSE	0	0
FBgn0286852	216	261	182	187	398	448	FALSE	TRUE	FALSE	0	TRUE	TRUE	1	0
FBgn0286872	112	87	70	77	182	164	FALSE	TRUE	TRUE	0	TRUE	TRUE	1	0
FBgn0286873	38	42	25	27	63	69	TRUE	TRUE	TRUE	1	TRUE	TRUE	1	1
FBgn0286875	37	41	38	38	75	79	TRUE	TRUE	TRUE	1	TRUE	TRUE	1	1
FBgn0286876	39	40	36	24	75	64	TRUE	TRUE	TRUE	1	TRUE	TRUE	1	1
FBgn0286880	35	32	45	26	80	58	TRUE	FALSE	FALSE	0	TRUE	FALSE	0	0
FBgn0286882	57	74	54	60	111	134	TRUE	TRUE	TRUE	1	TRUE	TRUE	1	1
FBgn0286884	36	55	57	38	93	93	FALSE	FALSE	TRUE	0	FALSE	TRUE	0	0
FBgn0286885	28	23	29	21	57	44	TRUE	TRUE	TRUE	1	TRUE	TRUE	1	1
FBgn0286890	44	35	23	35	67	70	TRUE	TRUE	TRUE	1	TRUE	FALSE	0	0
FBgn0286891	46	41	32	34	78	75	TRUE	TRUE	TRUE	1	TRUE	TRUE	1	1
FBgn0286892	23	27	22	37	45	64	TRUE	FALSE	FALSE	0	TRUE	FALSE	0	0
FBgn0286898	101	113	95	83	196	196	TRUE	TRUE	TRUE	1	TRUE	TRUE	1	1
FBgn0286913	83	76	61	82	144	158	TRUE	FALSE	TRUE	0	TRUE	TRUE	1	0
FBgn0286914	58	64	55	50	113	114	TRUE	TRUE	TRUE	1	TRUE	TRUE	1	1
FBgn0286925	148	153	126	95	274	248	TRUE	FALSE	TRUE	0	TRUE	TRUE	1	0
FBgn0286927	28	24	35	24	63	48	TRUE	TRUE	TRUE	1	TRUE	TRUE	1	1
FBgn0286933	81	104	75	89	156	193	TRUE	TRUE	FALSE	0	TRUE	TRUE	1	0
FBgn0286938	90	76	69	60	159	136	TRUE	TRUE	TRUE	1	TRUE	TRUE	1	1
